game_id,year_id,game_dt,homeTeam,awayTeam,ballpark,awayScore,homeScore,totalRuns
ANA201004050,2010,100405,ANA,MIN,ANA01,3,6,9
ANA201004060,2010,100406,ANA,MIN,ANA01,5,3,8
ANA201004070,2010,100407,ANA,MIN,ANA01,4,2,6
ANA201004080,2010,100408,ANA,MIN,ANA01,10,1,11
ANA201004090,2010,100409,ANA,OAK,ANA01,10,4,14
ANA201004100,2010,100410,ANA,OAK,ANA01,3,4,7
ANA201004110,2010,100411,ANA,OAK,ANA01,9,4,13
ANA201004190,2010,100419,ANA,DET,ANA01,0,2,2
ANA201004200,2010,100420,ANA,DET,ANA01,5,6,11
ANA201004210,2010,100421,ANA,DET,ANA01,4,3,7
ANA201004220,2010,100422,ANA,DET,ANA01,5,4,9
ANA201004230,2010,100423,ANA,NYA,ANA01,4,6,10
ANA201004240,2010,100424,ANA,NYA,ANA01,7,1,8
ANA201004250,2010,100425,ANA,NYA,ANA01,4,8,12
ANA201004260,2010,100426,ANA,CLE,ANA01,2,5,7
ANA201004270,2010,100427,ANA,CLE,ANA01,9,2,11
ANA201004280,2010,100428,ANA,CLE,ANA01,3,4,7
ANA201005100,2010,100510,ANA,TBA,ANA01,4,5,9
ANA201005110,2010,100511,ANA,TBA,ANA01,7,2,9
ANA201005120,2010,100512,ANA,TBA,ANA01,4,3,7
ANA201005140,2010,100514,ANA,OAK,ANA01,0,4,4
ANA201005150,2010,100515,ANA,OAK,ANA01,3,12,15
ANA201005160,2010,100516,ANA,OAK,ANA01,0,4,4
ANA201005240,2010,100524,ANA,TOR,ANA01,6,0,6
ANA201005250,2010,100525,ANA,TOR,ANA01,3,8,11
ANA201005260,2010,100526,ANA,TOR,ANA01,5,6,11
ANA201005280,2010,100528,ANA,SEA,ANA01,8,3,11
ANA201005290,2010,100529,ANA,SEA,ANA01,1,5,6
ANA201005300,2010,100530,ANA,SEA,ANA01,7,9,16
ANA201006140,2010,100614,ANA,MIL,ANA01,12,2,14
ANA201006150,2010,100615,ANA,MIL,ANA01,7,1,8
ANA201006160,2010,100616,ANA,MIL,ANA01,1,5,6
ANA201006220,2010,100622,ANA,LAN,ANA01,3,6,9
ANA201006230,2010,100623,ANA,LAN,ANA01,1,2,3
ANA201006240,2010,100624,ANA,LAN,ANA01,10,6,16
ANA201006250,2010,100625,ANA,COL,ANA01,4,3,7
ANA201006260,2010,100626,ANA,COL,ANA01,2,4,6
ANA201006270,2010,100627,ANA,COL,ANA01,3,10,13
ANA201006290,2010,100629,ANA,TEX,ANA01,5,6,11
ANA201006300,2010,100630,ANA,TEX,ANA01,6,4,10
ANA201007010,2010,100701,ANA,TEX,ANA01,1,2,3
ANA201007020,2010,100702,ANA,KCA,ANA01,2,1,3
ANA201007030,2010,100703,ANA,KCA,ANA01,4,2,6
ANA201007040,2010,100704,ANA,KCA,ANA01,0,11,11
ANA201007150,2010,100715,ANA,SEA,ANA01,3,8,11
ANA201007160,2010,100716,ANA,SEA,ANA01,2,3,5
ANA201007170,2010,100717,ANA,SEA,ANA01,6,7,13
ANA201007180,2010,100718,ANA,SEA,ANA01,2,1,3
ANA201007260,2010,100726,ANA,BOS,ANA01,6,3,9
ANA201007270,2010,100727,ANA,BOS,ANA01,4,2,6
ANA201007280,2010,100728,ANA,BOS,ANA01,7,3,10
ANA201007300,2010,100730,ANA,TEX,ANA01,7,9,16
ANA201007310,2010,100731,ANA,TEX,ANA01,2,1,3
ANA201008010,2010,100801,ANA,TEX,ANA01,1,4,5
ANA201008090,2010,100809,ANA,KCA,ANA01,4,6,10
ANA201008100,2010,100810,ANA,KCA,ANA01,1,3,4
ANA201008110,2010,100811,ANA,KCA,ANA01,1,2,3
ANA201008130,2010,100813,ANA,TOR,ANA01,3,0,3
ANA201008140,2010,100814,ANA,TOR,ANA01,2,7,9
ANA201008150,2010,100815,ANA,TOR,ANA01,4,1,5
ANA201008230,2010,100823,ANA,TBA,ANA01,4,3,7
ANA201008240,2010,100824,ANA,TBA,ANA01,10,3,13
ANA201008250,2010,100825,ANA,TBA,ANA01,3,12,15
ANA201008270,2010,100827,ANA,BAL,ANA01,3,1,4
ANA201008280,2010,100828,ANA,BAL,ANA01,5,0,5
ANA201008290,2010,100829,ANA,BAL,ANA01,1,0,1
ANA201009060,2010,100906,ANA,CLE,ANA01,3,2,5
ANA201009070,2010,100907,ANA,CLE,ANA01,6,1,7
ANA201009080,2010,100908,ANA,CLE,ANA01,3,4,7
ANA201009100,2010,100910,ANA,SEA,ANA01,3,4,7
ANA201009110,2010,100911,ANA,SEA,ANA01,4,7,11
ANA201009120,2010,100912,ANA,SEA,ANA01,0,3,3
ANA201009200,2010,100920,ANA,TEX,ANA01,4,7,11
ANA201009210,2010,100921,ANA,TEX,ANA01,0,2,2
ANA201009220,2010,100922,ANA,TEX,ANA01,2,1,3
ANA201009240,2010,100924,ANA,CHA,ANA01,2,1,3
ANA201009250,2010,100925,ANA,CHA,ANA01,6,2,8
ANA201009260,2010,100926,ANA,CHA,ANA01,4,3,7
ANA201009270,2010,100927,ANA,OAK,ANA01,5,6,11
ANA201009280,2010,100928,ANA,OAK,ANA01,2,4,6
ANA201009290,2010,100929,ANA,OAK,ANA01,1,2,3
ANA201104080,2011,20110408,ANA,TOR,ANA01,3,2,5
ANA201104090,2011,20110409,ANA,TOR,ANA01,5,6,11
ANA201104100,2011,20110410,ANA,TOR,ANA01,1,3,4
ANA201104110,2011,20110411,ANA,CLE,ANA01,4,0,4
ANA201104120,2011,20110412,ANA,CLE,ANA01,0,2,2
ANA201104130,2011,20110413,ANA,CLE,ANA01,3,4,7
ANA201104210,2011,20110421,ANA,BOS,ANA01,4,2,6
ANA201104220,2011,20110422,ANA,BOS,ANA01,4,3,7
ANA201104230,2011,20110423,ANA,BOS,ANA01,5,0,5
ANA201104240,2011,20110424,ANA,BOS,ANA01,7,0,7
ANA201104250,2011,20110425,ANA,OAK,ANA01,0,5,5
ANA201104260,2011,20110426,ANA,OAK,ANA01,3,8,11
ANA201104270,2011,20110427,ANA,OAK,ANA01,2,1,3
ANA201105060,2011,20110506,ANA,CLE,ANA01,1,2,3
ANA201105070,2011,20110507,ANA,CLE,ANA01,4,3,7
ANA201105080,2011,20110508,ANA,CLE,ANA01,5,6,11
ANA201105090,2011,20110509,ANA,CHA,ANA01,8,0,8
ANA201105100,2011,20110510,ANA,CHA,ANA01,2,6,8
ANA201105110,2011,20110511,ANA,CHA,ANA01,6,4,10
ANA201105200,2011,20110520,ANA,ATL,ANA01,0,9,9
ANA201105210,2011,20110521,ANA,ATL,ANA01,5,4,9
ANA201105220,2011,20110522,ANA,ATL,ANA01,1,4,5
ANA201105230,2011,20110523,ANA,OAK,ANA01,1,4,5
ANA201105240,2011,20110524,ANA,OAK,ANA01,6,1,7
ANA201105250,2011,20110525,ANA,OAK,ANA01,1,4,5
ANA201105260,2011,20110526,ANA,OAK,ANA01,4,3,7
ANA201106030,2011,20110603,ANA,NYA,ANA01,2,3,5
ANA201106040,2011,20110604,ANA,NYA,ANA01,3,2,5
ANA201106050,2011,20110605,ANA,NYA,ANA01,5,3,8
ANA201106060,2011,20110606,ANA,TBA,ANA01,5,1,6
ANA201106070,2011,20110607,ANA,TBA,ANA01,4,1,5
ANA201106080,2011,20110608,ANA,TBA,ANA01,4,3,7
ANA201106100,2011,20110610,ANA,KCA,ANA01,4,2,6
ANA201106110,2011,20110611,ANA,KCA,ANA01,5,7,12
ANA201106120,2011,20110612,ANA,KCA,ANA01,9,0,9
ANA201106270,2011,20110627,ANA,WAS,ANA01,3,4,7
ANA201106280,2011,20110628,ANA,WAS,ANA01,5,11,16
ANA201106290,2011,20110629,ANA,WAS,ANA01,0,1,1
ANA201107010,2011,20110701,ANA,LAN,ANA01,5,0,5
ANA201107020,2011,20110702,ANA,LAN,ANA01,1,7,8
ANA201107030,2011,20110703,ANA,LAN,ANA01,1,3,4
ANA201107040,2011,20110704,ANA,DET,ANA01,1,5,6
ANA201107050,2011,20110705,ANA,DET,ANA01,0,1,1
ANA201107060,2011,20110706,ANA,DET,ANA01,5,4,9
ANA201107070,2011,20110707,ANA,SEA,ANA01,1,5,6
ANA201107080,2011,20110708,ANA,SEA,ANA01,3,4,7
ANA201107090,2011,20110709,ANA,SEA,ANA01,3,9,12
ANA201107100,2011,20110710,ANA,SEA,ANA01,2,4,6
ANA201107190,2011,20110719,ANA,TEX,ANA01,7,0,7
ANA201107200,2011,20110720,ANA,TEX,ANA01,8,9,17
ANA201107210,2011,20110721,ANA,TEX,ANA01,0,1,1
ANA201108020,2011,20110802,ANA,MIN,ANA01,1,5,6
ANA201108030,2011,20110803,ANA,MIN,ANA01,11,4,15
ANA201108040,2011,20110804,ANA,MIN,ANA01,1,7,8
ANA201108050,2011,20110805,ANA,SEA,ANA01,0,1,1
ANA201108060,2011,20110806,ANA,SEA,ANA01,5,1,6
ANA201108070,2011,20110807,ANA,SEA,ANA01,1,2,3
ANA201108150,2011,20110815,ANA,TEX,ANA01,8,4,12
ANA201108160,2011,20110816,ANA,TEX,ANA01,7,3,10
ANA201108170,2011,20110817,ANA,TEX,ANA01,4,3,7
ANA201108180,2011,20110818,ANA,TEX,ANA01,1,2,3
ANA201108190,2011,20110819,ANA,BAL,ANA01,3,8,11
ANA201108200,2011,20110820,ANA,BAL,ANA01,8,9,17
ANA201108210,2011,20110821,ANA,BAL,ANA01,1,7,8
ANA201108230,2011,20110823,ANA,CHA,ANA01,4,5,9
ANA201108240,2011,20110824,ANA,CHA,ANA01,0,8,8
ANA201109020,2011,20110902,ANA,MIN,ANA01,13,5,18
ANA201109030,2011,20110903,ANA,MIN,ANA01,6,10,16
ANA201109040,2011,20110904,ANA,MIN,ANA01,1,4,5
ANA201109050,2011,20110905,ANA,SEA,ANA01,3,7,10
ANA201109060,2011,20110906,ANA,SEA,ANA01,2,1,3
ANA201109070,2011,20110907,ANA,SEA,ANA01,1,3,4
ANA201109090,2011,20110909,ANA,NYA,ANA01,1,2,3
ANA201109100,2011,20110910,ANA,NYA,ANA01,0,6,6
ANA201109110,2011,20110911,ANA,NYA,ANA01,6,5,11
ANA201109230,2011,20110923,ANA,OAK,ANA01,3,1,4
ANA201109240,2011,20110924,ANA,OAK,ANA01,2,4,6
ANA201109250,2011,20110925,ANA,OAK,ANA01,6,5,11
ANA201109260,2011,20110926,ANA,TEX,ANA01,4,3,7
ANA201109270,2011,20110927,ANA,TEX,ANA01,10,3,13
ANA201109280,2011,20110928,ANA,TEX,ANA01,3,1,4
ANA201204060,2012,120406,ANA,KCA,ANA01,0,5,5
ANA201204070,2012,120407,ANA,KCA,ANA01,6,3,9
ANA201204080,2012,120408,ANA,KCA,ANA01,7,3,10
ANA201204160,2012,120416,ANA,OAK,ANA01,0,6,6
ANA201204170,2012,120417,ANA,OAK,ANA01,5,3,8
ANA201204180,2012,120418,ANA,OAK,ANA01,6,0,6
ANA201204190,2012,120419,ANA,OAK,ANA01,4,2,6
ANA201204200,2012,120420,ANA,BAL,ANA01,3,6,9
ANA201204210,2012,120421,ANA,BAL,ANA01,3,6,9
ANA201204220,2012,120422,ANA,BAL,ANA01,3,2,5
ANA201204300,2012,120430,ANA,MIN,ANA01,3,4,7
ANA201205010,2012,120501,ANA,MIN,ANA01,0,4,4
ANA201205020,2012,120502,ANA,MIN,ANA01,0,9,9
ANA201205030,2012,120503,ANA,TOR,ANA01,5,0,5
ANA201205040,2012,120504,ANA,TOR,ANA01,4,0,4
ANA201205050,2012,120505,ANA,TOR,ANA01,2,6,8
ANA201205060,2012,120506,ANA,TOR,ANA01,3,4,7
ANA201205140,2012,120514,ANA,OAK,ANA01,5,0,5
ANA201205150,2012,120515,ANA,OAK,ANA01,0,4,4
ANA201205160,2012,120516,ANA,CHA,ANA01,2,7,9
ANA201205170,2012,120517,ANA,CHA,ANA01,6,1,7
ANA201205280,2012,120528,ANA,NYA,ANA01,8,9,17
ANA201205290,2012,120529,ANA,NYA,ANA01,1,5,6
ANA201205300,2012,120530,ANA,NYA,ANA01,6,5,11
ANA201206010,2012,120601,ANA,TEX,ANA01,2,4,6
ANA201206020,2012,120602,ANA,TEX,ANA01,2,3,5
ANA201206030,2012,120603,ANA,TEX,ANA01,7,3,10
ANA201206040,2012,120604,ANA,SEA,ANA01,8,6,14
ANA201206050,2012,120605,ANA,SEA,ANA01,1,6,7
ANA201206060,2012,120606,ANA,SEA,ANA01,8,6,14
ANA201206150,2012,120615,ANA,ARI,ANA01,5,0,5
ANA201206160,2012,120616,ANA,ARI,ANA01,0,2,2
ANA201206170,2012,120617,ANA,ARI,ANA01,0,2,2
ANA201206180,2012,120618,ANA,SFN,ANA01,5,3,8
ANA201206190,2012,120619,ANA,SFN,ANA01,5,12,17
ANA201206200,2012,120620,ANA,SFN,ANA01,0,6,6
ANA201206220,2012,120622,ANA,LAN,ANA01,5,8,13
ANA201206230,2012,120623,ANA,LAN,ANA01,3,1,4
ANA201206240,2012,120624,ANA,LAN,ANA01,3,5,8
ANA201207050,2012,120705,ANA,BAL,ANA01,7,9,16
ANA201207060,2012,120706,ANA,BAL,ANA01,3,2,5
ANA201207070,2012,120707,ANA,BAL,ANA01,0,3,3
ANA201207080,2012,120708,ANA,BAL,ANA01,0,6,6
ANA201207200,2012,120720,ANA,TEX,ANA01,1,6,7
ANA201207210,2012,120721,ANA,TEX,ANA01,9,2,11
ANA201207220,2012,120722,ANA,TEX,ANA01,4,7,11
ANA201207230,2012,120723,ANA,KCA,ANA01,3,6,9
ANA201207240,2012,120724,ANA,KCA,ANA01,4,1,5
ANA201207250,2012,120725,ANA,KCA,ANA01,6,11,17
ANA201207270,2012,120727,ANA,TBA,ANA01,1,3,4
ANA201207280,2012,120728,ANA,TBA,ANA01,3,0,3
ANA201207290,2012,120729,ANA,TBA,ANA01,2,0,2
ANA201208100,2012,120810,ANA,SEA,ANA01,5,6,11
ANA201208110,2012,120811,ANA,SEA,ANA01,7,4,11
ANA201208120,2012,120812,ANA,SEA,ANA01,4,1,5
ANA201208130,2012,120813,ANA,CLE,ANA01,6,2,8
ANA201208140,2012,120814,ANA,CLE,ANA01,6,9,15
ANA201208150,2012,120815,ANA,CLE,ANA01,4,8,12
ANA201208160,2012,120816,ANA,TBA,ANA01,7,0,7
ANA201208170,2012,120817,ANA,TBA,ANA01,12,3,15
ANA201208180,2012,120818,ANA,TBA,ANA01,10,8,18
ANA201208190,2012,120819,ANA,TBA,ANA01,8,3,11
ANA201208280,2012,120828,ANA,BOS,ANA01,5,6,11
ANA201208290,2012,120829,ANA,BOS,ANA01,3,10,13
ANA201208300,2012,120830,ANA,BOS,ANA01,2,5,7
ANA201209070,2012,120907,ANA,DET,ANA01,2,3,5
ANA201209080,2012,120908,ANA,DET,ANA01,1,6,7
ANA201209090,2012,120909,ANA,DET,ANA01,2,3,5
ANA201209100,2012,120910,ANA,OAK,ANA01,3,1,4
ANA201209110,2012,120911,ANA,OAK,ANA01,6,5,11
ANA201209120,2012,120912,ANA,OAK,ANA01,4,1,5
ANA201209130,2012,120913,ANA,OAK,ANA01,0,6,6
ANA201209180,2012,120918,ANA,TEX,ANA01,3,11,14
ANA201209190,2012,120919,ANA,TEX,ANA01,6,2,8
ANA201209200,2012,120920,ANA,TEX,ANA01,3,1,4
ANA201209210,2012,120921,ANA,CHA,ANA01,2,6,8
ANA201209220,2012,120922,ANA,CHA,ANA01,2,4,6
ANA201209230,2012,120923,ANA,CHA,ANA01,1,4,5
ANA201209250,2012,120925,ANA,SEA,ANA01,4,5,9
ANA201209260,2012,120926,ANA,SEA,ANA01,3,4,7
ANA201209270,2012,120927,ANA,SEA,ANA01,9,4,13
ANA201304090,2013,20130409,ANA,OAK,ANA01,9,5,14
ANA201304100,2013,20130410,ANA,OAK,ANA01,11,5,16
ANA201304110,2013,20130411,ANA,OAK,ANA01,8,1,9
ANA201304120,2013,20130412,ANA,HOU,ANA01,5,0,5
ANA201304130,2013,20130413,ANA,HOU,ANA01,4,5,9
ANA201304140,2013,20130414,ANA,HOU,ANA01,1,4,5
ANA201304190,2013,20130419,ANA,DET,ANA01,1,8,9
ANA201304200,2013,20130420,ANA,DET,ANA01,0,10,10
ANA201304210,2013,20130421,ANA,DET,ANA01,3,4,7
ANA201304220,2013,20130422,ANA,TEX,ANA01,7,6,13
ANA201304230,2013,20130423,ANA,TEX,ANA01,4,5,9
ANA201304240,2013,20130424,ANA,TEX,ANA01,11,3,14
ANA201305020,2013,20130502,ANA,BAL,ANA01,5,1,6
ANA201305030,2013,20130503,ANA,BAL,ANA01,0,4,4
ANA201305040,2013,20130504,ANA,BAL,ANA01,5,4,9
ANA201305050,2013,20130505,ANA,BAL,ANA01,8,4,12
ANA201305130,2013,20130513,ANA,KCA,ANA01,11,4,15
ANA201305140,2013,20130514,ANA,KCA,ANA01,2,6,8
ANA201305150,2013,20130515,ANA,KCA,ANA01,9,5,14
ANA201305160,2013,20130516,ANA,CHA,ANA01,5,4,9
ANA201305170,2013,20130517,ANA,CHA,ANA01,3,0,3
ANA201305180,2013,20130518,ANA,CHA,ANA01,9,12,21
ANA201305190,2013,20130519,ANA,CHA,ANA01,2,6,8
ANA201305210,2013,20130521,ANA,SEA,ANA01,0,12,12
ANA201305220,2013,20130522,ANA,SEA,ANA01,1,7,8
ANA201305290,2013,20130529,ANA,LAN,ANA01,3,4,7
ANA201305300,2013,20130530,ANA,LAN,ANA01,2,3,5
ANA201305310,2013,20130531,ANA,HOU,ANA01,6,3,9
ANA201306010,2013,20130601,ANA,HOU,ANA01,2,0,2
ANA201306020,2013,20130602,ANA,HOU,ANA01,5,4,9
ANA201306030,2013,20130603,ANA,HOU,ANA01,2,1,3
ANA201306040,2013,20130604,ANA,CHN,ANA01,3,4,7
ANA201306050,2013,20130605,ANA,CHN,ANA01,8,6,14
ANA201306140,2013,20130614,ANA,NYA,ANA01,2,5,7
ANA201306150,2013,20130615,ANA,NYA,ANA01,2,6,8
ANA201306160,2013,20130616,ANA,NYA,ANA01,6,5,11
ANA201306170,2013,20130617,ANA,SEA,ANA01,3,11,14
ANA201306180,2013,20130618,ANA,SEA,ANA01,3,2,5
ANA201306190,2013,20130619,ANA,SEA,ANA01,0,1,1
ANA201306200,2013,20130620,ANA,SEA,ANA01,9,10,19
ANA201306210,2013,20130621,ANA,PIT,ANA01,5,2,7
ANA201306220,2013,20130622,ANA,PIT,ANA01,6,1,7
ANA201306230,2013,20130623,ANA,PIT,ANA01,10,9,19
ANA201307020,2013,20130702,ANA,SLN,ANA01,1,5,6
ANA201307030,2013,20130703,ANA,SLN,ANA01,12,2,14
ANA201307040,2013,20130704,ANA,SLN,ANA01,5,6,11
ANA201307050,2013,20130705,ANA,BOS,ANA01,6,2,8
ANA201307060,2013,20130706,ANA,BOS,ANA01,7,9,16
ANA201307070,2013,20130707,ANA,BOS,ANA01,0,3,3
ANA201307190,2013,20130719,ANA,OAK,ANA01,1,4,5
ANA201307200,2013,20130720,ANA,OAK,ANA01,0,2,2
ANA201307210,2013,20130721,ANA,OAK,ANA01,6,0,6
ANA201307220,2013,20130722,ANA,MIN,ANA01,4,3,7
ANA201307230,2013,20130723,ANA,MIN,ANA01,10,3,13
ANA201307240,2013,20130724,ANA,MIN,ANA01,0,1,1
ANA201308010,2013,20130801,ANA,TOR,ANA01,2,8,10
ANA201308020,2013,20130802,ANA,TOR,ANA01,5,7,12
ANA201308030,2013,20130803,ANA,TOR,ANA01,3,7,10
ANA201308040,2013,20130804,ANA,TOR,ANA01,6,5,11
ANA201308050,2013,20130805,ANA,TEX,ANA01,5,2,7
ANA201308060,2013,20130806,ANA,TEX,ANA01,8,3,11
ANA201308070,2013,20130807,ANA,TEX,ANA01,10,3,13
ANA201308160,2013,20130816,ANA,HOU,ANA01,8,2,10
ANA201308170,2013,20130817,ANA,HOU,ANA01,5,6,11
ANA201308180,2013,20130818,ANA,HOU,ANA01,7,5,12
ANA201308190,2013,20130819,ANA,CLE,ANA01,5,2,7
ANA201308200,2013,20130820,ANA,CLE,ANA01,4,1,5
ANA201308210,2013,20130821,ANA,CLE,ANA01,3,1,4
ANA201309020,2013,20130902,ANA,TBA,ANA01,2,11,13
ANA201309030,2013,20130903,ANA,TBA,ANA01,7,1,8
ANA201309040,2013,20130904,ANA,TBA,ANA01,3,1,4
ANA201309050,2013,20130905,ANA,TBA,ANA01,2,6,8
ANA201309060,2013,20130906,ANA,TEX,ANA01,5,6,11
ANA201309070,2013,20130907,ANA,TEX,ANA01,3,8,11
ANA201309080,2013,20130908,ANA,TEX,ANA01,4,3,7
ANA201309200,2013,20130920,ANA,SEA,ANA01,2,3,5
ANA201309210,2013,20130921,ANA,SEA,ANA01,5,6,11
ANA201309220,2013,20130922,ANA,SEA,ANA01,3,2,5
ANA201309230,2013,20130923,ANA,OAK,ANA01,10,5,15
ANA201309240,2013,20130924,ANA,OAK,ANA01,0,3,3
ANA201309250,2013,20130925,ANA,OAK,ANA01,1,3,4
ARI201004050,2010,100405,ARI,SDN,PHO01,3,6,9
ARI201004060,2010,100406,ARI,SDN,PHO01,6,3,9
ARI201004070,2010,100407,ARI,SDN,PHO01,3,5,8
ARI201004090,2010,100409,ARI,PIT,PHO01,1,9,10
ARI201004100,2010,100410,ARI,PIT,PHO01,6,3,9
ARI201004110,2010,100411,ARI,PIT,PHO01,6,15,21
ARI201004190,2010,100419,ARI,SLN,PHO01,4,2,6
ARI201004200,2010,100420,ARI,SLN,PHO01,7,9,16
ARI201004210,2010,100421,ARI,SLN,PHO01,9,4,13
ARI201004230,2010,100423,ARI,PHI,PHO01,4,7,11
ARI201004240,2010,100424,ARI,PHI,PHO01,3,2,5
ARI201004250,2010,100425,ARI,PHI,PHO01,6,8,14
ARI201005070,2010,100507,ARI,MIL,PHO01,3,2,5
ARI201005080,2010,100508,ARI,MIL,PHO01,17,3,20
ARI201005090,2010,100509,ARI,MIL,PHO01,6,1,7
ARI201005100,2010,100510,ARI,LAN,PHO01,7,3,10
ARI201005110,2010,100511,ARI,LAN,PHO01,13,3,16
ARI201005120,2010,100512,ARI,LAN,PHO01,6,3,9
ARI201005190,2010,100519,ARI,SFN,PHO01,1,13,14
ARI201005200,2010,100520,ARI,SFN,PHO01,7,8,15
ARI201005210,2010,100521,ARI,TOR,PHO01,6,8,14
ARI201005220,2010,100522,ARI,TOR,PHO01,5,8,13
ARI201005230,2010,100523,ARI,TOR,PHO01,12,4,16
ARI201006040,2010,100604,ARI,COL,PHO01,6,7,13
ARI201006050,2010,100605,ARI,COL,PHO01,3,4,7
ARI201006060,2010,100606,ARI,COL,PHO01,3,2,5
ARI201006070,2010,100607,ARI,ATL,PHO01,4,7,11
ARI201006080,2010,100608,ARI,ATL,PHO01,7,5,12
ARI201006090,2010,100609,ARI,ATL,PHO01,1,2,3
ARI201006100,2010,100610,ARI,ATL,PHO01,11,7,18
ARI201006110,2010,100611,ARI,SLN,PHO01,5,2,7
ARI201006120,2010,100612,ARI,SLN,PHO01,2,7,9
ARI201006130,2010,100613,ARI,SLN,PHO01,5,7,12
ARI201006210,2010,100621,ARI,NYA,PHO01,4,10,14
ARI201006220,2010,100622,ARI,NYA,PHO01,9,3,12
ARI201006230,2010,100623,ARI,NYA,PHO01,6,5,11
ARI201007020,2010,100702,ARI,LAN,PHO01,5,12,17
ARI201007030,2010,100703,ARI,LAN,PHO01,14,1,15
ARI201007040,2010,100704,ARI,LAN,PHO01,3,1,4
ARI201007050,2010,100705,ARI,CHN,PHO01,9,4,13
ARI201007060,2010,100706,ARI,CHN,PHO01,6,4,10
ARI201007070,2010,100707,ARI,CHN,PHO01,8,3,11
ARI201007080,2010,100708,ARI,FLO,PHO01,4,10,14
ARI201007090,2010,100709,ARI,FLO,PHO01,3,2,5
ARI201007100,2010,100710,ARI,FLO,PHO01,4,5,9
ARI201007110,2010,100711,ARI,FLO,PHO01,2,0,2
ARI201007190,2010,100719,ARI,NYN,PHO01,2,13,15
ARI201007200,2010,100720,ARI,NYN,PHO01,2,3,5
ARI201007210,2010,100721,ARI,NYN,PHO01,3,4,7
ARI201007220,2010,100722,ARI,SFN,PHO01,3,0,3
ARI201007230,2010,100723,ARI,SFN,PHO01,7,4,11
ARI201007240,2010,100724,ARI,SFN,PHO01,10,4,14
ARI201007250,2010,100725,ARI,SFN,PHO01,3,2,5
ARI201008020,2010,100802,ARI,WAS,PHO01,3,1,4
ARI201008030,2010,100803,ARI,WAS,PHO01,1,6,7
ARI201008040,2010,100804,ARI,WAS,PHO01,7,2,9
ARI201008050,2010,100805,ARI,WAS,PHO01,4,8,12
ARI201008060,2010,100806,ARI,SDN,PHO01,1,2,3
ARI201008070,2010,100807,ARI,SDN,PHO01,5,6,11
ARI201008080,2010,100808,ARI,SDN,PHO01,10,1,11
ARI201008170,2010,100817,ARI,CIN,PHO01,6,2,8
ARI201008180,2010,100818,ARI,CIN,PHO01,11,7,18
ARI201008190,2010,100819,ARI,CIN,PHO01,9,5,14
ARI201008200,2010,100820,ARI,COL,PHO01,3,4,7
ARI201008210,2010,100821,ARI,COL,PHO01,1,3,4
ARI201008220,2010,100822,ARI,COL,PHO01,1,0,1
ARI201008300,2010,100830,ARI,SDN,PHO01,2,7,9
ARI201008310,2010,100831,ARI,SDN,PHO01,4,7,11
ARI201009010,2010,100901,ARI,SDN,PHO01,2,5,7
ARI201009030,2010,100903,ARI,HOU,PHO01,3,4,7
ARI201009040,2010,100904,ARI,HOU,PHO01,6,5,11
ARI201009050,2010,100905,ARI,HOU,PHO01,3,2,5
ARI201009060,2010,100906,ARI,SFN,PHO01,2,0,2
ARI201009070,2010,100907,ARI,SFN,PHO01,6,3,9
ARI201009080,2010,100908,ARI,SFN,PHO01,1,3,4
ARI201009210,2010,100921,ARI,COL,PHO01,1,3,4
ARI201009220,2010,100922,ARI,COL,PHO01,4,8,12
ARI201009230,2010,100923,ARI,COL,PHO01,9,10,19
ARI201009240,2010,100924,ARI,LAN,PHO01,3,1,4
ARI201009250,2010,100925,ARI,LAN,PHO01,2,5,7
ARI201009260,2010,100926,ARI,LAN,PHO01,4,5,9
ARI201104080,2011,20110408,ARI,CIN,PHO01,2,13,15
ARI201104090,2011,20110409,ARI,CIN,PHO01,6,1,7
ARI201104100,2011,20110410,ARI,CIN,PHO01,8,10,18
ARI201104110,2011,20110411,ARI,SLN,PHO01,8,2,10
ARI201104120,2011,20110412,ARI,SLN,PHO01,8,13,21
ARI201104130,2011,20110413,ARI,SLN,PHO01,15,5,20
ARI201104150,2011,20110415,ARI,SFN,PHO01,5,2,7
ARI201104160,2011,20110416,ARI,SFN,PHO01,5,3,8
ARI201104170,2011,20110417,ARI,SFN,PHO01,5,6,11
ARI201104250,2011,20110425,ARI,PHI,PHO01,0,4,4
ARI201104260,2011,20110426,ARI,PHI,PHO01,5,7,12
ARI201104270,2011,20110427,ARI,PHI,PHO01,8,4,12
ARI201104280,2011,20110428,ARI,CHN,PHO01,2,11,13
ARI201104290,2011,20110429,ARI,CHN,PHO01,4,2,6
ARI201104300,2011,20110430,ARI,CHN,PHO01,5,3,8
ARI201105010,2011,20110501,ARI,CHN,PHO01,3,4,7
ARI201105030,2011,20110503,ARI,COL,PHO01,3,4,7
ARI201105040,2011,20110504,ARI,COL,PHO01,6,4,10
ARI201105050,2011,20110505,ARI,COL,PHO01,2,3,5
ARI201105160,2011,20110516,ARI,SDN,PHO01,8,4,12
ARI201105170,2011,20110517,ARI,SDN,PHO01,1,6,7
ARI201105180,2011,20110518,ARI,ATL,PHO01,4,5,9
ARI201105190,2011,20110519,ARI,ATL,PHO01,1,2,3
ARI201105200,2011,20110520,ARI,MIN,PHO01,7,8,15
ARI201105210,2011,20110521,ARI,MIN,PHO01,6,9,15
ARI201105220,2011,20110522,ARI,MIN,PHO01,2,3,5
ARI201105300,2011,20110530,ARI,FLO,PHO01,4,15,19
ARI201105310,2011,20110531,ARI,FLO,PHO01,5,2,7
ARI201106010,2011,20110601,ARI,FLO,PHO01,5,6,11
ARI201106020,2011,20110602,ARI,WAS,PHO01,6,1,7
ARI201106030,2011,20110603,ARI,WAS,PHO01,0,4,4
ARI201106040,2011,20110604,ARI,WAS,PHO01,0,2,2
ARI201106050,2011,20110605,ARI,WAS,PHO01,9,4,13
ARI201106140,2011,20110614,ARI,SFN,PHO01,6,5,11
ARI201106150,2011,20110615,ARI,SFN,PHO01,5,2,7
ARI201106160,2011,20110616,ARI,SFN,PHO01,2,3,5
ARI201106170,2011,20110617,ARI,CHA,PHO01,1,4,5
ARI201106180,2011,20110618,ARI,CHA,PHO01,6,2,8
ARI201106190,2011,20110619,ARI,CHA,PHO01,8,2,10
ARI201106270,2011,20110627,ARI,CLE,PHO01,5,4,9
ARI201106280,2011,20110628,ARI,CLE,PHO01,4,6,10
ARI201106290,2011,20110629,ARI,CLE,PHO01,6,2,8
ARI201107150,2011,20110715,ARI,LAN,PHO01,6,4,10
ARI201107160,2011,20110716,ARI,LAN,PHO01,2,3,5
ARI201107170,2011,20110717,ARI,LAN,PHO01,1,4,5
ARI201107180,2011,20110718,ARI,MIL,PHO01,0,3,3
ARI201107190,2011,20110719,ARI,MIL,PHO01,11,3,14
ARI201107200,2011,20110720,ARI,MIL,PHO01,5,2,7
ARI201107210,2011,20110721,ARI,MIL,PHO01,0,4,4
ARI201107220,2011,20110722,ARI,COL,PHO01,8,4,12
ARI201107230,2011,20110723,ARI,COL,PHO01,3,12,15
ARI201107240,2011,20110724,ARI,COL,PHO01,0,7,7
ARI201108050,2011,20110805,ARI,LAN,PHO01,7,4,11
ARI201108060,2011,20110806,ARI,LAN,PHO01,5,3,8
ARI201108070,2011,20110807,ARI,LAN,PHO01,3,4,7
ARI201108080,2011,20110808,ARI,HOU,PHO01,9,1,10
ARI201108090,2011,20110809,ARI,HOU,PHO01,9,11,20
ARI201108100,2011,20110810,ARI,HOU,PHO01,3,6,9
ARI201108110,2011,20110811,ARI,HOU,PHO01,5,8,13
ARI201108120,2011,20110812,ARI,NYN,PHO01,3,4,7
ARI201108130,2011,20110813,ARI,NYN,PHO01,4,6,10
ARI201108140,2011,20110814,ARI,NYN,PHO01,3,5,8
ARI201108260,2011,20110826,ARI,SDN,PHO01,0,5,5
ARI201108270,2011,20110827,ARI,SDN,PHO01,1,3,4
ARI201108280,2011,20110828,ARI,SDN,PHO01,1,6,7
ARI201108290,2011,20110829,ARI,COL,PHO01,1,5,6
ARI201108300,2011,20110830,ARI,COL,PHO01,4,9,13
ARI201108310,2011,20110831,ARI,COL,PHO01,2,4,6
ARI201109080,2011,20110908,ARI,SDN,PHO01,1,4,5
ARI201109090,2011,20110909,ARI,SDN,PHO01,2,3,5
ARI201109100,2011,20110910,ARI,SDN,PHO01,5,6,11
ARI201109110,2011,20110911,ARI,SDN,PHO01,7,6,13
ARI201109190,2011,20110919,ARI,PIT,PHO01,0,1,1
ARI201109200,2011,20110920,ARI,PIT,PHO01,5,3,8
ARI201109210,2011,20110921,ARI,PIT,PHO01,5,8,13
ARI201109230,2011,20110923,ARI,SFN,PHO01,1,3,4
ARI201109240,2011,20110924,ARI,SFN,PHO01,2,15,17
ARI201109250,2011,20110925,ARI,SFN,PHO01,2,5,7
ARI201109260,2011,20110926,ARI,LAN,PHO01,4,2,6
ARI201109270,2011,20110927,ARI,LAN,PHO01,6,7,13
ARI201109280,2011,20110928,ARI,LAN,PHO01,7,5,12
ARI201110040,2011,20111004,ARI,MIL,PHO01,1,8,9
ARI201110050,2011,20111005,ARI,MIL,PHO01,6,10,16
ARI201204060,2012,120406,ARI,SFN,PHO01,4,5,9
ARI201204070,2012,120407,ARI,SFN,PHO01,4,5,9
ARI201204080,2012,120408,ARI,SFN,PHO01,6,7,13
ARI201204160,2012,120416,ARI,PIT,PHO01,1,5,6
ARI201204170,2012,120417,ARI,PIT,PHO01,5,4,9
ARI201204180,2012,120418,ARI,PIT,PHO01,2,1,3
ARI201204190,2012,120419,ARI,ATL,PHO01,10,2,12
ARI201204200,2012,120420,ARI,ATL,PHO01,9,1,10
ARI201204210,2012,120421,ARI,ATL,PHO01,3,2,5
ARI201204220,2012,120422,ARI,ATL,PHO01,4,6,10
ARI201204230,2012,120423,ARI,PHI,PHO01,5,9,14
ARI201204240,2012,120424,ARI,PHI,PHO01,8,5,13
ARI201204250,2012,120425,ARI,PHI,PHO01,7,2,9
ARI201205070,2012,120507,ARI,SLN,PHO01,9,6,15
ARI201205080,2012,120508,ARI,SLN,PHO01,6,1,7
ARI201205090,2012,120509,ARI,SLN,PHO01,7,2,9
ARI201205110,2012,120511,ARI,SFN,PHO01,1,5,6
ARI201205120,2012,120512,ARI,SFN,PHO01,5,2,7
ARI201205130,2012,120513,ARI,SFN,PHO01,7,3,10
ARI201205210,2012,120521,ARI,LAN,PHO01,6,1,7
ARI201205220,2012,120522,ARI,LAN,PHO01,8,7,15
ARI201205230,2012,120523,ARI,LAN,PHO01,4,11,15
ARI201205250,2012,120525,ARI,MIL,PHO01,7,1,8
ARI201205260,2012,120526,ARI,MIL,PHO01,5,8,13
ARI201205270,2012,120527,ARI,MIL,PHO01,3,4,7
ARI201206040,2012,120604,ARI,COL,PHO01,4,0,4
ARI201206050,2012,120605,ARI,COL,PHO01,0,10,10
ARI201206060,2012,120606,ARI,COL,PHO01,1,6,7
ARI201206080,2012,120608,ARI,OAK,PHO01,8,9,17
ARI201206090,2012,120609,ARI,OAK,PHO01,3,8,11
ARI201206100,2012,120610,ARI,OAK,PHO01,3,4,7
ARI201206180,2012,120618,ARI,SEA,PHO01,1,7,8
ARI201206190,2012,120619,ARI,SEA,PHO01,12,9,21
ARI201206200,2012,120620,ARI,SEA,PHO01,10,14,24
ARI201206220,2012,120622,ARI,CHN,PHO01,1,6,7
ARI201206230,2012,120623,ARI,CHN,PHO01,5,10,15
ARI201206240,2012,120624,ARI,CHN,PHO01,1,5,6
ARI201207020,2012,120702,ARI,SDN,PHO01,6,2,8
ARI201207030,2012,120703,ARI,SDN,PHO01,9,5,14
ARI201207040,2012,120704,ARI,SDN,PHO01,8,6,14
ARI201207050,2012,120705,ARI,LAN,PHO01,4,1,5
ARI201207060,2012,120706,ARI,LAN,PHO01,3,5,8
ARI201207070,2012,120707,ARI,LAN,PHO01,3,5,8
ARI201207080,2012,120708,ARI,LAN,PHO01,1,7,8
ARI201207200,2012,120720,ARI,HOU,PHO01,8,13,21
ARI201207210,2012,120721,ARI,HOU,PHO01,3,12,15
ARI201207220,2012,120722,ARI,HOU,PHO01,2,8,10
ARI201207230,2012,120723,ARI,COL,PHO01,3,6,9
ARI201207240,2012,120724,ARI,COL,PHO01,2,6,8
ARI201207250,2012,120725,ARI,COL,PHO01,4,2,6
ARI201207260,2012,120726,ARI,NYN,PHO01,3,1,4
ARI201207270,2012,120727,ARI,NYN,PHO01,5,11,16
ARI201207280,2012,120728,ARI,NYN,PHO01,3,6,9
ARI201207290,2012,120729,ARI,NYN,PHO01,5,1,6
ARI201208100,2012,120810,ARI,WAS,PHO01,9,1,10
ARI201208110,2012,120811,ARI,WAS,PHO01,6,5,11
ARI201208120,2012,120812,ARI,WAS,PHO01,4,7,11
ARI201208200,2012,120820,ARI,MIA,PHO01,12,3,15
ARI201208210,2012,120821,ARI,MIA,PHO01,6,5,11
ARI201208221,2012,120822,ARI,MIA,PHO01,2,3,5
ARI201208222,2012,120822,ARI,MIA,PHO01,0,3,3
ARI201208240,2012,120824,ARI,SDN,PHO01,5,0,5
ARI201208250,2012,120825,ARI,SDN,PHO01,9,3,12
ARI201208260,2012,120826,ARI,SDN,PHO01,5,4,9
ARI201208270,2012,120827,ARI,CIN,PHO01,3,2,5
ARI201208280,2012,120828,ARI,CIN,PHO01,5,2,7
ARI201208290,2012,120829,ARI,CIN,PHO01,6,2,8
ARI201209110,2012,120911,ARI,LAN,PHO01,0,1,1
ARI201209120,2012,120912,ARI,LAN,PHO01,2,3,5
ARI201209140,2012,120914,ARI,SFN,PHO01,6,2,8
ARI201209150,2012,120915,ARI,SFN,PHO01,3,2,5
ARI201209160,2012,120916,ARI,SFN,PHO01,2,10,12
ARI201209180,2012,120918,ARI,SDN,PHO01,2,3,5
ARI201209190,2012,120919,ARI,SDN,PHO01,2,6,8
ARI201209200,2012,120920,ARI,SDN,PHO01,6,5,11
ARI201209280,2012,120928,ARI,CHN,PHO01,3,8,11
ARI201209290,2012,120929,ARI,CHN,PHO01,2,8,10
ARI201209300,2012,120930,ARI,CHN,PHO01,7,2,9
ARI201210010,2012,121001,ARI,COL,PHO01,7,5,12
ARI201210020,2012,121002,ARI,COL,PHO01,3,5,8
ARI201210030,2012,121003,ARI,COL,PHO01,2,1,3
ARI201304010,2013,20130401,ARI,SLN,PHO01,2,6,8
ARI201304020,2013,20130402,ARI,SLN,PHO01,6,1,7
ARI201304030,2013,20130403,ARI,SLN,PHO01,9,10,19
ARI201304080,2013,20130408,ARI,PIT,PHO01,5,3,8
ARI201304090,2013,20130409,ARI,PIT,PHO01,6,5,11
ARI201304100,2013,20130410,ARI,PIT,PHO01,2,10,12
ARI201304120,2013,20130412,ARI,LAN,PHO01,0,3,3
ARI201304130,2013,20130413,ARI,LAN,PHO01,7,5,12
ARI201304140,2013,20130414,ARI,LAN,PHO01,0,1,1
ARI201304250,2013,20130425,ARI,COL,PHO01,2,3,5
ARI201304260,2013,20130426,ARI,COL,PHO01,6,3,9
ARI201304270,2013,20130427,ARI,COL,PHO01,2,3,5
ARI201304280,2013,20130428,ARI,COL,PHO01,2,4,6
ARI201304290,2013,20130429,ARI,SFN,PHO01,6,4,10
ARI201304300,2013,20130430,ARI,SFN,PHO01,2,1,3
ARI201305010,2013,20130501,ARI,SFN,PHO01,9,6,15
ARI201305090,2013,20130509,ARI,PHI,PHO01,1,2,3
ARI201305100,2013,20130510,ARI,PHI,PHO01,2,3,5
ARI201305110,2013,20130511,ARI,PHI,PHO01,3,1,4
ARI201305120,2013,20130512,ARI,PHI,PHO01,4,2,6
ARI201305130,2013,20130513,ARI,ATL,PHO01,10,1,11
ARI201305140,2013,20130514,ARI,ATL,PHO01,0,2,2
ARI201305150,2013,20130515,ARI,ATL,PHO01,3,5,8
ARI201305240,2013,20130524,ARI,SDN,PHO01,2,5,7
ARI201305250,2013,20130525,ARI,SDN,PHO01,10,4,14
ARI201305260,2013,20130526,ARI,SDN,PHO01,5,6,11
ARI201305271,2013,20130527,ARI,TEX,PHO01,3,5,8
ARI201305272,2013,20130527,ARI,TEX,PHO01,4,5,9
ARI201306070,2013,20130607,ARI,SFN,PHO01,1,3,4
ARI201306080,2013,20130608,ARI,SFN,PHO01,10,5,15
ARI201306090,2013,20130609,ARI,SFN,PHO01,6,2,8
ARI201306170,2013,20130617,ARI,MIA,PHO01,3,2,5
ARI201306180,2013,20130618,ARI,MIA,PHO01,2,3,5
ARI201306190,2013,20130619,ARI,MIA,PHO01,1,3,4
ARI201306210,2013,20130621,ARI,CIN,PHO01,5,11,16
ARI201306220,2013,20130622,ARI,CIN,PHO01,3,4,7
ARI201306230,2013,20130623,ARI,CIN,PHO01,4,2,6
ARI201307050,2013,20130705,ARI,COL,PHO01,0,5,5
ARI201307060,2013,20130706,ARI,COL,PHO01,1,11,12
ARI201307070,2013,20130707,ARI,COL,PHO01,1,6,7
ARI201307080,2013,20130708,ARI,LAN,PHO01,6,1,7
ARI201307090,2013,20130709,ARI,LAN,PHO01,6,1,7
ARI201307100,2013,20130710,ARI,LAN,PHO01,7,5,12
ARI201307110,2013,20130711,ARI,MIL,PHO01,3,5,8
ARI201307120,2013,20130712,ARI,MIL,PHO01,1,2,3
ARI201307130,2013,20130713,ARI,MIL,PHO01,4,5,9
ARI201307140,2013,20130714,ARI,MIL,PHO01,5,1,6
ARI201307220,2013,20130722,ARI,CHN,PHO01,4,2,6
ARI201307230,2013,20130723,ARI,CHN,PHO01,4,10,14
ARI201307240,2013,20130724,ARI,CHN,PHO01,7,6,13
ARI201307250,2013,20130725,ARI,CHN,PHO01,1,3,4
ARI201307260,2013,20130726,ARI,SDN,PHO01,0,10,10
ARI201307270,2013,20130727,ARI,SDN,PHO01,12,3,15
ARI201307280,2013,20130728,ARI,SDN,PHO01,1,0,1
ARI201308060,2013,20130806,ARI,TBA,PHO01,1,6,7
ARI201308070,2013,20130807,ARI,TBA,PHO01,8,9,17
ARI201308090,2013,20130809,ARI,NYN,PHO01,4,5,9
ARI201308100,2013,20130810,ARI,NYN,PHO01,4,1,5
ARI201308110,2013,20130811,ARI,NYN,PHO01,9,5,14
ARI201308120,2013,20130812,ARI,BAL,PHO01,6,7,13
ARI201308130,2013,20130813,ARI,BAL,PHO01,3,4,7
ARI201308140,2013,20130814,ARI,BAL,PHO01,4,5,9
ARI201308260,2013,20130826,ARI,SDN,PHO01,1,6,7
ARI201308270,2013,20130827,ARI,SDN,PHO01,9,10,19
ARI201308280,2013,20130828,ARI,SDN,PHO01,5,1,6
ARI201308300,2013,20130830,ARI,SFN,PHO01,1,0,1
ARI201308310,2013,20130831,ARI,SFN,PHO01,3,4,7
ARI201309010,2013,20130901,ARI,SFN,PHO01,8,2,10
ARI201309020,2013,20130902,ARI,TOR,PHO01,4,1,5
ARI201309030,2013,20130903,ARI,TOR,PHO01,10,4,14
ARI201309040,2013,20130904,ARI,TOR,PHO01,3,4,7
ARI201309130,2013,20130913,ARI,COL,PHO01,7,5,12
ARI201309140,2013,20130914,ARI,COL,PHO01,2,9,11
ARI201309150,2013,20130915,ARI,COL,PHO01,2,8,10
ARI201309160,2013,20130916,ARI,LAN,PHO01,1,2,3
ARI201309170,2013,20130917,ARI,LAN,PHO01,9,3,12
ARI201309180,2013,20130918,ARI,LAN,PHO01,4,9,13
ARI201309190,2013,20130919,ARI,LAN,PHO01,7,6,13
ARI201309270,2013,20130927,ARI,WAS,PHO01,8,4,12
ARI201309280,2013,20130928,ARI,WAS,PHO01,2,0,2
ARI201309290,2013,20130929,ARI,WAS,PHO01,2,3,5
ATL201004050,2010,100405,ATL,CHN,ATL02,5,16,21
ATL201004070,2010,100407,ATL,CHN,ATL02,2,3,5
ATL201004080,2010,100408,ATL,CHN,ATL02,2,0,2
ATL201004160,2010,100416,ATL,COL,ATL02,5,9,14
ATL201004170,2010,100417,ATL,COL,ATL02,4,0,4
ATL201004180,2010,100418,ATL,COL,ATL02,3,4,7
ATL201004200,2010,100420,ATL,PHI,ATL02,3,4,7
ATL201004210,2010,100421,ATL,PHI,ATL02,2,0,2
ATL201004220,2010,100422,ATL,PHI,ATL02,8,3,11
ATL201004300,2010,100430,ATL,HOU,ATL02,2,4,6
ATL201005010,2010,100501,ATL,HOU,ATL02,1,10,11
ATL201005020,2010,100502,ATL,HOU,ATL02,1,7,8
ATL201005140,2010,100514,ATL,ARI,ATL02,5,6,11
ATL201005150,2010,100515,ATL,ARI,ATL02,11,1,12
ATL201005160,2010,100516,ATL,ARI,ATL02,1,13,14
ATL201005170,2010,100517,ATL,NYN,ATL02,3,2,5
ATL201005180,2010,100518,ATL,NYN,ATL02,2,3,5
ATL201005190,2010,100519,ATL,CIN,ATL02,4,5,9
ATL201005200,2010,100520,ATL,CIN,ATL02,9,10,19
ATL201005280,2010,100528,ATL,PIT,ATL02,3,7,10
ATL201005290,2010,100529,ATL,PIT,ATL02,3,6,9
ATL201005300,2010,100530,ATL,PIT,ATL02,2,5,7
ATL201005310,2010,100531,ATL,PHI,ATL02,3,9,12
ATL201006010,2010,100601,ATL,PHI,ATL02,3,7,10
ATL201006020,2010,100602,ATL,PHI,ATL02,1,2,3
ATL201006150,2010,100615,ATL,TBA,ATL02,10,4,14
ATL201006160,2010,100616,ATL,TBA,ATL02,2,6,8
ATL201006170,2010,100617,ATL,TBA,ATL02,1,3,4
ATL201006180,2010,100618,ATL,KCA,ATL02,4,6,10
ATL201006190,2010,100619,ATL,KCA,ATL02,4,5,9
ATL201006200,2010,100620,ATL,KCA,ATL02,5,8,13
ATL201006250,2010,100625,ATL,DET,ATL02,1,3,4
ATL201006260,2010,100626,ATL,DET,ATL02,3,4,7
ATL201006270,2010,100627,ATL,DET,ATL02,10,4,14
ATL201006280,2010,100628,ATL,WAS,ATL02,0,5,5
ATL201006290,2010,100629,ATL,WAS,ATL02,7,2,9
ATL201006300,2010,100630,ATL,WAS,ATL02,1,4,5
ATL201007020,2010,100702,ATL,FLO,ATL02,3,4,7
ATL201007030,2010,100703,ATL,FLO,ATL02,1,4,5
ATL201007040,2010,100704,ATL,FLO,ATL02,3,2,5
ATL201007150,2010,100715,ATL,MIL,ATL02,1,2,3
ATL201007160,2010,100716,ATL,MIL,ATL02,9,3,12
ATL201007170,2010,100717,ATL,MIL,ATL02,6,3,9
ATL201007180,2010,100718,ATL,MIL,ATL02,6,11,17
ATL201007200,2010,100720,ATL,SDN,ATL02,1,4,5
ATL201007210,2010,100721,ATL,SDN,ATL02,6,4,10
ATL201007220,2010,100722,ATL,SDN,ATL02,0,8,8
ATL201008020,2010,100802,ATL,NYN,ATL02,1,4,5
ATL201008030,2010,100803,ATL,NYN,ATL02,3,2,5
ATL201008040,2010,100804,ATL,NYN,ATL02,3,8,11
ATL201008050,2010,100805,ATL,SFN,ATL02,2,3,5
ATL201008060,2010,100806,ATL,SFN,ATL02,3,2,5
ATL201008070,2010,100807,ATL,SFN,ATL02,0,3,3
ATL201008080,2010,100808,ATL,SFN,ATL02,3,6,9
ATL201008130,2010,100813,ATL,LAN,ATL02,0,1,1
ATL201008140,2010,100814,ATL,LAN,ATL02,2,1,3
ATL201008150,2010,100815,ATL,LAN,ATL02,1,13,14
ATL201008160,2010,100816,ATL,LAN,ATL02,3,4,7
ATL201008170,2010,100817,ATL,WAS,ATL02,2,10,12
ATL201008180,2010,100818,ATL,WAS,ATL02,2,3,5
ATL201008190,2010,100819,ATL,WAS,ATL02,6,2,8
ATL201008270,2010,100827,ATL,FLO,ATL02,7,1,8
ATL201008280,2010,100828,ATL,FLO,ATL02,3,12,15
ATL201008290,2010,100829,ATL,FLO,ATL02,6,7,13
ATL201008300,2010,100830,ATL,NYN,ATL02,3,9,12
ATL201008310,2010,100831,ATL,NYN,ATL02,2,9,11
ATL201009010,2010,100901,ATL,NYN,ATL02,1,4,5
ATL201009020,2010,100902,ATL,NYN,ATL02,4,2,6
ATL201009090,2010,100909,ATL,SLN,ATL02,11,4,15
ATL201009100,2010,100910,ATL,SLN,ATL02,6,8,14
ATL201009110,2010,100911,ATL,SLN,ATL02,3,6,9
ATL201009120,2010,100912,ATL,SLN,ATL02,7,3,10
ATL201009130,2010,100913,ATL,WAS,ATL02,0,4,4
ATL201009140,2010,100914,ATL,WAS,ATL02,6,0,6
ATL201009150,2010,100915,ATL,WAS,ATL02,4,2,6
ATL201009270,2010,100927,ATL,FLO,ATL02,1,2,3
ATL201009280,2010,100928,ATL,FLO,ATL02,2,3,5
ATL201009290,2010,100929,ATL,FLO,ATL02,1,5,6
ATL201010010,2010,101001,ATL,PHI,ATL02,11,5,16
ATL201010020,2010,101002,ATL,PHI,ATL02,7,0,7
ATL201010030,2010,101003,ATL,PHI,ATL02,7,8,15
ATL201010100,2010,101010,ATL,SFN,ATL02,3,2,5
ATL201010110,2010,101011,ATL,SFN,ATL02,3,2,5
ATL201104080,2011,20110408,ATL,PHI,ATL02,3,6,9
ATL201104090,2011,20110409,ATL,PHI,ATL02,10,2,12
ATL201104100,2011,20110410,ATL,PHI,ATL02,3,0,3
ATL201104120,2011,20110412,ATL,FLO,ATL02,0,5,5
ATL201104130,2011,20110413,ATL,FLO,ATL02,5,1,6
ATL201104140,2011,20110414,ATL,FLO,ATL02,6,5,11
ATL201104161,2011,20110416,ATL,NYN,ATL02,2,4,6
ATL201104162,2011,20110416,ATL,NYN,ATL02,0,4,4
ATL201104170,2011,20110417,ATL,NYN,ATL02,3,2,5
ATL201104290,2011,20110429,ATL,SLN,ATL02,5,3,8
ATL201104300,2011,20110430,ATL,SLN,ATL02,3,2,5
ATL201105010,2011,20110501,ATL,SLN,ATL02,5,6,11
ATL201105020,2011,20110502,ATL,MIL,ATL02,2,6,8
ATL201105041,2011,20110504,ATL,MIL,ATL02,3,8,11
ATL201105042,2011,20110504,ATL,MIL,ATL02,0,8,8
ATL201105050,2011,20110505,ATL,MIL,ATL02,1,2,3
ATL201105100,2011,20110510,ATL,WAS,ATL02,7,6,13
ATL201105110,2011,20110511,ATL,WAS,ATL02,7,3,10
ATL201105120,2011,20110512,ATL,WAS,ATL02,5,6,11
ATL201105130,2011,20110513,ATL,PHI,ATL02,5,4,9
ATL201105140,2011,20110514,ATL,PHI,ATL02,3,5,8
ATL201105150,2011,20110515,ATL,PHI,ATL02,2,3,5
ATL201105160,2011,20110516,ATL,HOU,ATL02,2,3,5
ATL201105170,2011,20110517,ATL,HOU,ATL02,1,3,4
ATL201105270,2011,20110527,ATL,CIN,ATL02,5,1,6
ATL201105280,2011,20110528,ATL,CIN,ATL02,6,7,13
ATL201105290,2011,20110529,ATL,CIN,ATL02,1,2,3
ATL201105300,2011,20110530,ATL,SDN,ATL02,3,2,5
ATL201105310,2011,20110531,ATL,SDN,ATL02,5,4,9
ATL201106010,2011,20110601,ATL,SDN,ATL02,3,4,7
ATL201106140,2011,20110614,ATL,NYN,ATL02,4,3,7
ATL201106150,2011,20110615,ATL,NYN,ATL02,4,0,4
ATL201106160,2011,20110616,ATL,NYN,ATL02,8,9,17
ATL201106170,2011,20110617,ATL,TEX,ATL02,6,2,8
ATL201106180,2011,20110618,ATL,TEX,ATL02,5,4,9
ATL201106190,2011,20110619,ATL,TEX,ATL02,2,4,6
ATL201106200,2011,20110620,ATL,TOR,ATL02,0,2,2
ATL201106210,2011,20110621,ATL,TOR,ATL02,1,5,6
ATL201106220,2011,20110622,ATL,TOR,ATL02,1,5,6
ATL201107010,2011,20110701,ATL,BAL,ATL02,0,4,4
ATL201107020,2011,20110702,ATL,BAL,ATL02,4,5,9
ATL201107030,2011,20110703,ATL,BAL,ATL02,5,4,9
ATL201107040,2011,20110704,ATL,COL,ATL02,1,4,5
ATL201107050,2011,20110705,ATL,COL,ATL02,3,5,8
ATL201107060,2011,20110706,ATL,COL,ATL02,1,9,10
ATL201107070,2011,20110707,ATL,COL,ATL02,3,6,9
ATL201107150,2011,20110715,ATL,WAS,ATL02,1,11,12
ATL201107160,2011,20110716,ATL,WAS,ATL02,5,2,7
ATL201107170,2011,20110717,ATL,WAS,ATL02,8,9,17
ATL201107250,2011,20110725,ATL,PIT,ATL02,3,1,4
ATL201107260,2011,20110726,ATL,PIT,ATL02,3,4,7
ATL201107270,2011,20110727,ATL,PIT,ATL02,1,2,3
ATL201107280,2011,20110728,ATL,PIT,ATL02,5,2,7
ATL201107290,2011,20110729,ATL,FLO,ATL02,0,5,5
ATL201107300,2011,20110730,ATL,FLO,ATL02,1,5,6
ATL201107310,2011,20110731,ATL,FLO,ATL02,3,1,4
ATL201108120,2011,20110812,ATL,CHN,ATL02,4,10,14
ATL201108130,2011,20110813,ATL,CHN,ATL02,8,4,12
ATL201108140,2011,20110814,ATL,CHN,ATL02,6,5,11
ATL201108150,2011,20110815,ATL,SFN,ATL02,4,5,9
ATL201108160,2011,20110816,ATL,SFN,ATL02,1,2,3
ATL201108170,2011,20110817,ATL,SFN,ATL02,7,5,12
ATL201108180,2011,20110818,ATL,SFN,ATL02,0,1,1
ATL201108190,2011,20110819,ATL,ARI,ATL02,2,4,6
ATL201108200,2011,20110820,ATL,ARI,ATL02,1,8,9
ATL201108210,2011,20110821,ATL,ARI,ATL02,0,1,1
ATL201108300,2011,20110830,ATL,WAS,ATL02,9,2,11
ATL201108310,2011,20110831,ATL,WAS,ATL02,1,3,4
ATL201109010,2011,20110901,ATL,WAS,ATL02,2,5,7
ATL201109020,2011,20110902,ATL,LAN,ATL02,8,6,14
ATL201109030,2011,20110903,ATL,LAN,ATL02,2,1,3
ATL201109040,2011,20110904,ATL,LAN,ATL02,3,4,7
ATL201109120,2011,20110912,ATL,FLO,ATL02,5,4,9
ATL201109130,2011,20110913,ATL,FLO,ATL02,1,7,8
ATL201109140,2011,20110914,ATL,FLO,ATL02,1,4,5
ATL201109160,2011,20110916,ATL,NYN,ATL02,12,2,14
ATL201109170,2011,20110917,ATL,NYN,ATL02,0,1,1
ATL201109180,2011,20110918,ATL,NYN,ATL02,7,5,12
ATL201109260,2011,20110926,ATL,PHI,ATL02,4,2,6
ATL201109270,2011,20110927,ATL,PHI,ATL02,7,1,8
ATL201109280,2011,20110928,ATL,PHI,ATL02,4,3,7
ATL201204130,2012,120413,ATL,MIL,ATL02,8,10,18
ATL201204140,2012,120414,ATL,MIL,ATL02,1,2,3
ATL201204150,2012,120415,ATL,MIL,ATL02,4,7,11
ATL201204160,2012,120416,ATL,NYN,ATL02,6,1,7
ATL201204170,2012,120417,ATL,NYN,ATL02,3,9,12
ATL201204180,2012,120418,ATL,NYN,ATL02,6,14,20
ATL201204270,2012,120427,ATL,PIT,ATL02,1,6,7
ATL201204280,2012,120428,ATL,PIT,ATL02,4,2,6
ATL201204290,2012,120429,ATL,PIT,ATL02,3,4,7
ATL201204300,2012,120430,ATL,PIT,ATL02,9,3,12
ATL201205010,2012,120501,ATL,PHI,ATL02,4,2,6
ATL201205020,2012,120502,ATL,PHI,ATL02,13,15,28
ATL201205030,2012,120503,ATL,PHI,ATL02,4,0,4
ATL201205140,2012,120514,ATL,CIN,ATL02,3,1,4
ATL201205150,2012,120515,ATL,CIN,ATL02,2,6,8
ATL201205160,2012,120516,ATL,MIA,ATL02,8,4,12
ATL201205170,2012,120517,ATL,MIA,ATL02,0,7,7
ATL201205250,2012,120525,ATL,WAS,ATL02,7,4,11
ATL201205260,2012,120526,ATL,WAS,ATL02,8,4,12
ATL201205270,2012,120527,ATL,WAS,ATL02,7,2,9
ATL201205280,2012,120528,ATL,SLN,ATL02,8,2,10
ATL201205290,2012,120529,ATL,SLN,ATL02,4,5,9
ATL201205300,2012,120530,ATL,SLN,ATL02,7,10,17
ATL201206080,2012,120608,ATL,TOR,ATL02,3,4,7
ATL201206090,2012,120609,ATL,TOR,ATL02,2,5,7
ATL201206100,2012,120610,ATL,TOR,ATL02,12,4,16
ATL201206110,2012,120611,ATL,NYA,ATL02,3,0,3
ATL201206120,2012,120612,ATL,NYA,ATL02,6,4,10
ATL201206130,2012,120613,ATL,NYA,ATL02,3,2,5
ATL201206150,2012,120615,ATL,BAL,ATL02,2,4,6
ATL201206160,2012,120616,ATL,BAL,ATL02,5,0,5
ATL201206170,2012,120617,ATL,BAL,ATL02,2,0,2
ATL201206260,2012,120626,ATL,ARI,ATL02,1,8,9
ATL201206270,2012,120627,ATL,ARI,ATL02,4,6,10
ATL201206280,2012,120628,ATL,ARI,ATL02,3,2,5
ATL201206290,2012,120629,ATL,WAS,ATL02,5,4,9
ATL201206300,2012,120630,ATL,WAS,ATL02,5,7,12
ATL201207010,2012,120701,ATL,WAS,ATL02,8,4,12
ATL201207020,2012,120702,ATL,CHN,ATL02,4,1,5
ATL201207030,2012,120703,ATL,CHN,ATL02,3,10,13
ATL201207040,2012,120704,ATL,CHN,ATL02,5,1,6
ATL201207050,2012,120705,ATL,CHN,ATL02,3,7,10
ATL201207130,2012,120713,ATL,NYN,ATL02,5,7,12
ATL201207140,2012,120714,ATL,NYN,ATL02,7,8,15
ATL201207150,2012,120715,ATL,NYN,ATL02,1,6,7
ATL201207170,2012,120717,ATL,SFN,ATL02,9,0,9
ATL201207180,2012,120718,ATL,SFN,ATL02,9,4,13
ATL201207190,2012,120719,ATL,SFN,ATL02,2,3,5
ATL201207270,2012,120727,ATL,PHI,ATL02,1,6,7
ATL201207280,2012,120728,ATL,PHI,ATL02,1,2,3
ATL201207290,2012,120729,ATL,PHI,ATL02,2,6,8
ATL201207300,2012,120730,ATL,MIA,ATL02,2,8,10
ATL201207310,2012,120731,ATL,MIA,ATL02,1,7,8
ATL201208010,2012,120801,ATL,MIA,ATL02,4,2,6
ATL201208020,2012,120802,ATL,MIA,ATL02,1,6,7
ATL201208030,2012,120803,ATL,HOU,ATL02,1,4,5
ATL201208040,2012,120804,ATL,HOU,ATL02,3,2,5
ATL201208050,2012,120805,ATL,HOU,ATL02,1,6,7
ATL201208130,2012,120813,ATL,SDN,ATL02,4,1,5
ATL201208140,2012,120814,ATL,SDN,ATL02,0,6,6
ATL201208150,2012,120815,ATL,SDN,ATL02,1,6,7
ATL201208160,2012,120816,ATL,SDN,ATL02,0,6,6
ATL201208170,2012,120817,ATL,LAN,ATL02,3,4,7
ATL201208180,2012,120818,ATL,LAN,ATL02,6,2,8
ATL201208190,2012,120819,ATL,LAN,ATL02,5,0,5
ATL201208310,2012,120831,ATL,PHI,ATL02,8,5,13
ATL201209010,2012,120901,ATL,PHI,ATL02,5,1,6
ATL201209020,2012,120902,ATL,PHI,ATL02,7,8,15
ATL201209030,2012,120903,ATL,COL,ATL02,1,6,7
ATL201209040,2012,120904,ATL,COL,ATL02,6,0,6
ATL201209050,2012,120905,ATL,COL,ATL02,0,1,1
ATL201209060,2012,120906,ATL,COL,ATL02,0,1,1
ATL201209140,2012,120914,ATL,WAS,ATL02,1,2,3
ATL201209150,2012,120915,ATL,WAS,ATL02,4,5,9
ATL201209160,2012,120916,ATL,WAS,ATL02,1,5,6
ATL201209250,2012,120925,ATL,MIA,ATL02,3,4,7
ATL201209260,2012,120926,ATL,MIA,ATL02,0,3,3
ATL201209270,2012,120927,ATL,MIA,ATL02,2,6,8
ATL201209280,2012,120928,ATL,NYN,ATL02,3,1,4
ATL201209290,2012,120929,ATL,NYN,ATL02,0,2,2
ATL201209300,2012,120930,ATL,NYN,ATL02,2,6,8
ATL201210050,2012,121005,ATL,SLN,ATL02,6,3,9
ATL201304010,2013,20130401,ATL,PHI,ATL02,5,7,12
ATL201304030,2013,20130403,ATL,PHI,ATL02,2,9,11
ATL201304040,2013,20130404,ATL,PHI,ATL02,2,0,2
ATL201304050,2013,20130405,ATL,CHN,ATL02,1,4,5
ATL201304060,2013,20130406,ATL,CHN,ATL02,5,6,11
ATL201304070,2013,20130407,ATL,CHN,ATL02,1,5,6
ATL201304160,2013,20130416,ATL,KCA,ATL02,3,6,9
ATL201304170,2013,20130417,ATL,KCA,ATL02,1,0,1
ATL201304290,2013,20130429,ATL,WAS,ATL02,2,3,5
ATL201304300,2013,20130430,ATL,WAS,ATL02,1,8,9
ATL201305010,2013,20130501,ATL,WAS,ATL02,2,0,2
ATL201305020,2013,20130502,ATL,WAS,ATL02,3,1,4
ATL201305030,2013,20130503,ATL,NYN,ATL02,7,5,12
ATL201305050,2013,20130505,ATL,NYN,ATL02,4,9,13
ATL201305170,2013,20130517,ATL,LAN,ATL02,5,8,13
ATL201305180,2013,20130518,ATL,LAN,ATL02,1,3,4
ATL201305190,2013,20130519,ATL,LAN,ATL02,2,5,7
ATL201305200,2013,20130520,ATL,MIN,ATL02,1,5,6
ATL201305210,2013,20130521,ATL,MIN,ATL02,4,5,9
ATL201305220,2013,20130522,ATL,MIN,ATL02,3,8,11
ATL201305290,2013,20130529,ATL,TOR,ATL02,3,0,3
ATL201305300,2013,20130530,ATL,TOR,ATL02,3,11,14
ATL201305310,2013,20130531,ATL,WAS,ATL02,3,2,5
ATL201306010,2013,20130601,ATL,WAS,ATL02,1,2,3
ATL201306020,2013,20130602,ATL,WAS,ATL02,3,6,9
ATL201306030,2013,20130603,ATL,PIT,ATL02,2,7,9
ATL201306040,2013,20130604,ATL,PIT,ATL02,4,5,9
ATL201306050,2013,20130605,ATL,PIT,ATL02,0,5,5
ATL201306140,2013,20130614,ATL,SFN,ATL02,6,0,6
ATL201306150,2013,20130615,ATL,SFN,ATL02,5,6,11
ATL201306160,2013,20130616,ATL,SFN,ATL02,0,3,3
ATL201306170,2013,20130617,ATL,NYN,ATL02,1,2,3
ATL201306181,2013,20130618,ATL,NYN,ATL02,4,3,7
ATL201306182,2013,20130618,ATL,NYN,ATL02,6,1,7
ATL201306190,2013,20130619,ATL,NYN,ATL02,3,5,8
ATL201306200,2013,20130620,ATL,NYN,ATL02,4,3,7
ATL201306280,2013,20130628,ATL,ARI,ATL02,0,3,3
ATL201306290,2013,20130629,ATL,ARI,ATL02,5,11,16
ATL201306300,2013,20130630,ATL,ARI,ATL02,2,6,8
ATL201307020,2013,20130702,ATL,MIA,ATL02,3,11,14
ATL201307030,2013,20130703,ATL,MIA,ATL02,6,3,9
ATL201307040,2013,20130704,ATL,MIA,ATL02,4,3,7
ATL201307110,2013,20130711,ATL,CIN,ATL02,5,6,11
ATL201307120,2013,20130712,ATL,CIN,ATL02,4,2,6
ATL201307130,2013,20130713,ATL,CIN,ATL02,2,5,7
ATL201307140,2013,20130714,ATL,CIN,ATL02,8,4,12
ATL201307260,2013,20130726,ATL,SLN,ATL02,1,4,5
ATL201307270,2013,20130727,ATL,SLN,ATL02,0,2,2
ATL201307280,2013,20130728,ATL,SLN,ATL02,2,5,7
ATL201307290,2013,20130729,ATL,COL,ATL02,8,9,17
ATL201307300,2013,20130730,ATL,COL,ATL02,3,11,14
ATL201307310,2013,20130731,ATL,COL,ATL02,0,9,9
ATL201308010,2013,20130801,ATL,COL,ATL02,2,11,13
ATL201308090,2013,20130809,ATL,MIA,ATL02,0,5,5
ATL201308100,2013,20130810,ATL,MIA,ATL02,1,0,1
ATL201308110,2013,20130811,ATL,MIA,ATL02,4,9,13
ATL201308120,2013,20130812,ATL,PHI,ATL02,5,1,6
ATL201308130,2013,20130813,ATL,PHI,ATL02,1,3,4
ATL201308140,2013,20130814,ATL,PHI,ATL02,3,6,9
ATL201308160,2013,20130816,ATL,WAS,ATL02,2,3,5
ATL201308170,2013,20130817,ATL,WAS,ATL02,8,7,15
ATL201308180,2013,20130818,ATL,WAS,ATL02,1,2,3
ATL201308270,2013,20130827,ATL,CLE,ATL02,0,2,2
ATL201308280,2013,20130828,ATL,CLE,ATL02,2,3,5
ATL201308290,2013,20130829,ATL,CLE,ATL02,1,3,4
ATL201308300,2013,20130830,ATL,MIA,ATL02,1,2,3
ATL201308310,2013,20130831,ATL,MIA,ATL02,4,5,9
ATL201309010,2013,20130901,ATL,MIA,ATL02,7,0,7
ATL201309020,2013,20130902,ATL,NYN,ATL02,5,13,18
ATL201309030,2013,20130903,ATL,NYN,ATL02,1,3,4
ATL201309040,2013,20130904,ATL,NYN,ATL02,5,2,7
ATL201309130,2013,20130913,ATL,SDN,ATL02,4,3,7
ATL201309140,2013,20130914,ATL,SDN,ATL02,1,2,3
ATL201309150,2013,20130915,ATL,SDN,ATL02,4,0,4
ATL201309230,2013,20130923,ATL,MIL,ATL02,5,0,5
ATL201309240,2013,20130924,ATL,MIL,ATL02,2,3,5
ATL201309250,2013,20130925,ATL,MIL,ATL02,4,0,4
ATL201309260,2013,20130926,ATL,PHI,ATL02,1,7,8
ATL201309270,2013,20130927,ATL,PHI,ATL02,0,1,1
ATL201309280,2013,20130928,ATL,PHI,ATL02,5,4,9
ATL201309290,2013,20130929,ATL,PHI,ATL02,5,12,17
ATL201310030,2013,20131003,ATL,LAN,ATL02,6,1,7
ATL201310040,2013,20131004,ATL,LAN,ATL02,3,4,7
BAL201004090,2010,100409,BAL,TOR,BAL12,7,6,13
BAL201004100,2010,100410,BAL,TOR,BAL12,3,0,3
BAL201004110,2010,100411,BAL,TOR,BAL12,5,2,7
BAL201004120,2010,100412,BAL,TBA,BAL12,5,1,6
BAL201004130,2010,100413,BAL,TBA,BAL12,8,6,14
BAL201004140,2010,100414,BAL,TBA,BAL12,9,1,10
BAL201004270,2010,100427,BAL,NYA,BAL12,4,5,9
BAL201004280,2010,100428,BAL,NYA,BAL12,8,3,11
BAL201004290,2010,100429,BAL,NYA,BAL12,4,0,4
BAL201004300,2010,100430,BAL,BOS,BAL12,4,5,9
BAL201005010,2010,100501,BAL,BOS,BAL12,9,12,21
BAL201005020,2010,100502,BAL,BOS,BAL12,2,3,5
BAL201005110,2010,100511,BAL,SEA,BAL12,5,1,6
BAL201005120,2010,100512,BAL,SEA,BAL12,2,5,7
BAL201005130,2010,100513,BAL,SEA,BAL12,5,6,11
BAL201005140,2010,100514,BAL,CLE,BAL12,1,8,9
BAL201005150,2010,100515,BAL,CLE,BAL12,8,2,10
BAL201005160,2010,100516,BAL,CLE,BAL12,5,1,6
BAL201005170,2010,100517,BAL,KCA,BAL12,4,3,7
BAL201005180,2010,100518,BAL,KCA,BAL12,3,4,7
BAL201005250,2010,100525,BAL,OAK,BAL12,1,5,6
BAL201005260,2010,100526,BAL,OAK,BAL12,6,1,7
BAL201005270,2010,100527,BAL,OAK,BAL12,7,5,12
BAL201006040,2010,100604,BAL,BOS,BAL12,11,0,11
BAL201006050,2010,100605,BAL,BOS,BAL12,8,2,10
BAL201006060,2010,100606,BAL,BOS,BAL12,3,4,7
BAL201006080,2010,100608,BAL,NYA,BAL12,12,7,19
BAL201006090,2010,100609,BAL,NYA,BAL12,4,2,6
BAL201006100,2010,100610,BAL,NYA,BAL12,3,4,7
BAL201006110,2010,100611,BAL,NYN,BAL12,5,1,6
BAL201006120,2010,100612,BAL,NYN,BAL12,3,1,4
BAL201006130,2010,100613,BAL,NYN,BAL12,11,4,15
BAL201006220,2010,100622,BAL,FLO,BAL12,10,4,14
BAL201006230,2010,100623,BAL,FLO,BAL12,7,5,12
BAL201006240,2010,100624,BAL,FLO,BAL12,5,11,16
BAL201006250,2010,100625,BAL,WAS,BAL12,6,7,13
BAL201006260,2010,100626,BAL,WAS,BAL12,5,6,11
BAL201006270,2010,100627,BAL,WAS,BAL12,3,4,7
BAL201006290,2010,100629,BAL,OAK,BAL12,4,2,6
BAL201006300,2010,100630,BAL,OAK,BAL12,6,9,15
BAL201007010,2010,100701,BAL,OAK,BAL12,8,1,9
BAL201007160,2010,100716,BAL,TOR,BAL12,4,2,6
BAL201007170,2010,100717,BAL,TOR,BAL12,3,2,5
BAL201007180,2010,100718,BAL,TOR,BAL12,10,1,11
BAL201007190,2010,100719,BAL,TBA,BAL12,8,1,9
BAL201007200,2010,100720,BAL,TBA,BAL12,10,11,21
BAL201007210,2010,100721,BAL,TBA,BAL12,5,4,9
BAL201007220,2010,100722,BAL,MIN,BAL12,5,0,5
BAL201007230,2010,100723,BAL,MIN,BAL12,2,3,5
BAL201007240,2010,100724,BAL,MIN,BAL12,7,2,9
BAL201007250,2010,100725,BAL,MIN,BAL12,10,4,14
BAL201008030,2010,100803,BAL,ANA,BAL12,3,6,9
BAL201008040,2010,100804,BAL,ANA,BAL12,7,9,16
BAL201008050,2010,100805,BAL,ANA,BAL12,4,5,9
BAL201008060,2010,100806,BAL,CHA,BAL12,1,2,3
BAL201008070,2010,100807,BAL,CHA,BAL12,4,2,6
BAL201008080,2010,100808,BAL,CHA,BAL12,3,4,7
BAL201008090,2010,100809,BAL,CHA,BAL12,2,3,5
BAL201008160,2010,100816,BAL,SEA,BAL12,4,5,9
BAL201008170,2010,100817,BAL,SEA,BAL12,4,0,4
BAL201008180,2010,100818,BAL,SEA,BAL12,6,5,11
BAL201008190,2010,100819,BAL,TEX,BAL12,0,4,4
BAL201008200,2010,100820,BAL,TEX,BAL12,2,0,2
BAL201008210,2010,100821,BAL,TEX,BAL12,6,8,14
BAL201008220,2010,100822,BAL,TEX,BAL12,6,4,10
BAL201008310,2010,100831,BAL,BOS,BAL12,2,5,7
BAL201009010,2010,100901,BAL,BOS,BAL12,9,6,15
BAL201009020,2010,100902,BAL,BOS,BAL12,6,4,10
BAL201009030,2010,100903,BAL,TBA,BAL12,4,1,5
BAL201009040,2010,100904,BAL,TBA,BAL12,4,8,12
BAL201009050,2010,100905,BAL,TBA,BAL12,7,8,15
BAL201009130,2010,100913,BAL,TOR,BAL12,3,4,7
BAL201009140,2010,100914,BAL,TOR,BAL12,3,11,14
BAL201009150,2010,100915,BAL,TOR,BAL12,1,3,4
BAL201009170,2010,100917,BAL,NYA,BAL12,4,3,7
BAL201009180,2010,100918,BAL,NYA,BAL12,11,3,14
BAL201009190,2010,100919,BAL,NYA,BAL12,3,4,7
BAL201010011,2010,101001,BAL,DET,BAL12,6,10,16
BAL201010012,2010,101001,BAL,DET,BAL12,1,2,3
BAL201010020,2010,101002,BAL,DET,BAL12,1,2,3
BAL201010030,2010,101003,BAL,DET,BAL12,4,2,6
BAL201104040,2011,20110404,BAL,DET,BAL12,1,5,6
BAL201104060,2011,20110406,BAL,DET,BAL12,7,3,10
BAL201104070,2011,20110407,BAL,DET,BAL12,5,9,14
BAL201104091,2011,20110409,BAL,TEX,BAL12,0,5,5
BAL201104092,2011,20110409,BAL,TEX,BAL12,13,1,14
BAL201104100,2011,20110410,BAL,TEX,BAL12,3,0,3
BAL201104180,2011,20110418,BAL,MIN,BAL12,5,3,8
BAL201104190,2011,20110419,BAL,MIN,BAL12,0,11,11
BAL201104200,2011,20110420,BAL,MIN,BAL12,4,5,9
BAL201104210,2011,20110421,BAL,MIN,BAL12,3,1,4
BAL201104230,2011,20110423,BAL,NYA,BAL12,15,3,18
BAL201104240,2011,20110424,BAL,NYA,BAL12,6,3,9
BAL201104260,2011,20110426,BAL,BOS,BAL12,1,4,5
BAL201104270,2011,20110427,BAL,BOS,BAL12,4,5,9
BAL201104280,2011,20110428,BAL,BOS,BAL12,6,2,8
BAL201105060,2011,20110506,BAL,TBA,BAL12,6,2,8
BAL201105070,2011,20110507,BAL,TBA,BAL12,8,2,10
BAL201105080,2011,20110508,BAL,TBA,BAL12,5,3,8
BAL201105100,2011,20110510,BAL,SEA,BAL12,6,7,13
BAL201105110,2011,20110511,BAL,SEA,BAL12,2,4,6
BAL201105120,2011,20110512,BAL,SEA,BAL12,1,2,3
BAL201105180,2011,20110518,BAL,NYA,BAL12,4,1,5
BAL201105190,2011,20110519,BAL,NYA,BAL12,13,2,15
BAL201105200,2011,20110520,BAL,WAS,BAL12,17,5,22
BAL201105210,2011,20110521,BAL,WAS,BAL12,3,8,11
BAL201105220,2011,20110522,BAL,WAS,BAL12,1,2,3
BAL201105240,2011,20110524,BAL,KCA,BAL12,3,5,8
BAL201105250,2011,20110525,BAL,KCA,BAL12,2,9,11
BAL201105260,2011,20110526,BAL,KCA,BAL12,5,6,11
BAL201106030,2011,20110603,BAL,TOR,BAL12,8,4,12
BAL201106040,2011,20110604,BAL,TOR,BAL12,3,5,8
BAL201106050,2011,20110605,BAL,TOR,BAL12,7,4,11
BAL201106060,2011,20110606,BAL,OAK,BAL12,2,4,6
BAL201106070,2011,20110607,BAL,OAK,BAL12,0,4,4
BAL201106080,2011,20110608,BAL,OAK,BAL12,2,3,5
BAL201106100,2011,20110610,BAL,TBA,BAL12,0,7,7
BAL201106110,2011,20110611,BAL,TBA,BAL12,7,5,12
BAL201106120,2011,20110612,BAL,TBA,BAL12,9,6,15
BAL201106240,2011,20110624,BAL,CIN,BAL12,4,5,9
BAL201106250,2011,20110625,BAL,CIN,BAL12,10,5,15
BAL201106260,2011,20110626,BAL,CIN,BAL12,5,7,12
BAL201106280,2011,20110628,BAL,SLN,BAL12,6,2,8
BAL201106290,2011,20110629,BAL,SLN,BAL12,5,1,6
BAL201106300,2011,20110630,BAL,SLN,BAL12,9,6,15
BAL201107140,2011,20110714,BAL,CLE,BAL12,8,4,12
BAL201107150,2011,20110715,BAL,CLE,BAL12,6,5,11
BAL201107160,2011,20110716,BAL,CLE,BAL12,5,6,11
BAL201107170,2011,20110717,BAL,CLE,BAL12,3,8,11
BAL201107180,2011,20110718,BAL,BOS,BAL12,15,10,25
BAL201107190,2011,20110719,BAL,BOS,BAL12,2,6,8
BAL201107200,2011,20110720,BAL,BOS,BAL12,4,0,4
BAL201107220,2011,20110722,BAL,ANA,BAL12,6,1,7
BAL201107230,2011,20110723,BAL,ANA,BAL12,2,3,5
BAL201107240,2011,20110724,BAL,ANA,BAL12,9,3,12
BAL201108050,2011,20110805,BAL,TOR,BAL12,5,4,9
BAL201108060,2011,20110806,BAL,TOR,BAL12,2,6,8
BAL201108070,2011,20110807,BAL,TOR,BAL12,7,2,9
BAL201108080,2011,20110808,BAL,CHA,BAL12,7,6,13
BAL201108090,2011,20110809,BAL,CHA,BAL12,4,3,7
BAL201108100,2011,20110810,BAL,CHA,BAL12,4,6,10
BAL201108110,2011,20110811,BAL,CHA,BAL12,6,3,9
BAL201108120,2011,20110812,BAL,DET,BAL12,5,4,9
BAL201108130,2011,20110813,BAL,DET,BAL12,6,5,11
BAL201108140,2011,20110814,BAL,DET,BAL12,5,8,13
BAL201108260,2011,20110826,BAL,NYA,BAL12,5,12,17
BAL201108281,2011,20110828,BAL,NYA,BAL12,0,2,2
BAL201108282,2011,20110828,BAL,NYA,BAL12,8,3,11
BAL201108290,2011,20110829,BAL,NYA,BAL12,3,2,5
BAL201108300,2011,20110830,BAL,TOR,BAL12,5,6,11
BAL201108310,2011,20110831,BAL,TOR,BAL12,13,0,13
BAL201109010,2011,20110901,BAL,TOR,BAL12,8,6,14
BAL201109080,2011,20110908,BAL,NYA,BAL12,4,5,9
BAL201109120,2011,20110912,BAL,TBA,BAL12,5,2,7
BAL201109130,2011,20110913,BAL,TBA,BAL12,2,4,6
BAL201109140,2011,20110914,BAL,TBA,BAL12,2,6,8
BAL201109160,2011,20110916,BAL,ANA,BAL12,3,8,11
BAL201109170,2011,20110917,BAL,ANA,BAL12,2,6,8
BAL201109180,2011,20110918,BAL,ANA,BAL12,11,2,13
BAL201109260,2011,20110926,BAL,BOS,BAL12,3,6,9
BAL201109270,2011,20110927,BAL,BOS,BAL12,8,7,15
BAL201109280,2011,20110928,BAL,BOS,BAL12,3,4,7
BAL201204060,2012,120406,BAL,MIN,BAL12,2,4,6
BAL201204070,2012,120407,BAL,MIN,BAL12,2,8,10
BAL201204080,2012,120408,BAL,MIN,BAL12,1,3,4
BAL201204090,2012,120409,BAL,NYA,BAL12,6,2,8
BAL201204100,2012,120410,BAL,NYA,BAL12,5,4,9
BAL201204110,2012,120411,BAL,NYA,BAL12,6,4,10
BAL201204240,2012,120424,BAL,TOR,BAL12,1,2,3
BAL201204250,2012,120425,BAL,TOR,BAL12,0,3,3
BAL201204260,2012,120426,BAL,TOR,BAL12,2,5,7
BAL201204270,2012,120427,BAL,OAK,BAL12,5,2,7
BAL201204280,2012,120428,BAL,OAK,BAL12,1,10,11
BAL201204290,2012,120429,BAL,OAK,BAL12,2,5,7
BAL201205070,2012,120507,BAL,TEX,BAL12,14,3,17
BAL201205080,2012,120508,BAL,TEX,BAL12,10,3,13
BAL201205101,2012,120510,BAL,TEX,BAL12,5,6,11
BAL201205102,2012,120510,BAL,TEX,BAL12,7,3,10
BAL201205110,2012,120511,BAL,TBA,BAL12,3,4,7
BAL201205120,2012,120512,BAL,TBA,BAL12,3,5,8
BAL201205130,2012,120513,BAL,TBA,BAL12,9,8,17
BAL201205140,2012,120514,BAL,NYA,BAL12,8,5,13
BAL201205150,2012,120515,BAL,NYA,BAL12,2,5,7
BAL201205210,2012,120521,BAL,BOS,BAL12,8,6,14
BAL201205220,2012,120522,BAL,BOS,BAL12,1,4,5
BAL201205230,2012,120523,BAL,BOS,BAL12,6,5,11
BAL201205250,2012,120525,BAL,KCA,BAL12,2,8,10
BAL201205260,2012,120526,BAL,KCA,BAL12,4,3,7
BAL201205270,2012,120527,BAL,KCA,BAL12,4,2,6
BAL201206080,2012,120608,BAL,PHI,BAL12,9,6,15
BAL201206090,2012,120609,BAL,PHI,BAL12,4,6,10
BAL201206100,2012,120610,BAL,PHI,BAL12,4,5,9
BAL201206120,2012,120612,BAL,PIT,BAL12,6,8,14
BAL201206130,2012,120613,BAL,PIT,BAL12,1,7,8
BAL201206140,2012,120614,BAL,PIT,BAL12,6,12,18
BAL201206220,2012,120622,BAL,WAS,BAL12,1,2,3
BAL201206230,2012,120623,BAL,WAS,BAL12,3,1,4
BAL201206240,2012,120624,BAL,WAS,BAL12,1,2,3
BAL201206260,2012,120626,BAL,ANA,BAL12,7,3,10
BAL201206270,2012,120627,BAL,ANA,BAL12,13,1,14
BAL201206280,2012,120628,BAL,CLE,BAL12,7,2,9
BAL201206290,2012,120629,BAL,CLE,BAL12,8,9,17
BAL201206300,2012,120630,BAL,CLE,BAL12,11,5,16
BAL201207010,2012,120701,BAL,CLE,BAL12,6,2,8
BAL201207130,2012,120713,BAL,DET,BAL12,7,2,9
BAL201207140,2012,120714,BAL,DET,BAL12,6,8,14
BAL201207150,2012,120715,BAL,DET,BAL12,4,0,4
BAL201207240,2012,120724,BAL,TBA,BAL12,3,1,4
BAL201207250,2012,120725,BAL,TBA,BAL12,10,1,11
BAL201207260,2012,120726,BAL,TBA,BAL12,2,6,8
BAL201207270,2012,120727,BAL,OAK,BAL12,14,9,23
BAL201207280,2012,120728,BAL,OAK,BAL12,6,1,7
BAL201207290,2012,120729,BAL,OAK,BAL12,1,6,7
BAL201208060,2012,120806,BAL,SEA,BAL12,1,3,4
BAL201208070,2012,120807,BAL,SEA,BAL12,7,8,15
BAL201208080,2012,120808,BAL,SEA,BAL12,2,9,11
BAL201208090,2012,120809,BAL,KCA,BAL12,8,2,10
BAL201208100,2012,120810,BAL,KCA,BAL12,1,7,8
BAL201208110,2012,120811,BAL,KCA,BAL12,7,3,10
BAL201208120,2012,120812,BAL,KCA,BAL12,3,5,8
BAL201208140,2012,120814,BAL,BOS,BAL12,1,7,8
BAL201208150,2012,120815,BAL,BOS,BAL12,3,5,8
BAL201208160,2012,120816,BAL,BOS,BAL12,6,3,9
BAL201208240,2012,120824,BAL,TOR,BAL12,4,6,10
BAL201208250,2012,120825,BAL,TOR,BAL12,2,8,10
BAL201208270,2012,120827,BAL,CHA,BAL12,3,4,7
BAL201208280,2012,120828,BAL,CHA,BAL12,0,6,6
BAL201208290,2012,120829,BAL,CHA,BAL12,8,1,9
BAL201208300,2012,120830,BAL,CHA,BAL12,3,5,8
BAL201209060,2012,120906,BAL,NYA,BAL12,6,10,16
BAL201209070,2012,120907,BAL,NYA,BAL12,8,5,13
BAL201209080,2012,120908,BAL,NYA,BAL12,4,5,9
BAL201209090,2012,120909,BAL,NYA,BAL12,13,3,16
BAL201209110,2012,120911,BAL,TBA,BAL12,2,9,11
BAL201209120,2012,120912,BAL,TBA,BAL12,2,3,5
BAL201209130,2012,120913,BAL,TBA,BAL12,2,3,5
BAL201209241,2012,120924,BAL,TOR,BAL12,1,4,5
BAL201209242,2012,120924,BAL,TOR,BAL12,9,5,14
BAL201209250,2012,120925,BAL,TOR,BAL12,4,0,4
BAL201209260,2012,120926,BAL,TOR,BAL12,2,12,14
BAL201209280,2012,120928,BAL,BOS,BAL12,1,9,10
BAL201209290,2012,120929,BAL,BOS,BAL12,3,4,7
BAL201209300,2012,120930,BAL,BOS,BAL12,3,6,9
BAL201210070,2012,121007,BAL,NYA,BAL12,7,2,9
BAL201210080,2012,121008,BAL,NYA,BAL12,2,3,5
BAL201304050,2013,20130405,BAL,MIN,BAL12,5,9,14
BAL201304060,2013,20130406,BAL,MIN,BAL12,6,5,11
BAL201304070,2013,20130407,BAL,MIN,BAL12,4,3,7
BAL201304160,2013,20130416,BAL,TBA,BAL12,4,5,9
BAL201304170,2013,20130417,BAL,TBA,BAL12,6,2,8
BAL201304180,2013,20130418,BAL,TBA,BAL12,6,10,16
BAL201304201,2013,20130420,BAL,LAN,BAL12,5,7,12
BAL201304202,2013,20130420,BAL,LAN,BAL12,1,6,7
BAL201304210,2013,20130421,BAL,LAN,BAL12,7,4,11
BAL201304220,2013,20130422,BAL,TOR,BAL12,1,2,3
BAL201304230,2013,20130423,BAL,TOR,BAL12,3,4,7
BAL201304240,2013,20130424,BAL,TOR,BAL12,6,5,11
BAL201305070,2013,20130507,BAL,KCA,BAL12,3,4,7
BAL201305080,2013,20130508,BAL,KCA,BAL12,3,5,8
BAL201305090,2013,20130509,BAL,KCA,BAL12,6,2,8
BAL201305140,2013,20130514,BAL,SDN,BAL12,3,2,5
BAL201305150,2013,20130515,BAL,SDN,BAL12,8,4,12
BAL201305170,2013,20130517,BAL,TBA,BAL12,12,10,22
BAL201305180,2013,20130518,BAL,TBA,BAL12,10,6,16
BAL201305190,2013,20130519,BAL,TBA,BAL12,3,1,4
BAL201305200,2013,20130520,BAL,NYA,BAL12,6,4,10
BAL201305210,2013,20130521,BAL,NYA,BAL12,2,3,5
BAL201305220,2013,20130522,BAL,NYA,BAL12,3,6,9
BAL201305290,2013,20130529,BAL,WAS,BAL12,6,9,15
BAL201305300,2013,20130530,BAL,WAS,BAL12,0,2,2
BAL201305310,2013,20130531,BAL,DET,BAL12,5,7,12
BAL201306010,2013,20130601,BAL,DET,BAL12,10,3,13
BAL201306020,2013,20130602,BAL,DET,BAL12,2,4,6
BAL201306100,2013,20130610,BAL,ANA,BAL12,3,4,7
BAL201306110,2013,20130611,BAL,ANA,BAL12,2,3,5
BAL201306120,2013,20130612,BAL,ANA,BAL12,9,5,14
BAL201306130,2013,20130613,BAL,BOS,BAL12,4,5,9
BAL201306140,2013,20130614,BAL,BOS,BAL12,0,2,2
BAL201306150,2013,20130615,BAL,BOS,BAL12,5,4,9
BAL201306160,2013,20130616,BAL,BOS,BAL12,3,6,9
BAL201306240,2013,20130624,BAL,CLE,BAL12,5,2,7
BAL201306250,2013,20130625,BAL,CLE,BAL12,3,6,9
BAL201306260,2013,20130626,BAL,CLE,BAL12,4,3,7
BAL201306270,2013,20130627,BAL,CLE,BAL12,3,7,10
BAL201306280,2013,20130628,BAL,NYA,BAL12,3,4,7
BAL201306290,2013,20130629,BAL,NYA,BAL12,3,11,14
BAL201306300,2013,20130630,BAL,NYA,BAL12,2,4,6
BAL201307080,2013,20130708,BAL,TEX,BAL12,8,5,13
BAL201307090,2013,20130709,BAL,TEX,BAL12,8,4,12
BAL201307100,2013,20130710,BAL,TEX,BAL12,1,6,7
BAL201307110,2013,20130711,BAL,TEX,BAL12,1,3,4
BAL201307120,2013,20130712,BAL,TOR,BAL12,5,8,13
BAL201307130,2013,20130713,BAL,TOR,BAL12,7,3,10
BAL201307140,2013,20130714,BAL,TOR,BAL12,4,7,11
BAL201307260,2013,20130726,BAL,BOS,BAL12,0,6,6
BAL201307270,2013,20130727,BAL,BOS,BAL12,7,3,10
BAL201307280,2013,20130728,BAL,BOS,BAL12,5,0,5
BAL201307300,2013,20130730,BAL,HOU,BAL12,3,4,7
BAL201307310,2013,20130731,BAL,HOU,BAL12,11,0,11
BAL201308010,2013,20130801,BAL,HOU,BAL12,3,6,9
BAL201308020,2013,20130802,BAL,SEA,BAL12,8,11,19
BAL201308030,2013,20130803,BAL,SEA,BAL12,8,4,12
BAL201308040,2013,20130804,BAL,SEA,BAL12,3,2,5
BAL201308160,2013,20130816,BAL,COL,BAL12,6,3,9
BAL201308170,2013,20130817,BAL,COL,BAL12,4,8,12
BAL201308180,2013,20130818,BAL,COL,BAL12,2,7,9
BAL201308190,2013,20130819,BAL,TBA,BAL12,4,3,7
BAL201308200,2013,20130820,BAL,TBA,BAL12,7,4,11
BAL201308210,2013,20130821,BAL,TBA,BAL12,2,4,6
BAL201308230,2013,20130823,BAL,OAK,BAL12,7,9,16
BAL201308240,2013,20130824,BAL,OAK,BAL12,2,1,3
BAL201308250,2013,20130825,BAL,OAK,BAL12,3,10,13
BAL201309050,2013,20130905,BAL,CHA,BAL12,1,3,4
BAL201309060,2013,20130906,BAL,CHA,BAL12,0,4,4
BAL201309070,2013,20130907,BAL,CHA,BAL12,3,4,7
BAL201309080,2013,20130908,BAL,CHA,BAL12,4,2,6
BAL201309090,2013,20130909,BAL,NYA,BAL12,2,4,6
BAL201309100,2013,20130910,BAL,NYA,BAL12,7,5,12
BAL201309110,2013,20130911,BAL,NYA,BAL12,5,4,9
BAL201309120,2013,20130912,BAL,NYA,BAL12,6,5,11
BAL201309240,2013,20130924,BAL,TOR,BAL12,3,2,5
BAL201309250,2013,20130925,BAL,TOR,BAL12,5,9,14
BAL201309260,2013,20130926,BAL,TOR,BAL12,2,3,5
BAL201309270,2013,20130927,BAL,BOS,BAL12,12,3,15
BAL201309280,2013,20130928,BAL,BOS,BAL12,5,6,11
BAL201309290,2013,20130929,BAL,BOS,BAL12,6,7,13
BOS201004040,2010,100404,BOS,NYA,BOS07,7,9,16
BOS201004060,2010,100406,BOS,NYA,BOS07,6,4,10
BOS201004070,2010,100407,BOS,NYA,BOS07,3,1,4
BOS201004160,2010,100416,BOS,TBA,BOS07,3,1,4
BOS201004170,2010,100417,BOS,TBA,BOS07,6,5,11
BOS201004180,2010,100418,BOS,TBA,BOS07,7,1,8
BOS201004190,2010,100419,BOS,TBA,BOS07,8,2,10
BOS201004200,2010,100420,BOS,TEX,BOS07,6,7,13
BOS201004210,2010,100421,BOS,TEX,BOS07,7,8,15
BOS201004220,2010,100422,BOS,TEX,BOS07,3,0,3
BOS201004230,2010,100423,BOS,BAL,BOS07,3,4,7
BOS201004240,2010,100424,BOS,BAL,BOS07,6,7,13
BOS201004250,2010,100425,BOS,BAL,BOS07,7,6,13
BOS201005030,2010,100503,BOS,ANA,BOS07,8,17,25
BOS201005040,2010,100504,BOS,ANA,BOS07,1,5,6
BOS201005050,2010,100505,BOS,ANA,BOS07,1,3,4
BOS201005060,2010,100506,BOS,ANA,BOS07,6,11,17
BOS201005070,2010,100507,BOS,NYA,BOS07,10,3,13
BOS201005080,2010,100508,BOS,NYA,BOS07,14,3,17
BOS201005090,2010,100509,BOS,NYA,BOS07,3,9,12
BOS201005100,2010,100510,BOS,TOR,BOS07,6,7,13
BOS201005110,2010,100511,BOS,TOR,BOS07,1,6,7
BOS201005120,2010,100512,BOS,TOR,BOS07,3,2,5
BOS201005190,2010,100519,BOS,MIN,BOS07,2,3,5
BOS201005200,2010,100520,BOS,MIN,BOS07,2,6,8
BOS201005270,2010,100527,BOS,KCA,BOS07,4,3,7
BOS201005280,2010,100528,BOS,KCA,BOS07,12,5,17
BOS201005290,2010,100529,BOS,KCA,BOS07,0,1,1
BOS201005300,2010,100530,BOS,KCA,BOS07,1,8,9
BOS201006010,2010,100601,BOS,OAK,BOS07,4,9,13
BOS201006020,2010,100602,BOS,OAK,BOS07,4,6,10
BOS201006030,2010,100603,BOS,OAK,BOS07,9,8,17
BOS201006110,2010,100611,BOS,PHI,BOS07,2,12,14
BOS201006120,2010,100612,BOS,PHI,BOS07,2,10,12
BOS201006130,2010,100613,BOS,PHI,BOS07,5,3,8
BOS201006150,2010,100615,BOS,ARI,BOS07,3,6,9
BOS201006160,2010,100616,BOS,ARI,BOS07,2,6,8
BOS201006170,2010,100617,BOS,ARI,BOS07,5,8,13
BOS201006180,2010,100618,BOS,LAN,BOS07,6,10,16
BOS201006190,2010,100619,BOS,LAN,BOS07,4,5,9
BOS201006200,2010,100620,BOS,LAN,BOS07,0,2,2
BOS201006290,2010,100629,BOS,TBA,BOS07,5,8,13
BOS201006300,2010,100630,BOS,TBA,BOS07,9,4,13
BOS201007020,2010,100702,BOS,BAL,BOS07,2,3,5
BOS201007030,2010,100703,BOS,BAL,BOS07,3,9,12
BOS201007040,2010,100704,BOS,BAL,BOS07,6,1,7
BOS201007150,2010,100715,BOS,TEX,BOS07,7,2,9
BOS201007160,2010,100716,BOS,TEX,BOS07,8,4,12
BOS201007170,2010,100717,BOS,TEX,BOS07,2,3,5
BOS201007180,2010,100718,BOS,TEX,BOS07,4,2,6
BOS201007300,2010,100730,BOS,DET,BOS07,6,5,11
BOS201007310,2010,100731,BOS,DET,BOS07,4,5,9
BOS201008010,2010,100801,BOS,DET,BOS07,3,4,7
BOS201008020,2010,100802,BOS,CLE,BOS07,6,5,11
BOS201008030,2010,100803,BOS,CLE,BOS07,1,3,4
BOS201008040,2010,100804,BOS,CLE,BOS07,9,1,10
BOS201008050,2010,100805,BOS,CLE,BOS07,2,6,8
BOS201008170,2010,100817,BOS,ANA,BOS07,0,6,6
BOS201008180,2010,100818,BOS,ANA,BOS07,5,7,12
BOS201008190,2010,100819,BOS,ANA,BOS07,7,2,9
BOS201008200,2010,100820,BOS,TOR,BOS07,16,2,18
BOS201008210,2010,100821,BOS,TOR,BOS07,4,5,9
BOS201008220,2010,100822,BOS,TOR,BOS07,0,5,5
BOS201008230,2010,100823,BOS,SEA,BOS07,3,6,9
BOS201008251,2010,100825,BOS,SEA,BOS07,3,5,8
BOS201008252,2010,100825,BOS,SEA,BOS07,4,2,6
BOS201009041,2010,100904,BOS,CHA,BOS07,3,1,4
BOS201009042,2010,100904,BOS,CHA,BOS07,3,1,4
BOS201009050,2010,100905,BOS,CHA,BOS07,7,5,12
BOS201009060,2010,100906,BOS,TBA,BOS07,5,12,17
BOS201009070,2010,100907,BOS,TBA,BOS07,14,5,19
BOS201009080,2010,100908,BOS,TBA,BOS07,5,11,16
BOS201009170,2010,100917,BOS,TOR,BOS07,11,9,20
BOS201009180,2010,100918,BOS,TOR,BOS07,4,3,7
BOS201009190,2010,100919,BOS,TOR,BOS07,0,6,6
BOS201009200,2010,100920,BOS,BAL,BOS07,4,2,6
BOS201009210,2010,100921,BOS,BAL,BOS07,9,1,10
BOS201009220,2010,100922,BOS,BAL,BOS07,1,6,7
BOS201010021,2010,101002,BOS,NYA,BOS07,6,5,11
BOS201010022,2010,101002,BOS,NYA,BOS07,6,7,13
BOS201010030,2010,101003,BOS,NYA,BOS07,4,8,12
BOS201104080,2011,20110408,BOS,NYA,BOS07,6,9,15
BOS201104090,2011,20110409,BOS,NYA,BOS07,9,4,13
BOS201104100,2011,20110410,BOS,NYA,BOS07,0,4,4
BOS201104110,2011,20110411,BOS,TBA,BOS07,16,5,21
BOS201104120,2011,20110412,BOS,TBA,BOS07,3,2,5
BOS201104150,2011,20110415,BOS,TOR,BOS07,7,6,13
BOS201104160,2011,20110416,BOS,TOR,BOS07,1,4,5
BOS201104170,2011,20110417,BOS,TOR,BOS07,1,8,9
BOS201104180,2011,20110418,BOS,TOR,BOS07,1,9,10
BOS201104290,2011,20110429,BOS,SEA,BOS07,5,4,9
BOS201104300,2011,20110430,BOS,SEA,BOS07,2,0,2
BOS201105010,2011,20110501,BOS,SEA,BOS07,2,3,5
BOS201105020,2011,20110502,BOS,ANA,BOS07,5,9,14
BOS201105030,2011,20110503,BOS,ANA,BOS07,3,7,10
BOS201105040,2011,20110504,BOS,ANA,BOS07,5,3,8
BOS201105050,2011,20110505,BOS,ANA,BOS07,11,0,11
BOS201105060,2011,20110506,BOS,MIN,BOS07,9,2,11
BOS201105070,2011,20110507,BOS,MIN,BOS07,0,4,4
BOS201105080,2011,20110508,BOS,MIN,BOS07,5,9,14
BOS201105090,2011,20110509,BOS,MIN,BOS07,1,2,3
BOS201105160,2011,20110516,BOS,BAL,BOS07,7,8,15
BOS201105180,2011,20110518,BOS,DET,BOS07,0,1,1
BOS201105190,2011,20110519,BOS,DET,BOS07,3,4,7
BOS201105200,2011,20110520,BOS,CHN,BOS07,5,15,20
BOS201105210,2011,20110521,BOS,CHN,BOS07,9,3,12
BOS201105220,2011,20110522,BOS,CHN,BOS07,1,5,6
BOS201105300,2011,20110530,BOS,CHA,BOS07,7,3,10
BOS201105310,2011,20110531,BOS,CHA,BOS07,10,7,17
BOS201106010,2011,20110601,BOS,CHA,BOS07,7,4,11
BOS201106030,2011,20110603,BOS,OAK,BOS07,6,8,14
BOS201106040,2011,20110604,BOS,OAK,BOS07,8,9,17
BOS201106050,2011,20110605,BOS,OAK,BOS07,3,6,9
BOS201106170,2011,20110617,BOS,MIL,BOS07,4,10,14
BOS201106180,2011,20110618,BOS,MIL,BOS07,4,2,6
BOS201106190,2011,20110619,BOS,MIL,BOS07,3,12,15
BOS201106200,2011,20110620,BOS,SDN,BOS07,5,14,19
BOS201106210,2011,20110621,BOS,SDN,BOS07,5,4,9
BOS201106220,2011,20110622,BOS,SDN,BOS07,5,1,6
BOS201107040,2011,20110704,BOS,TOR,BOS07,9,7,16
BOS201107050,2011,20110705,BOS,TOR,BOS07,2,3,5
BOS201107060,2011,20110706,BOS,TOR,BOS07,4,6,10
BOS201107070,2011,20110707,BOS,BAL,BOS07,4,10,14
BOS201107080,2011,20110708,BOS,BAL,BOS07,3,10,13
BOS201107090,2011,20110709,BOS,BAL,BOS07,0,4,4
BOS201107100,2011,20110710,BOS,BAL,BOS07,6,8,14
BOS201107220,2011,20110722,BOS,SEA,BOS07,4,7,11
BOS201107230,2011,20110723,BOS,SEA,BOS07,1,3,4
BOS201107240,2011,20110724,BOS,SEA,BOS07,8,12,20
BOS201107250,2011,20110725,BOS,KCA,BOS07,3,1,4
BOS201107260,2011,20110726,BOS,KCA,BOS07,9,13,22
BOS201107270,2011,20110727,BOS,KCA,BOS07,5,12,17
BOS201107280,2011,20110728,BOS,KCA,BOS07,4,3,7
BOS201108010,2011,20110801,BOS,CLE,BOS07,9,6,15
BOS201108020,2011,20110802,BOS,CLE,BOS07,2,3,5
BOS201108030,2011,20110803,BOS,CLE,BOS07,3,4,7
BOS201108040,2011,20110804,BOS,CLE,BOS07,7,3,10
BOS201108050,2011,20110805,BOS,NYA,BOS07,3,2,5
BOS201108060,2011,20110806,BOS,NYA,BOS07,4,10,14
BOS201108070,2011,20110807,BOS,NYA,BOS07,2,3,5
BOS201108161,2011,20110816,BOS,TBA,BOS07,1,3,4
BOS201108162,2011,20110816,BOS,TBA,BOS07,6,2,8
BOS201108170,2011,20110817,BOS,TBA,BOS07,4,0,4
BOS201108260,2011,20110826,BOS,OAK,BOS07,15,5,20
BOS201108271,2011,20110827,BOS,OAK,BOS07,3,9,12
BOS201108272,2011,20110827,BOS,OAK,BOS07,0,4,4
BOS201108300,2011,20110830,BOS,NYA,BOS07,5,2,7
BOS201108310,2011,20110831,BOS,NYA,BOS07,5,9,14
BOS201109010,2011,20110901,BOS,NYA,BOS07,4,2,6
BOS201109020,2011,20110902,BOS,TEX,BOS07,10,0,10
BOS201109030,2011,20110903,BOS,TEX,BOS07,7,12,19
BOS201109040,2011,20110904,BOS,TEX,BOS07,11,4,15
BOS201109130,2011,20110913,BOS,TOR,BOS07,6,18,24
BOS201109140,2011,20110914,BOS,TOR,BOS07,5,4,9
BOS201109150,2011,20110915,BOS,TBA,BOS07,9,2,11
BOS201109160,2011,20110916,BOS,TBA,BOS07,3,4,7
BOS201109170,2011,20110917,BOS,TBA,BOS07,4,3,7
BOS201109180,2011,20110918,BOS,TBA,BOS07,8,5,13
BOS201109191,2011,20110919,BOS,BAL,BOS07,6,5,11
BOS201109192,2011,20110919,BOS,BAL,BOS07,9,18,27
BOS201109200,2011,20110920,BOS,BAL,BOS07,7,5,12
BOS201109210,2011,20110921,BOS,BAL,BOS07,6,4,10
BOS201204130,2012,120413,BOS,TBA,BOS07,2,12,14
BOS201204140,2012,120414,BOS,TBA,BOS07,5,13,18
BOS201204150,2012,120415,BOS,TBA,BOS07,4,6,10
BOS201204160,2012,120416,BOS,TBA,BOS07,1,0,1
BOS201204170,2012,120417,BOS,TEX,BOS07,18,3,21
BOS201204180,2012,120418,BOS,TEX,BOS07,6,3,9
BOS201204200,2012,120420,BOS,NYA,BOS07,6,2,8
BOS201204210,2012,120421,BOS,NYA,BOS07,15,9,24
BOS201204300,2012,120430,BOS,OAK,BOS07,6,11,17
BOS201205010,2012,120501,BOS,OAK,BOS07,5,3,8
BOS201205020,2012,120502,BOS,OAK,BOS07,4,2,6
BOS201205040,2012,120504,BOS,BAL,BOS07,6,4,10
BOS201205050,2012,120505,BOS,BAL,BOS07,8,2,10
BOS201205060,2012,120506,BOS,BAL,BOS07,9,6,15
BOS201205100,2012,120510,BOS,CLE,BOS07,8,3,11
BOS201205110,2012,120511,BOS,CLE,BOS07,5,7,12
BOS201205120,2012,120512,BOS,CLE,BOS07,1,4,5
BOS201205130,2012,120513,BOS,CLE,BOS07,1,12,13
BOS201205140,2012,120514,BOS,SEA,BOS07,1,6,7
BOS201205150,2012,120515,BOS,SEA,BOS07,0,5,5
BOS201205250,2012,120525,BOS,TBA,BOS07,7,4,11
BOS201205260,2012,120526,BOS,TBA,BOS07,2,3,5
BOS201205270,2012,120527,BOS,TBA,BOS07,4,3,7
BOS201205280,2012,120528,BOS,DET,BOS07,4,7,11
BOS201205290,2012,120529,BOS,DET,BOS07,3,6,9
BOS201205300,2012,120530,BOS,DET,BOS07,4,6,10
BOS201205310,2012,120531,BOS,DET,BOS07,7,3,10
BOS201206050,2012,120605,BOS,BAL,BOS07,8,6,14
BOS201206060,2012,120606,BOS,BAL,BOS07,2,1,3
BOS201206070,2012,120607,BOS,BAL,BOS07,0,7,7
BOS201206080,2012,120608,BOS,WAS,BOS07,7,4,11
BOS201206090,2012,120609,BOS,WAS,BOS07,4,2,6
BOS201206100,2012,120610,BOS,WAS,BOS07,4,3,7
BOS201206190,2012,120619,BOS,MIA,BOS07,5,7,12
BOS201206200,2012,120620,BOS,MIA,BOS07,5,15,20
BOS201206210,2012,120621,BOS,MIA,BOS07,5,6,11
BOS201206220,2012,120622,BOS,ATL,BOS07,4,1,5
BOS201206230,2012,120623,BOS,ATL,BOS07,4,8,12
BOS201206240,2012,120624,BOS,ATL,BOS07,4,9,13
BOS201206250,2012,120625,BOS,TOR,BOS07,9,6,15
BOS201206260,2012,120626,BOS,TOR,BOS07,1,5,6
BOS201206270,2012,120627,BOS,TOR,BOS07,4,10,14
BOS201207060,2012,120706,BOS,NYA,BOS07,10,8,18
BOS201207071,2012,120707,BOS,NYA,BOS07,6,1,7
BOS201207072,2012,120707,BOS,NYA,BOS07,5,9,14
BOS201207080,2012,120708,BOS,NYA,BOS07,7,3,10
BOS201207160,2012,120716,BOS,CHA,BOS07,1,5,6
BOS201207170,2012,120717,BOS,CHA,BOS07,7,5,12
BOS201207180,2012,120718,BOS,CHA,BOS07,1,10,11
BOS201207190,2012,120719,BOS,CHA,BOS07,1,3,4
BOS201207200,2012,120720,BOS,TOR,BOS07,6,1,7
BOS201207210,2012,120721,BOS,TOR,BOS07,7,3,10
BOS201207220,2012,120722,BOS,TOR,BOS07,15,7,22
BOS201207300,2012,120730,BOS,DET,BOS07,3,7,10
BOS201207310,2012,120731,BOS,DET,BOS07,1,4,5
BOS201208010,2012,120801,BOS,DET,BOS07,7,5,12
BOS201208020,2012,120802,BOS,MIN,BOS07,5,0,5
BOS201208030,2012,120803,BOS,MIN,BOS07,6,5,11
BOS201208040,2012,120804,BOS,MIN,BOS07,6,4,10
BOS201208050,2012,120805,BOS,MIN,BOS07,4,6,10
BOS201208060,2012,120806,BOS,TEX,BOS07,2,9,11
BOS201208070,2012,120807,BOS,TEX,BOS07,6,3,9
BOS201208080,2012,120808,BOS,TEX,BOS07,10,9,19
BOS201208210,2012,120821,BOS,ANA,BOS07,5,3,8
BOS201208220,2012,120822,BOS,ANA,BOS07,7,3,10
BOS201208230,2012,120823,BOS,ANA,BOS07,14,13,27
BOS201208240,2012,120824,BOS,KCA,BOS07,3,4,7
BOS201208250,2012,120825,BOS,KCA,BOS07,10,9,19
BOS201208260,2012,120826,BOS,KCA,BOS07,6,8,14
BOS201208270,2012,120827,BOS,KCA,BOS07,1,5,6
BOS201209070,2012,120907,BOS,TOR,BOS07,7,5,12
BOS201209080,2012,120908,BOS,TOR,BOS07,9,2,11
BOS201209090,2012,120909,BOS,TOR,BOS07,4,3,7
BOS201209110,2012,120911,BOS,NYA,BOS07,3,4,7
BOS201209120,2012,120912,BOS,NYA,BOS07,5,4,9
BOS201209130,2012,120913,BOS,NYA,BOS07,2,0,2
BOS201209210,2012,120921,BOS,BAL,BOS07,4,2,6
BOS201209220,2012,120922,BOS,BAL,BOS07,9,6,15
BOS201209230,2012,120923,BOS,BAL,BOS07,1,2,3
BOS201209250,2012,120925,BOS,TBA,BOS07,5,2,7
BOS201209260,2012,120926,BOS,TBA,BOS07,4,2,6
BOS201304080,2013,20130408,BOS,BAL,BOS07,1,3,4
BOS201304100,2013,20130410,BOS,BAL,BOS07,8,5,13
BOS201304110,2013,20130411,BOS,BAL,BOS07,3,2,5
BOS201304130,2013,20130413,BOS,TBA,BOS07,1,2,3
BOS201304140,2013,20130414,BOS,TBA,BOS07,0,5,5
BOS201304150,2013,20130415,BOS,TBA,BOS07,2,3,5
BOS201304200,2013,20130420,BOS,KCA,BOS07,3,4,7
BOS201304211,2013,20130421,BOS,KCA,BOS07,4,2,6
BOS201304212,2013,20130421,BOS,KCA,BOS07,5,4,9
BOS201304220,2013,20130422,BOS,OAK,BOS07,6,9,15
BOS201304230,2013,20130423,BOS,OAK,BOS07,13,0,13
BOS201304240,2013,20130424,BOS,OAK,BOS07,5,6,11
BOS201304250,2013,20130425,BOS,HOU,BOS07,2,7,9
BOS201304260,2013,20130426,BOS,HOU,BOS07,3,7,10
BOS201304270,2013,20130427,BOS,HOU,BOS07,4,8,12
BOS201304280,2013,20130428,BOS,HOU,BOS07,1,6,7
BOS201305060,2013,20130506,BOS,MIN,BOS07,5,6,11
BOS201305070,2013,20130507,BOS,MIN,BOS07,6,1,7
BOS201305080,2013,20130508,BOS,MIN,BOS07,15,8,23
BOS201305090,2013,20130509,BOS,MIN,BOS07,5,3,8
BOS201305100,2013,20130510,BOS,TOR,BOS07,0,5,5
BOS201305110,2013,20130511,BOS,TOR,BOS07,3,2,5
BOS201305120,2013,20130512,BOS,TOR,BOS07,12,4,16
BOS201305230,2013,20130523,BOS,CLE,BOS07,12,3,15
BOS201305240,2013,20130524,BOS,CLE,BOS07,1,8,9
BOS201305250,2013,20130525,BOS,CLE,BOS07,4,7,11
BOS201305260,2013,20130526,BOS,CLE,BOS07,5,6,11
BOS201305270,2013,20130527,BOS,PHI,BOS07,3,9,12
BOS201305280,2013,20130528,BOS,PHI,BOS07,3,1,4
BOS201306040,2013,20130604,BOS,TEX,BOS07,5,17,22
BOS201306050,2013,20130605,BOS,TEX,BOS07,3,2,5
BOS201306060,2013,20130606,BOS,TEX,BOS07,3,6,9
BOS201306081,2013,20130608,BOS,ANA,BOS07,9,5,14
BOS201306082,2013,20130608,BOS,ANA,BOS07,2,7,9
BOS201306090,2013,20130609,BOS,ANA,BOS07,5,10,15
BOS201306181,2013,20130618,BOS,TBA,BOS07,1,5,6
BOS201306182,2013,20130618,BOS,TBA,BOS07,1,3,4
BOS201306190,2013,20130619,BOS,TBA,BOS07,6,2,8
BOS201306250,2013,20130625,BOS,COL,BOS07,4,11,15
BOS201306260,2013,20130626,BOS,COL,BOS07,3,5,8
BOS201306270,2013,20130627,BOS,TOR,BOS07,4,7,11
BOS201306280,2013,20130628,BOS,TOR,BOS07,5,7,12
BOS201306290,2013,20130629,BOS,TOR,BOS07,6,2,8
BOS201306300,2013,20130630,BOS,TOR,BOS07,4,5,9
BOS201307020,2013,20130702,BOS,SDN,BOS07,1,4,5
BOS201307030,2013,20130703,BOS,SDN,BOS07,1,2,3
BOS201307040,2013,20130704,BOS,SDN,BOS07,2,8,10
BOS201307190,2013,20130719,BOS,NYA,BOS07,2,4,6
BOS201307200,2013,20130720,BOS,NYA,BOS07,5,2,7
BOS201307210,2013,20130721,BOS,NYA,BOS07,7,8,15
BOS201307220,2013,20130722,BOS,TBA,BOS07,3,0,3
BOS201307230,2013,20130723,BOS,TBA,BOS07,2,6,8
BOS201307240,2013,20130724,BOS,TBA,BOS07,5,1,6
BOS201307290,2013,20130729,BOS,TBA,BOS07,2,1,3
BOS201307300,2013,20130730,BOS,SEA,BOS07,2,8,10
BOS201307310,2013,20130731,BOS,SEA,BOS07,4,5,9
BOS201308010,2013,20130801,BOS,SEA,BOS07,7,8,15
BOS201308020,2013,20130802,BOS,ARI,BOS07,7,6,13
BOS201308030,2013,20130803,BOS,ARI,BOS07,2,5,7
BOS201308040,2013,20130804,BOS,ARI,BOS07,0,4,4
BOS201308160,2013,20130816,BOS,NYA,BOS07,10,3,13
BOS201308170,2013,20130817,BOS,NYA,BOS07,1,6,7
BOS201308180,2013,20130818,BOS,NYA,BOS07,9,6,15
BOS201308270,2013,20130827,BOS,BAL,BOS07,2,13,15
BOS201308280,2013,20130828,BOS,BAL,BOS07,3,4,7
BOS201308290,2013,20130829,BOS,BAL,BOS07,3,2,5
BOS201308300,2013,20130830,BOS,CHA,BOS07,3,4,7
BOS201308310,2013,20130831,BOS,CHA,BOS07,2,7,9
BOS201309010,2013,20130901,BOS,CHA,BOS07,6,7,13
BOS201309020,2013,20130902,BOS,DET,BOS07,3,0,3
BOS201309030,2013,20130903,BOS,DET,BOS07,1,2,3
BOS201309040,2013,20130904,BOS,DET,BOS07,4,20,24
BOS201309130,2013,20130913,BOS,NYA,BOS07,4,8,12
BOS201309140,2013,20130914,BOS,NYA,BOS07,1,5,6
BOS201309150,2013,20130915,BOS,NYA,BOS07,2,9,11
BOS201309170,2013,20130917,BOS,BAL,BOS07,3,2,5
BOS201309180,2013,20130918,BOS,BAL,BOS07,5,3,8
BOS201309190,2013,20130919,BOS,BAL,BOS07,1,3,4
BOS201309200,2013,20130920,BOS,TOR,BOS07,3,6,9
BOS201309210,2013,20130921,BOS,TOR,BOS07,4,2,6
BOS201309220,2013,20130922,BOS,TOR,BOS07,2,5,7
BOS201310040,2013,20131004,BOS,TBA,BOS07,2,12,14
BOS201310050,2013,20131005,BOS,TBA,BOS07,4,7,11
BOS201310120,2013,20131012,BOS,DET,BOS07,1,0,1
BOS201310130,2013,20131013,BOS,DET,BOS07,5,6,11
BOS201310190,2013,20131019,BOS,DET,BOS07,2,5,7
BOS201310230,2013,20131023,BOS,SLN,BOS07,1,8,9
BOS201310240,2013,20131024,BOS,SLN,BOS07,4,2,6
BOS201310300,2013,20131030,BOS,SLN,BOS07,1,6,7
CHA201004050,2010,100405,CHA,CLE,CHI12,0,6,6
CHA201004070,2010,100407,CHA,CLE,CHI12,5,3,8
CHA201004080,2010,100408,CHA,CLE,CHI12,5,3,8
CHA201004090,2010,100409,CHA,MIN,CHI12,4,3,7
CHA201004100,2010,100410,CHA,MIN,CHI12,2,1,3
CHA201004110,2010,100411,CHA,MIN,CHI12,4,5,9
CHA201004200,2010,100420,CHA,TBA,CHI12,1,4,5
CHA201004210,2010,100421,CHA,TBA,CHI12,12,0,12
CHA201004220,2010,100422,CHA,TBA,CHI12,10,2,12
CHA201004230,2010,100423,CHA,SEA,CHI12,6,7,13
CHA201004240,2010,100424,CHA,SEA,CHI12,4,5,9
CHA201004250,2010,100425,CHA,SEA,CHI12,2,3,5
CHA201005030,2010,100503,CHA,KCA,CHI12,1,5,6
CHA201005040,2010,100504,CHA,KCA,CHI12,7,2,9
CHA201005050,2010,100505,CHA,KCA,CHI12,2,9,11
CHA201005060,2010,100506,CHA,TOR,CHI12,2,0,2
CHA201005070,2010,100507,CHA,TOR,CHI12,7,4,11
CHA201005080,2010,100508,CHA,TOR,CHI12,3,7,10
CHA201005090,2010,100509,CHA,TOR,CHI12,9,7,16
CHA201005190,2010,100519,CHA,ANA,CHI12,3,2,5
CHA201005200,2010,100520,CHA,ANA,CHI12,6,5,11
CHA201005210,2010,100521,CHA,FLO,CHI12,0,8,8
CHA201005220,2010,100522,CHA,FLO,CHI12,1,4,5
CHA201005230,2010,100523,CHA,FLO,CHI12,13,0,13
CHA201006010,2010,100601,CHA,TEX,CHI12,9,6,15
CHA201006020,2010,100602,CHA,TEX,CHI12,9,5,14
CHA201006030,2010,100603,CHA,TEX,CHI12,3,4,7
CHA201006040,2010,100604,CHA,CLE,CHI12,10,1,11
CHA201006050,2010,100605,CHA,CLE,CHI12,3,1,4
CHA201006060,2010,100606,CHA,CLE,CHI12,7,8,15
CHA201006080,2010,100608,CHA,DET,CHI12,7,2,9
CHA201006090,2010,100609,CHA,DET,CHI12,3,15,18
CHA201006100,2010,100610,CHA,DET,CHI12,0,3,3
CHA201006220,2010,100622,CHA,ATL,CHI12,6,9,15
CHA201006230,2010,100623,CHA,ATL,CHI12,2,4,6
CHA201006240,2010,100624,CHA,ATL,CHI12,0,2,2
CHA201006250,2010,100625,CHA,CHN,CHI12,0,6,6
CHA201006260,2010,100626,CHA,CHN,CHI12,2,3,5
CHA201006270,2010,100627,CHA,CHN,CHI12,8,6,14
CHA201007050,2010,100705,CHA,ANA,CHI12,2,9,11
CHA201007060,2010,100706,CHA,ANA,CHI12,1,4,5
CHA201007070,2010,100707,CHA,ANA,CHI12,2,5,7
CHA201007080,2010,100708,CHA,ANA,CHI12,0,1,1
CHA201007090,2010,100709,CHA,KCA,CHI12,2,8,10
CHA201007100,2010,100710,CHA,KCA,CHI12,1,5,6
CHA201007110,2010,100711,CHA,KCA,CHI12,5,15,20
CHA201007260,2010,100726,CHA,SEA,CHI12,1,6,7
CHA201007270,2010,100727,CHA,SEA,CHI12,0,11,11
CHA201007280,2010,100728,CHA,SEA,CHI12,5,6,11
CHA201007290,2010,100729,CHA,SEA,CHI12,5,9,14
CHA201007300,2010,100730,CHA,OAK,CHI12,1,6,7
CHA201007310,2010,100731,CHA,OAK,CHI12,6,2,8
CHA201008010,2010,100801,CHA,OAK,CHI12,1,4,5
CHA201008100,2010,100810,CHA,MIN,CHI12,12,6,18
CHA201008110,2010,100811,CHA,MIN,CHI12,1,6,7
CHA201008120,2010,100812,CHA,MIN,CHI12,6,1,7
CHA201008130,2010,100813,CHA,DET,CHI12,4,8,12
CHA201008140,2010,100814,CHA,DET,CHI12,3,2,5
CHA201008150,2010,100815,CHA,DET,CHI12,13,8,21
CHA201008240,2010,100824,CHA,BAL,CHI12,5,7,12
CHA201008250,2010,100825,CHA,BAL,CHI12,4,2,6
CHA201008260,2010,100826,CHA,BAL,CHI12,0,8,8
CHA201008270,2010,100827,CHA,NYA,CHI12,4,9,13
CHA201008280,2010,100828,CHA,NYA,CHI12,12,9,21
CHA201008290,2010,100829,CHA,NYA,CHI12,2,1,3
CHA201009100,2010,100910,CHA,KCA,CHI12,3,4,7
CHA201009110,2010,100911,CHA,KCA,CHI12,8,2,10
CHA201009120,2010,100912,CHA,KCA,CHI12,6,12,18
CHA201009140,2010,100914,CHA,MIN,CHI12,9,3,12
CHA201009150,2010,100915,CHA,MIN,CHI12,9,3,12
CHA201009160,2010,100916,CHA,MIN,CHI12,8,5,13
CHA201009170,2010,100917,CHA,DET,CHI12,9,2,11
CHA201009180,2010,100918,CHA,DET,CHI12,6,3,9
CHA201009190,2010,100919,CHA,DET,CHI12,9,7,16
CHA201009270,2010,100927,CHA,BOS,CHI12,6,1,7
CHA201009280,2010,100928,CHA,BOS,CHI12,4,5,9
CHA201009290,2010,100929,CHA,BOS,CHI12,2,5,7
CHA201009300,2010,100930,CHA,BOS,CHI12,2,8,10
CHA201010010,2010,101001,CHA,CLE,CHI12,7,3,10
CHA201010020,2010,101002,CHA,CLE,CHI12,2,6,8
CHA201010030,2010,101003,CHA,CLE,CHI12,5,6,11
CHA201104070,2011,20110407,CHA,TBA,CHI12,1,5,6
CHA201104080,2011,20110408,CHA,TBA,CHI12,9,7,16
CHA201104090,2011,20110409,CHA,TBA,CHI12,2,4,6
CHA201104100,2011,20110410,CHA,TBA,CHI12,1,6,7
CHA201104110,2011,20110411,CHA,OAK,CHI12,2,1,3
CHA201104120,2011,20110412,CHA,OAK,CHI12,5,6,11
CHA201104130,2011,20110413,CHA,OAK,CHI12,7,4,11
CHA201104150,2011,20110415,CHA,ANA,CHI12,4,3,7
CHA201104160,2011,20110416,CHA,ANA,CHI12,7,2,9
CHA201104170,2011,20110417,CHA,ANA,CHI12,4,2,6
CHA201104290,2011,20110429,CHA,BAL,CHI12,10,4,14
CHA201104300,2011,20110430,CHA,BAL,CHI12,6,2,8
CHA201105010,2011,20110501,CHA,BAL,CHI12,6,4,10
CHA201105020,2011,20110502,CHA,BAL,CHI12,2,6,8
CHA201105030,2011,20110503,CHA,MIN,CHI12,1,0,1
CHA201105040,2011,20110504,CHA,MIN,CHI12,3,2,5
CHA201105160,2011,20110516,CHA,TEX,CHI12,4,0,4
CHA201105170,2011,20110517,CHA,TEX,CHI12,3,4,7
CHA201105180,2011,20110518,CHA,CLE,CHI12,0,1,1
CHA201105190,2011,20110519,CHA,CLE,CHI12,2,8,10
CHA201105200,2011,20110520,CHA,LAN,CHI12,6,4,10
CHA201105210,2011,20110521,CHA,LAN,CHI12,2,9,11
CHA201105220,2011,20110522,CHA,LAN,CHI12,3,8,11
CHA201106030,2011,20110603,CHA,DET,CHI12,4,6,10
CHA201106040,2011,20110604,CHA,DET,CHI12,4,2,6
CHA201106050,2011,20110605,CHA,DET,CHI12,7,3,10
CHA201106060,2011,20110606,CHA,SEA,CHI12,1,3,4
CHA201106070,2011,20110607,CHA,SEA,CHI12,1,5,6
CHA201106080,2011,20110608,CHA,SEA,CHI12,7,4,11
CHA201106090,2011,20110609,CHA,OAK,CHI12,4,9,13
CHA201106100,2011,20110610,CHA,OAK,CHI12,7,5,12
CHA201106110,2011,20110611,CHA,OAK,CHI12,2,3,5
CHA201106120,2011,20110612,CHA,OAK,CHI12,4,5,9
CHA201106200,2011,20110620,CHA,CHN,CHI12,6,3,9
CHA201106210,2011,20110621,CHA,CHN,CHI12,2,3,5
CHA201106220,2011,20110622,CHA,CHN,CHI12,3,4,7
CHA201106240,2011,20110624,CHA,WAS,CHI12,9,5,14
CHA201106250,2011,20110625,CHA,WAS,CHI12,0,3,3
CHA201106260,2011,20110626,CHA,WAS,CHI12,2,1,3
CHA201107040,2011,20110704,CHA,KCA,CHI12,4,5,9
CHA201107050,2011,20110705,CHA,KCA,CHI12,5,3,8
CHA201107060,2011,20110706,CHA,KCA,CHI12,4,1,5
CHA201107070,2011,20110707,CHA,MIN,CHI12,6,2,8
CHA201107080,2011,20110708,CHA,MIN,CHI12,8,5,13
CHA201107090,2011,20110709,CHA,MIN,CHI12,3,4,7
CHA201107100,2011,20110710,CHA,MIN,CHI12,6,3,9
CHA201107250,2011,20110725,CHA,DET,CHI12,3,6,9
CHA201107260,2011,20110726,CHA,DET,CHI12,5,4,9
CHA201107270,2011,20110727,CHA,DET,CHI12,1,2,3
CHA201107290,2011,20110729,CHA,BOS,CHI12,1,3,4
CHA201107300,2011,20110730,CHA,BOS,CHI12,10,2,12
CHA201107310,2011,20110731,CHA,BOS,CHI12,5,3,8
CHA201108010,2011,20110801,CHA,NYA,CHI12,3,2,5
CHA201108020,2011,20110802,CHA,NYA,CHI12,6,0,6
CHA201108030,2011,20110803,CHA,NYA,CHI12,18,7,25
CHA201108040,2011,20110804,CHA,NYA,CHI12,7,2,9
CHA201108120,2011,20110812,CHA,KCA,CHI12,5,1,6
CHA201108130,2011,20110813,CHA,KCA,CHI12,4,5,9
CHA201108140,2011,20110814,CHA,KCA,CHI12,2,6,8
CHA201108160,2011,20110816,CHA,CLE,CHI12,7,8,15
CHA201108170,2011,20110817,CHA,CLE,CHI12,4,1,5
CHA201108180,2011,20110818,CHA,CLE,CHI12,4,2,6
CHA201108190,2011,20110819,CHA,TEX,CHI12,7,4,11
CHA201108200,2011,20110820,CHA,TEX,CHI12,2,3,5
CHA201108210,2011,20110821,CHA,TEX,CHI12,0,10,10
CHA201108290,2011,20110829,CHA,MIN,CHI12,0,3,3
CHA201108300,2011,20110830,CHA,MIN,CHI12,6,8,14
CHA201108310,2011,20110831,CHA,MIN,CHI12,7,6,13
CHA201109080,2011,20110908,CHA,CLE,CHI12,1,8,9
CHA201109090,2011,20110909,CHA,CLE,CHI12,8,4,12
CHA201109100,2011,20110910,CHA,CLE,CHI12,3,7,10
CHA201109110,2011,20110911,CHA,CLE,CHI12,7,3,10
CHA201109120,2011,20110912,CHA,DET,CHI12,14,4,18
CHA201109130,2011,20110913,CHA,DET,CHI12,5,0,5
CHA201109140,2011,20110914,CHA,DET,CHI12,6,5,11
CHA201109230,2011,20110923,CHA,KCA,CHI12,11,1,12
CHA201109240,2011,20110924,CHA,KCA,CHI12,3,6,9
CHA201109250,2011,20110925,CHA,KCA,CHI12,2,1,3
CHA201109260,2011,20110926,CHA,TOR,CHI12,3,4,7
CHA201109270,2011,20110927,CHA,TOR,CHI12,1,2,3
CHA201109280,2011,20110928,CHA,TOR,CHI12,3,2,5
CHA201204130,2012,120413,CHA,DET,CHI12,2,5,7
CHA201204140,2012,120414,CHA,DET,CHI12,1,5,6
CHA201204150,2012,120415,CHA,DET,CHI12,5,2,7
CHA201204160,2012,120416,CHA,BAL,CHI12,10,4,14
CHA201204170,2012,120417,CHA,BAL,CHI12,3,2,5
CHA201204180,2012,120418,CHA,BAL,CHI12,1,8,9
CHA201204190,2012,120419,CHA,BAL,CHI12,5,3,8
CHA201204260,2012,120426,CHA,BOS,CHI12,10,3,13
CHA201204270,2012,120427,CHA,BOS,CHI12,10,3,13
CHA201204280,2012,120428,CHA,BOS,CHI12,1,0,1
CHA201204290,2012,120429,CHA,BOS,CHI12,1,4,5
CHA201205010,2012,120501,CHA,CLE,CHI12,2,7,9
CHA201205020,2012,120502,CHA,CLE,CHI12,6,3,9
CHA201205030,2012,120503,CHA,CLE,CHI12,7,5,12
CHA201205110,2012,120511,CHA,KCA,CHI12,0,5,5
CHA201205120,2012,120512,CHA,KCA,CHI12,5,0,5
CHA201205130,2012,120513,CHA,KCA,CHI12,9,1,10
CHA201205140,2012,120514,CHA,DET,CHI12,5,7,12
CHA201205150,2012,120515,CHA,DET,CHI12,10,8,18
CHA201205220,2012,120522,CHA,MIN,CHI12,9,2,11
CHA201205230,2012,120523,CHA,MIN,CHI12,0,6,6
CHA201205240,2012,120524,CHA,MIN,CHI12,8,11,19
CHA201205250,2012,120525,CHA,CLE,CHI12,3,9,12
CHA201205260,2012,120526,CHA,CLE,CHI12,7,14,21
CHA201205270,2012,120527,CHA,CLE,CHI12,6,12,18
CHA201206010,2012,120601,CHA,SEA,CHI12,4,7,11
CHA201206020,2012,120602,CHA,SEA,CHI12,10,8,18
CHA201206030,2012,120603,CHA,SEA,CHI12,2,4,6
CHA201206050,2012,120605,CHA,TOR,CHI12,9,5,14
CHA201206060,2012,120606,CHA,TOR,CHI12,4,0,4
CHA201206070,2012,120607,CHA,TOR,CHI12,3,4,7
CHA201206080,2012,120608,CHA,HOU,CHI12,8,3,11
CHA201206090,2012,120609,CHA,HOU,CHI12,1,10,11
CHA201206100,2012,120610,CHA,HOU,CHI12,11,9,20
CHA201206180,2012,120618,CHA,CHN,CHI12,12,3,15
CHA201206190,2012,120619,CHA,CHN,CHI12,2,1,3
CHA201206200,2012,120620,CHA,CHN,CHI12,0,7,7
CHA201206220,2012,120622,CHA,MIL,CHI12,1,0,1
CHA201206230,2012,120623,CHA,MIL,CHI12,6,8,14
CHA201206240,2012,120624,CHA,MIL,CHI12,0,1,1
CHA201207030,2012,120703,CHA,TEX,CHI12,2,19,21
CHA201207040,2012,120704,CHA,TEX,CHI12,4,5,9
CHA201207050,2012,120705,CHA,TEX,CHI12,1,2,3
CHA201207060,2012,120706,CHA,TOR,CHI12,2,4,6
CHA201207070,2012,120707,CHA,TOR,CHI12,0,2,2
CHA201207080,2012,120708,CHA,TOR,CHI12,11,9,20
CHA201207230,2012,120723,CHA,MIN,CHI12,4,7,11
CHA201207240,2012,120724,CHA,MIN,CHI12,4,11,15
CHA201207250,2012,120725,CHA,MIN,CHI12,2,8,10
CHA201208030,2012,120803,CHA,ANA,CHI12,6,8,14
CHA201208040,2012,120804,CHA,ANA,CHI12,6,5,11
CHA201208050,2012,120805,CHA,ANA,CHI12,2,4,6
CHA201208060,2012,120806,CHA,KCA,CHI12,2,4,6
CHA201208070,2012,120807,CHA,KCA,CHI12,5,2,7
CHA201208080,2012,120808,CHA,KCA,CHI12,2,1,3
CHA201208100,2012,120810,CHA,OAK,CHI12,3,4,7
CHA201208110,2012,120811,CHA,OAK,CHI12,9,7,16
CHA201208120,2012,120812,CHA,OAK,CHI12,3,7,10
CHA201208200,2012,120820,CHA,NYA,CHI12,6,9,15
CHA201208210,2012,120821,CHA,NYA,CHI12,3,7,10
CHA201208220,2012,120822,CHA,NYA,CHI12,1,2,3
CHA201208240,2012,120824,CHA,SEA,CHI12,8,9,17
CHA201208250,2012,120825,CHA,SEA,CHI12,4,5,9
CHA201208260,2012,120826,CHA,SEA,CHI12,3,4,7
CHA201209030,2012,120903,CHA,MIN,CHI12,2,4,6
CHA201209040,2012,120904,CHA,MIN,CHI12,18,9,27
CHA201209050,2012,120905,CHA,MIN,CHI12,2,6,8
CHA201209070,2012,120907,CHA,KCA,CHI12,7,5,12
CHA201209080,2012,120908,CHA,KCA,CHI12,4,5,9
CHA201209090,2012,120909,CHA,KCA,CHI12,2,1,3
CHA201209100,2012,120910,CHA,DET,CHI12,1,6,7
CHA201209110,2012,120911,CHA,DET,CHI12,5,3,8
CHA201209120,2012,120912,CHA,DET,CHI12,8,6,14
CHA201209170,2012,120917,CHA,DET,CHI12,4,5,9
CHA201209240,2012,120924,CHA,CLE,CHI12,4,5,9
CHA201209250,2012,120925,CHA,CLE,CHI12,4,3,7
CHA201209260,2012,120926,CHA,CLE,CHI12,6,4,10
CHA201209270,2012,120927,CHA,TBA,CHI12,3,2,5
CHA201209280,2012,120928,CHA,TBA,CHI12,1,3,4
CHA201209290,2012,120929,CHA,TBA,CHI12,10,4,14
CHA201209300,2012,120930,CHA,TBA,CHI12,6,2,8
CHA201304010,2013,20130401,CHA,KCA,CHI12,0,1,1
CHA201304030,2013,20130403,CHA,KCA,CHI12,2,5,7
CHA201304040,2013,20130404,CHA,KCA,CHI12,3,1,4
CHA201304050,2013,20130405,CHA,SEA,CHI12,8,7,15
CHA201304060,2013,20130406,CHA,SEA,CHI12,3,4,7
CHA201304070,2013,20130407,CHA,SEA,CHI12,3,4,7
CHA201304200,2013,20130420,CHA,MIN,CHI12,2,1,3
CHA201304210,2013,20130421,CHA,MIN,CHI12,5,3,8
CHA201304220,2013,20130422,CHA,CLE,CHI12,3,2,5
CHA201304240,2013,20130424,CHA,CLE,CHI12,2,3,5
CHA201304250,2013,20130425,CHA,TBA,CHI12,2,5,7
CHA201304260,2013,20130426,CHA,TBA,CHI12,4,5,9
CHA201304270,2013,20130427,CHA,TBA,CHI12,10,4,14
CHA201304280,2013,20130428,CHA,TBA,CHI12,8,3,11
CHA201305100,2013,20130510,CHA,ANA,CHI12,7,5,12
CHA201305110,2013,20130511,CHA,ANA,CHI12,3,2,5
CHA201305120,2013,20130512,CHA,ANA,CHI12,0,3,3
CHA201305200,2013,20130520,CHA,BOS,CHI12,4,6,10
CHA201305210,2013,20130521,CHA,BOS,CHI12,1,3,4
CHA201305220,2013,20130522,CHA,BOS,CHI12,6,2,8
CHA201305240,2013,20130524,CHA,MIA,CHI12,3,4,7
CHA201305250,2013,20130525,CHA,MIA,CHI12,1,2,3
CHA201305260,2013,20130526,CHA,MIA,CHI12,3,5,8
CHA201305270,2013,20130527,CHA,CHN,CHI12,7,0,7
CHA201306060,2013,20130606,CHA,OAK,CHI12,5,4,9
CHA201306070,2013,20130607,CHA,OAK,CHI12,4,3,7
CHA201306080,2013,20130608,CHA,OAK,CHI12,1,4,5
CHA201306090,2013,20130609,CHA,OAK,CHI12,2,4,6
CHA201306100,2013,20130610,CHA,TOR,CHI12,6,10,16
CHA201306110,2013,20130611,CHA,TOR,CHI12,7,5,12
CHA201306250,2013,20130625,CHA,NYN,CHI12,4,5,9
CHA201306260,2013,20130626,CHA,NYN,CHI12,3,0,3
CHA201306281,2013,20130628,CHA,CLE,CHI12,19,10,29
CHA201306282,2013,20130628,CHA,CLE,CHI12,9,8,17
CHA201306290,2013,20130629,CHA,CLE,CHI12,4,3,7
CHA201306300,2013,20130630,CHA,CLE,CHI12,4,0,4
CHA201307020,2013,20130702,CHA,BAL,CHI12,2,5,7
CHA201307030,2013,20130703,CHA,BAL,CHI12,4,2,6
CHA201307040,2013,20130704,CHA,BAL,CHI12,2,3,5
CHA201307080,2013,20130708,CHA,CHN,CHI12,8,2,10
CHA201307190,2013,20130719,CHA,ATL,CHI12,6,4,10
CHA201307200,2013,20130720,CHA,ATL,CHI12,6,10,16
CHA201307210,2013,20130721,CHA,ATL,CHI12,1,3,4
CHA201307220,2013,20130722,CHA,DET,CHI12,7,3,10
CHA201307230,2013,20130723,CHA,DET,CHI12,6,2,8
CHA201307240,2013,20130724,CHA,DET,CHI12,6,2,8
CHA201307250,2013,20130725,CHA,DET,CHI12,4,7,11
CHA201307260,2013,20130726,CHA,KCA,CHI12,5,1,6
CHA201307270,2013,20130727,CHA,KCA,CHI12,1,0,1
CHA201307280,2013,20130728,CHA,KCA,CHI12,4,2,6
CHA201308050,2013,20130805,CHA,NYA,CHI12,1,8,9
CHA201308060,2013,20130806,CHA,NYA,CHI12,2,3,5
CHA201308070,2013,20130807,CHA,NYA,CHI12,5,6,11
CHA201308091,2013,20130809,CHA,MIN,CHI12,7,5,12
CHA201308092,2013,20130809,CHA,MIN,CHI12,3,2,5
CHA201308100,2013,20130810,CHA,MIN,CHI12,4,5,9
CHA201308110,2013,20130811,CHA,MIN,CHI12,5,2,7
CHA201308120,2013,20130812,CHA,DET,CHI12,2,6,8
CHA201308130,2013,20130813,CHA,DET,CHI12,3,4,7
CHA201308140,2013,20130814,CHA,DET,CHI12,6,4,10
CHA201308230,2013,20130823,CHA,TEX,CHI12,11,5,16
CHA201308240,2013,20130824,CHA,TEX,CHI12,2,3,5
CHA201308250,2013,20130825,CHA,TEX,CHI12,2,5,7
CHA201308260,2013,20130826,CHA,HOU,CHI12,10,8,18
CHA201308270,2013,20130827,CHA,HOU,CHI12,3,4,7
CHA201308280,2013,20130828,CHA,HOU,CHI12,1,6,7
CHA201309090,2013,20130909,CHA,DET,CHI12,1,5,6
CHA201309100,2013,20130910,CHA,DET,CHI12,9,1,10
CHA201309110,2013,20130911,CHA,DET,CHI12,1,0,1
CHA201309120,2013,20130912,CHA,CLE,CHI12,14,3,17
CHA201309130,2013,20130913,CHA,CLE,CHI12,3,1,4
CHA201309140,2013,20130914,CHA,CLE,CHI12,8,1,9
CHA201309150,2013,20130915,CHA,CLE,CHI12,7,1,8
CHA201309160,2013,20130916,CHA,MIN,CHI12,1,12,13
CHA201309170,2013,20130917,CHA,MIN,CHI12,3,4,7
CHA201309180,2013,20130918,CHA,MIN,CHI12,4,3,7
CHA201309230,2013,20130923,CHA,TOR,CHI12,2,3,5
CHA201309260,2013,20130926,CHA,KCA,CHI12,3,2,5
CHA201309270,2013,20130927,CHA,KCA,CHI12,6,1,7
CHA201309280,2013,20130928,CHA,KCA,CHI12,5,6,11
CHA201309290,2013,20130929,CHA,KCA,CHI12,4,1,5
CHN201004120,2010,100412,CHN,MIL,CHI11,5,9,14
CHN201004140,2010,100414,CHN,MIL,CHI11,6,7,13
CHN201004150,2010,100415,CHN,MIL,CHI11,8,6,14
CHN201004160,2010,100416,CHN,HOU,CHI11,2,7,9
CHN201004170,2010,100417,CHN,HOU,CHI11,4,3,7
CHN201004180,2010,100418,CHN,HOU,CHI11,3,2,5
CHN201004260,2010,100426,CHN,WAS,CHI11,3,4,7
CHN201004270,2010,100427,CHN,WAS,CHI11,3,1,4
CHN201004280,2010,100428,CHN,WAS,CHI11,3,2,5
CHN201004290,2010,100429,CHN,ARI,CHI11,13,5,18
CHN201004300,2010,100430,CHN,ARI,CHI11,5,11,16
CHN201005010,2010,100501,CHN,ARI,CHI11,5,7,12
CHN201005020,2010,100502,CHN,ARI,CHI11,5,10,15
CHN201005100,2010,100510,CHN,FLO,CHI11,4,2,6
CHN201005110,2010,100511,CHN,FLO,CHI11,3,2,5
CHN201005120,2010,100512,CHN,FLO,CHI11,3,4,7
CHN201005140,2010,100514,CHN,PIT,CHI11,10,6,16
CHN201005150,2010,100515,CHN,PIT,CHI11,4,3,7
CHN201005160,2010,100516,CHN,PIT,CHI11,3,4,7
CHN201005170,2010,100517,CHN,COL,CHI11,2,4,6
CHN201005180,2010,100518,CHN,COL,CHI11,2,6,8
CHN201005250,2010,100525,CHN,LAN,CHI11,0,3,3
CHN201005260,2010,100526,CHN,LAN,CHI11,8,5,13
CHN201005270,2010,100527,CHN,LAN,CHI11,0,1,1
CHN201005280,2010,100528,CHN,SLN,CHI11,7,1,8
CHN201005290,2010,100529,CHN,SLN,CHI11,0,5,5
CHN201005300,2010,100530,CHN,SLN,CHI11,9,1,10
CHN201006110,2010,100611,CHN,CHA,CHI11,10,5,15
CHN201006120,2010,100612,CHN,CHA,CHI11,2,1,3
CHN201006130,2010,100613,CHN,CHA,CHI11,0,1,1
CHN201006150,2010,100615,CHN,OAK,CHI11,9,5,14
CHN201006160,2010,100616,CHN,OAK,CHI11,2,6,8
CHN201006170,2010,100617,CHN,OAK,CHI11,2,3,5
CHN201006180,2010,100618,CHN,ANA,CHI11,7,6,13
CHN201006190,2010,100619,CHN,ANA,CHI11,12,0,12
CHN201006200,2010,100620,CHN,ANA,CHI11,1,12,13
CHN201006280,2010,100628,CHN,PIT,CHI11,2,1,3
CHN201006290,2010,100629,CHN,PIT,CHI11,1,3,4
CHN201006300,2010,100630,CHN,PIT,CHI11,2,0,2
CHN201007010,2010,100701,CHN,CIN,CHI11,3,2,5
CHN201007020,2010,100702,CHN,CIN,CHI11,12,0,12
CHN201007030,2010,100703,CHN,CIN,CHI11,1,3,4
CHN201007040,2010,100704,CHN,CIN,CHI11,14,3,17
CHN201007150,2010,100715,CHN,PHI,CHI11,6,12,18
CHN201007160,2010,100716,CHN,PHI,CHI11,3,4,7
CHN201007170,2010,100717,CHN,PHI,CHI11,4,1,5
CHN201007180,2010,100718,CHN,PHI,CHI11,6,11,17
CHN201007190,2010,100719,CHN,HOU,CHI11,11,5,16
CHN201007200,2010,100720,CHN,HOU,CHI11,7,14,21
CHN201007210,2010,100721,CHN,HOU,CHI11,4,3,7
CHN201007230,2010,100723,CHN,SLN,CHI11,0,5,5
CHN201007240,2010,100724,CHN,SLN,CHI11,5,6,11
CHN201007250,2010,100725,CHN,SLN,CHI11,4,3,7
CHN201008020,2010,100802,CHN,MIL,CHI11,18,1,19
CHN201008030,2010,100803,CHN,MIL,CHI11,4,3,7
CHN201008040,2010,100804,CHN,MIL,CHI11,3,15,18
CHN201008060,2010,100806,CHN,CIN,CHI11,3,0,3
CHN201008070,2010,100807,CHN,CIN,CHI11,4,3,7
CHN201008080,2010,100808,CHN,CIN,CHI11,11,4,15
CHN201008160,2010,100816,CHN,SDN,CHI11,9,5,14
CHN201008170,2010,100817,CHN,SDN,CHI11,1,0,1
CHN201008180,2010,100818,CHN,SDN,CHI11,5,1,6
CHN201008190,2010,100819,CHN,SDN,CHI11,5,3,8
CHN201008200,2010,100820,CHN,ATL,CHI11,5,3,8
CHN201008210,2010,100821,CHN,ATL,CHI11,4,5,9
CHN201008220,2010,100822,CHN,ATL,CHI11,16,5,21
CHN201008300,2010,100830,CHN,PIT,CHI11,2,14,16
CHN201008310,2010,100831,CHN,PIT,CHI11,14,7,21
CHN201009010,2010,100901,CHN,PIT,CHI11,3,5,8
CHN201009030,2010,100903,CHN,NYN,CHI11,6,7,13
CHN201009040,2010,100904,CHN,NYN,CHI11,3,5,8
CHN201009050,2010,100905,CHN,NYN,CHI11,18,5,23
CHN201009060,2010,100906,CHN,HOU,CHI11,4,5,9
CHN201009070,2010,100907,CHN,HOU,CHI11,7,3,10
CHN201009080,2010,100908,CHN,HOU,CHI11,4,0,4
CHN201009210,2010,100921,CHN,SFN,CHI11,1,0,1
CHN201009220,2010,100922,CHN,SFN,CHI11,0,2,2
CHN201009230,2010,100923,CHN,SFN,CHI11,13,0,13
CHN201009240,2010,100924,CHN,SLN,CHI11,7,1,8
CHN201009250,2010,100925,CHN,SLN,CHI11,3,7,10
CHN201009260,2010,100926,CHN,SLN,CHI11,8,7,15
CHN201104010,2011,20110401,CHN,PIT,CHI11,6,3,9
CHN201104020,2011,20110402,CHN,PIT,CHI11,3,5,8
CHN201104030,2011,20110403,CHN,PIT,CHI11,5,4,9
CHN201104040,2011,20110404,CHN,ARI,CHI11,1,4,5
CHN201104050,2011,20110405,CHN,ARI,CHI11,5,6,11
CHN201104060,2011,20110406,CHN,ARI,CHI11,6,4,10
CHN201104180,2011,20110418,CHN,SDN,CHI11,0,1,1
CHN201104201,2011,20110420,CHN,SDN,CHI11,1,2,3
CHN201104202,2011,20110420,CHN,SDN,CHI11,5,4,9
CHN201104220,2011,20110422,CHN,LAN,CHI11,12,2,14
CHN201104230,2011,20110423,CHN,LAN,CHI11,8,10,18
CHN201104240,2011,20110424,CHN,LAN,CHI11,7,3,10
CHN201104250,2011,20110425,CHN,COL,CHI11,5,3,8
CHN201104260,2011,20110426,CHN,COL,CHI11,4,3,7
CHN201105060,2011,20110506,CHN,CIN,CHI11,5,4,9
CHN201105070,2011,20110507,CHN,CIN,CHI11,2,3,5
CHN201105080,2011,20110508,CHN,CIN,CHI11,2,0,2
CHN201105100,2011,20110510,CHN,SLN,CHI11,6,4,10
CHN201105110,2011,20110511,CHN,SLN,CHI11,4,11,15
CHN201105120,2011,20110512,CHN,SLN,CHI11,9,1,10
CHN201105130,2011,20110513,CHN,SFN,CHI11,4,11,15
CHN201105140,2011,20110514,CHN,SFN,CHI11,3,0,3
CHN201105240,2011,20110524,CHN,NYN,CHI11,1,11,12
CHN201105250,2011,20110525,CHN,NYN,CHI11,7,4,11
CHN201105260,2011,20110526,CHN,NYN,CHI11,3,9,12
CHN201105270,2011,20110527,CHN,PIT,CHI11,4,2,6
CHN201105280,2011,20110528,CHN,PIT,CHI11,10,0,10
CHN201105290,2011,20110529,CHN,PIT,CHI11,2,3,5
CHN201105300,2011,20110530,CHN,HOU,CHI11,12,7,19
CHN201105310,2011,20110531,CHN,HOU,CHI11,7,3,10
CHN201106010,2011,20110601,CHN,HOU,CHI11,3,1,4
CHN201106130,2011,20110613,CHN,MIL,CHI11,0,1,1
CHN201106140,2011,20110614,CHN,MIL,CHI11,4,5,9
CHN201106150,2011,20110615,CHN,MIL,CHI11,9,5,14
CHN201106160,2011,20110616,CHN,MIL,CHI11,7,12,19
CHN201106170,2011,20110617,CHN,NYA,CHI11,1,3,4
CHN201106180,2011,20110618,CHN,NYA,CHI11,4,3,7
CHN201106190,2011,20110619,CHN,NYA,CHI11,10,4,14
CHN201106270,2011,20110627,CHN,COL,CHI11,3,7,10
CHN201106281,2011,20110628,CHN,SFN,CHI11,13,7,20
CHN201106282,2011,20110628,CHN,SFN,CHI11,6,3,9
CHN201106290,2011,20110629,CHN,SFN,CHI11,1,2,3
CHN201106300,2011,20110630,CHN,SFN,CHI11,2,5,7
CHN201107010,2011,20110701,CHN,CHA,CHI11,6,4,10
CHN201107020,2011,20110702,CHN,CHA,CHI11,1,0,1
CHN201107030,2011,20110703,CHN,CHA,CHI11,1,3,4
CHN201107140,2011,20110714,CHN,FLO,CHI11,6,3,9
CHN201107150,2011,20110715,CHN,FLO,CHI11,1,2,3
CHN201107160,2011,20110716,CHN,FLO,CHI11,13,3,16
CHN201107170,2011,20110717,CHN,FLO,CHI11,7,5,12
CHN201107180,2011,20110718,CHN,PHI,CHI11,1,6,7
CHN201107190,2011,20110719,CHN,PHI,CHI11,4,2,6
CHN201107200,2011,20110720,CHN,PHI,CHI11,9,1,10
CHN201107220,2011,20110722,CHN,HOU,CHI11,2,4,6
CHN201107230,2011,20110723,CHN,HOU,CHI11,1,5,6
CHN201107240,2011,20110724,CHN,HOU,CHI11,4,5,9
CHN201108050,2011,20110805,CHN,CIN,CHI11,3,4,7
CHN201108060,2011,20110806,CHN,CIN,CHI11,4,11,15
CHN201108070,2011,20110807,CHN,CIN,CHI11,8,7,15
CHN201108090,2011,20110809,CHN,WAS,CHI11,3,1,4
CHN201108100,2011,20110810,CHN,WAS,CHI11,2,4,6
CHN201108110,2011,20110811,CHN,WAS,CHI11,3,4,7
CHN201108190,2011,20110819,CHN,SLN,CHI11,4,5,9
CHN201108200,2011,20110820,CHN,SLN,CHI11,0,3,3
CHN201108210,2011,20110821,CHN,SLN,CHI11,6,2,8
CHN201108220,2011,20110822,CHN,ATL,CHI11,3,0,3
CHN201108230,2011,20110823,CHN,ATL,CHI11,5,4,9
CHN201108240,2011,20110824,CHN,ATL,CHI11,2,3,5
CHN201108250,2011,20110825,CHN,ATL,CHI11,8,3,11
CHN201109020,2011,20110902,CHN,PIT,CHI11,3,1,4
CHN201109030,2011,20110903,CHN,PIT,CHI11,7,5,12
CHN201109040,2011,20110904,CHN,PIT,CHI11,3,6,9
CHN201109050,2011,20110905,CHN,CIN,CHI11,3,4,7
CHN201109060,2011,20110906,CHN,CIN,CHI11,4,2,6
CHN201109070,2011,20110907,CHN,CIN,CHI11,3,6,9
CHN201109160,2011,20110916,CHN,HOU,CHI11,3,4,7
CHN201109170,2011,20110917,CHN,HOU,CHI11,1,2,3
CHN201109180,2011,20110918,CHN,HOU,CHI11,3,2,5
CHN201109190,2011,20110919,CHN,MIL,CHI11,2,5,7
CHN201109200,2011,20110920,CHN,MIL,CHI11,5,1,6
CHN201109210,2011,20110921,CHN,MIL,CHI11,1,7,8
CHN201204050,2012,120405,CHN,WAS,CHI11,2,1,3
CHN201204070,2012,120407,CHN,WAS,CHI11,7,4,11
CHN201204080,2012,120408,CHN,WAS,CHI11,3,4,7
CHN201204090,2012,120409,CHN,MIL,CHI11,7,5,12
CHN201204100,2012,120410,CHN,MIL,CHI11,7,4,11
CHN201204110,2012,120411,CHN,MIL,CHI11,2,1,3
CHN201204120,2012,120412,CHN,MIL,CHI11,0,8,8
CHN201204200,2012,120420,CHN,CIN,CHI11,9,4,13
CHN201204210,2012,120421,CHN,CIN,CHI11,1,6,7
CHN201204220,2012,120422,CHN,CIN,CHI11,4,3,7
CHN201204230,2012,120423,CHN,SLN,CHI11,2,3,5
CHN201204240,2012,120424,CHN,SLN,CHI11,2,3,5
CHN201204250,2012,120425,CHN,SLN,CHI11,5,1,6
CHN201205040,2012,120504,CHN,LAN,CHI11,4,5,9
CHN201205050,2012,120505,CHN,LAN,CHI11,5,1,6
CHN201205060,2012,120506,CHN,LAN,CHI11,3,4,7
CHN201205070,2012,120507,CHN,ATL,CHI11,1,5,6
CHN201205080,2012,120508,CHN,ATL,CHI11,3,1,4
CHN201205090,2012,120509,CHN,ATL,CHI11,0,1,1
CHN201205160,2012,120516,CHN,PHI,CHI11,9,2,11
CHN201205170,2012,120517,CHN,PHI,CHI11,8,7,15
CHN201205180,2012,120518,CHN,CHA,CHI11,3,2,5
CHN201205190,2012,120519,CHN,CHA,CHI11,7,4,11
CHN201205200,2012,120520,CHN,CHA,CHI11,6,0,6
CHN201205280,2012,120528,CHN,SDN,CHI11,7,11,18
CHN201205290,2012,120529,CHN,SDN,CHI11,3,5,8
CHN201205300,2012,120530,CHN,SDN,CHI11,6,8,14
CHN201206120,2012,120612,CHN,DET,CHI11,3,4,7
CHN201206130,2012,120613,CHN,DET,CHI11,8,4,12
CHN201206140,2012,120614,CHN,DET,CHI11,5,3,8
CHN201206150,2012,120615,CHN,BOS,CHI11,0,3,3
CHN201206160,2012,120616,CHN,BOS,CHI11,4,3,7
CHN201206170,2012,120617,CHN,BOS,CHI11,7,4,11
CHN201206250,2012,120625,CHN,NYN,CHI11,1,6,7
CHN201206260,2012,120626,CHN,NYN,CHI11,3,5,8
CHN201206270,2012,120627,CHN,NYN,CHI11,17,1,18
CHN201206290,2012,120629,CHN,HOU,CHI11,0,4,4
CHN201206300,2012,120630,CHN,HOU,CHI11,2,3,5
CHN201207010,2012,120701,CHN,HOU,CHI11,0,3,3
CHN201207130,2012,120713,CHN,ARI,CHI11,1,8,9
CHN201207140,2012,120714,CHN,ARI,CHI11,1,4,5
CHN201207150,2012,120715,CHN,ARI,CHI11,1,3,4
CHN201207170,2012,120717,CHN,MIA,CHI11,9,5,14
CHN201207180,2012,120718,CHN,MIA,CHI11,1,5,6
CHN201207190,2012,120719,CHN,MIA,CHI11,2,4,6
CHN201207270,2012,120727,CHN,SLN,CHI11,9,6,15
CHN201207280,2012,120728,CHN,SLN,CHI11,2,3,5
CHN201207290,2012,120729,CHN,SLN,CHI11,2,4,6
CHN201207300,2012,120730,CHN,PIT,CHI11,4,14,18
CHN201207310,2012,120731,CHN,PIT,CHI11,5,0,5
CHN201208010,2012,120801,CHN,PIT,CHI11,8,4,12
CHN201208090,2012,120809,CHN,CIN,CHI11,3,5,8
CHN201208100,2012,120810,CHN,CIN,CHI11,10,8,18
CHN201208110,2012,120811,CHN,CIN,CHI11,4,2,6
CHN201208120,2012,120812,CHN,CIN,CHI11,3,0,3
CHN201208130,2012,120813,CHN,HOU,CHI11,1,7,8
CHN201208140,2012,120814,CHN,HOU,CHI11,10,1,11
CHN201208150,2012,120815,CHN,HOU,CHI11,2,7,9
CHN201208240,2012,120824,CHN,COL,CHI11,3,5,8
CHN201208250,2012,120825,CHN,COL,CHI11,4,3,7
CHN201208260,2012,120826,CHN,COL,CHI11,0,5,5
CHN201208270,2012,120827,CHN,MIL,CHI11,15,4,19
CHN201208280,2012,120828,CHN,MIL,CHI11,4,1,5
CHN201208290,2012,120829,CHN,MIL,CHI11,3,1,4
CHN201208300,2012,120830,CHN,MIL,CHI11,11,12,23
CHN201208310,2012,120831,CHN,SFN,CHI11,4,6,10
CHN201209010,2012,120901,CHN,SFN,CHI11,5,2,7
CHN201209020,2012,120902,CHN,SFN,CHI11,7,5,12
CHN201209140,2012,120914,CHN,PIT,CHI11,4,7,11
CHN201209150,2012,120915,CHN,PIT,CHI11,7,6,13
CHN201209160,2012,120916,CHN,PIT,CHI11,9,13,22
CHN201209170,2012,120917,CHN,PIT,CHI11,3,0,3
CHN201209180,2012,120918,CHN,CIN,CHI11,3,1,4
CHN201209190,2012,120919,CHN,CIN,CHI11,6,5,11
CHN201209200,2012,120920,CHN,CIN,CHI11,5,3,8
CHN201209210,2012,120921,CHN,SLN,CHI11,4,5,9
CHN201209220,2012,120922,CHN,SLN,CHI11,5,4,9
CHN201209230,2012,120923,CHN,SLN,CHI11,6,3,9
CHN201210010,2012,121001,CHN,HOU,CHI11,3,0,3
CHN201210020,2012,121002,CHN,HOU,CHI11,3,0,3
CHN201210030,2012,121003,CHN,HOU,CHI11,4,5,9
CHN201304080,2013,20130408,CHN,MIL,CHI11,7,4,11
CHN201304090,2013,20130409,CHN,MIL,CHI11,3,6,9
CHN201304110,2013,20130411,CHN,SFN,CHI11,7,6,13
CHN201304120,2013,20130412,CHN,SFN,CHI11,3,4,7
CHN201304130,2013,20130413,CHN,SFN,CHI11,3,2,5
CHN201304140,2013,20130414,CHN,SFN,CHI11,10,7,17
CHN201304160,2013,20130416,CHN,TEX,CHI11,4,2,6
CHN201304180,2013,20130418,CHN,TEX,CHI11,2,6,8
CHN201304290,2013,20130429,CHN,SDN,CHI11,3,5,8
CHN201304300,2013,20130430,CHN,SDN,CHI11,13,7,20
CHN201305010,2013,20130501,CHN,SDN,CHI11,2,6,8
CHN201305020,2013,20130502,CHN,SDN,CHI11,4,2,6
CHN201305030,2013,20130503,CHN,CIN,CHI11,6,5,11
CHN201305040,2013,20130504,CHN,CIN,CHI11,6,4,10
CHN201305050,2013,20130505,CHN,CIN,CHI11,7,4,11
CHN201305060,2013,20130506,CHN,TEX,CHI11,2,9,11
CHN201305070,2013,20130507,CHN,SLN,CHI11,1,2,3
CHN201305080,2013,20130508,CHN,SLN,CHI11,5,4,9
CHN201305130,2013,20130513,CHN,COL,CHI11,1,9,10
CHN201305140,2013,20130514,CHN,COL,CHI11,9,4,13
CHN201305150,2013,20130515,CHN,COL,CHI11,3,6,9
CHN201305170,2013,20130517,CHN,NYN,CHI11,3,2,5
CHN201305180,2013,20130518,CHN,NYN,CHI11,2,8,10
CHN201305190,2013,20130519,CHN,NYN,CHI11,4,3,7
CHN201305290,2013,20130529,CHN,CHA,CHI11,3,9,12
CHN201305300,2013,20130530,CHN,CHA,CHI11,3,8,11
CHN201305310,2013,20130531,CHN,ARI,CHI11,2,7,9
CHN201306010,2013,20130601,CHN,ARI,CHI11,12,4,16
CHN201306020,2013,20130602,CHN,ARI,CHI11,8,4,12
CHN201306070,2013,20130607,CHN,PIT,CHI11,2,0,2
CHN201306080,2013,20130608,CHN,PIT,CHI11,6,2,8
CHN201306090,2013,20130609,CHN,PIT,CHI11,1,4,5
CHN201306100,2013,20130610,CHN,CIN,CHI11,6,2,8
CHN201306110,2013,20130611,CHN,CIN,CHI11,12,2,14
CHN201306120,2013,20130612,CHN,CIN,CHI11,2,1,3
CHN201306130,2013,20130613,CHN,CIN,CHI11,5,6,11
CHN201306210,2013,20130621,CHN,HOU,CHI11,1,3,4
CHN201306220,2013,20130622,CHN,HOU,CHI11,4,3,7
CHN201306230,2013,20130623,CHN,HOU,CHI11,6,14,20
CHN201307050,2013,20130705,CHN,PIT,CHI11,6,2,8
CHN201307060,2013,20130706,CHN,PIT,CHI11,1,4,5
CHN201307070,2013,20130707,CHN,PIT,CHI11,3,4,7
CHN201307090,2013,20130709,CHN,ANA,CHI11,2,7,9
CHN201307100,2013,20130710,CHN,ANA,CHI11,13,2,15
CHN201307110,2013,20130711,CHN,SLN,CHI11,0,3,3
CHN201307120,2013,20130712,CHN,SLN,CHI11,3,2,5
CHN201307130,2013,20130713,CHN,SLN,CHI11,4,6,10
CHN201307140,2013,20130714,CHN,SLN,CHI11,10,6,16
CHN201307290,2013,20130729,CHN,MIL,CHI11,5,0,5
CHN201307301,2013,20130730,CHN,MIL,CHI11,6,5,11
CHN201307302,2013,20130730,CHN,MIL,CHI11,3,2,5
CHN201307310,2013,20130731,CHN,MIL,CHI11,1,6,7
CHN201308010,2013,20130801,CHN,LAN,CHI11,6,4,10
CHN201308020,2013,20130802,CHN,LAN,CHI11,6,2,8
CHN201308030,2013,20130803,CHN,LAN,CHI11,3,0,3
CHN201308040,2013,20130804,CHN,LAN,CHI11,1,0,1
CHN201308120,2013,20130812,CHN,CIN,CHI11,2,0,2
CHN201308130,2013,20130813,CHN,CIN,CHI11,6,4,10
CHN201308140,2013,20130814,CHN,CIN,CHI11,5,0,5
CHN201308160,2013,20130816,CHN,SLN,CHI11,0,7,7
CHN201308170,2013,20130817,CHN,SLN,CHI11,4,0,4
CHN201308180,2013,20130818,CHN,SLN,CHI11,6,1,7
CHN201308190,2013,20130819,CHN,WAS,CHI11,1,11,12
CHN201308200,2013,20130820,CHN,WAS,CHI11,4,2,6
CHN201308210,2013,20130821,CHN,WAS,CHI11,11,6,17
CHN201308220,2013,20130822,CHN,WAS,CHI11,5,4,9
CHN201308300,2013,20130830,CHN,PHI,CHI11,6,5,11
CHN201308310,2013,20130831,CHN,PHI,CHI11,3,4,7
CHN201309010,2013,20130901,CHN,PHI,CHI11,1,7,8
CHN201309020,2013,20130902,CHN,MIA,CHI11,4,3,7
CHN201309030,2013,20130903,CHN,MIA,CHI11,6,2,8
CHN201309040,2013,20130904,CHN,MIA,CHI11,7,9,16
CHN201309060,2013,20130906,CHN,MIL,CHI11,5,8,13
CHN201309070,2013,20130907,CHN,MIL,CHI11,5,3,8
CHN201309080,2013,20130908,CHN,MIL,CHI11,3,1,4
CHN201309200,2013,20130920,CHN,ATL,CHI11,9,5,14
CHN201309210,2013,20130921,CHN,ATL,CHI11,1,3,4
CHN201309220,2013,20130922,CHN,ATL,CHI11,5,2,7
CHN201309230,2013,20130923,CHN,PIT,CHI11,2,1,3
CHN201309240,2013,20130924,CHN,PIT,CHI11,8,2,10
CHN201309250,2013,20130925,CHN,PIT,CHI11,2,4,6
CIN201004050,2010,100405,CIN,SLN,CIN09,11,6,17
CIN201004070,2010,100407,CIN,SLN,CIN09,6,3,9
CIN201004080,2010,100408,CIN,SLN,CIN09,1,2,3
CIN201004090,2010,100409,CIN,CHN,CIN09,4,5,9
CIN201004100,2010,100410,CIN,CHN,CIN09,4,3,7
CIN201004110,2010,100411,CIN,CHN,CIN09,1,3,4
CIN201004200,2010,100420,CIN,LAN,CIN09,9,11,20
CIN201004210,2010,100421,CIN,LAN,CIN09,14,6,20
CIN201004220,2010,100422,CIN,LAN,CIN09,5,8,13
CIN201004230,2010,100423,CIN,SDN,CIN09,10,4,14
CIN201004240,2010,100424,CIN,SDN,CIN09,5,0,5
CIN201004250,2010,100425,CIN,SDN,CIN09,4,5,9
CIN201005030,2010,100503,CIN,NYN,CIN09,2,3,5
CIN201005040,2010,100504,CIN,NYN,CIN09,5,4,9
CIN201005050,2010,100505,CIN,NYN,CIN09,4,5,9
CIN201005070,2010,100507,CIN,CHN,CIN09,14,7,21
CIN201005080,2010,100508,CIN,CHN,CIN09,2,14,16
CIN201005090,2010,100509,CIN,CHN,CIN09,3,5,8
CIN201005140,2010,100514,CIN,SLN,CIN09,4,3,7
CIN201005150,2010,100515,CIN,SLN,CIN09,3,4,7
CIN201005160,2010,100516,CIN,SLN,CIN09,2,7,9
CIN201005170,2010,100517,CIN,MIL,CIN09,3,6,9
CIN201005180,2010,100518,CIN,MIL,CIN09,4,5,9
CIN201005240,2010,100524,CIN,PIT,CIN09,5,7,12
CIN201005250,2010,100525,CIN,PIT,CIN09,2,1,3
CIN201005260,2010,100526,CIN,PIT,CIN09,0,4,4
CIN201005270,2010,100527,CIN,PIT,CIN09,2,8,10
CIN201005280,2010,100528,CIN,HOU,CIN09,6,15,21
CIN201005290,2010,100529,CIN,HOU,CIN09,2,12,14
CIN201005300,2010,100530,CIN,HOU,CIN09,2,0,2
CIN201006070,2010,100607,CIN,SFN,CIN09,6,5,11
CIN201006080,2010,100608,CIN,SFN,CIN09,3,0,3
CIN201006090,2010,100609,CIN,SFN,CIN09,3,6,9
CIN201006100,2010,100610,CIN,SFN,CIN09,6,7,13
CIN201006110,2010,100611,CIN,KCA,CIN09,6,5,11
CIN201006120,2010,100612,CIN,KCA,CIN09,5,11,16
CIN201006130,2010,100613,CIN,KCA,CIN09,7,3,10
CIN201006150,2010,100615,CIN,LAN,CIN09,12,0,12
CIN201006160,2010,100616,CIN,LAN,CIN09,6,2,8
CIN201006170,2010,100617,CIN,LAN,CIN09,1,7,8
CIN201006250,2010,100625,CIN,CLE,CIN09,3,10,13
CIN201006260,2010,100626,CIN,CLE,CIN09,4,6,10
CIN201006270,2010,100627,CIN,CLE,CIN09,5,3,8
CIN201006280,2010,100628,CIN,PHI,CIN09,3,7,10
CIN201006290,2010,100629,CIN,PHI,CIN09,9,6,15
CIN201006300,2010,100630,CIN,PHI,CIN09,3,4,7
CIN201007160,2010,100716,CIN,COL,CIN09,2,3,5
CIN201007170,2010,100717,CIN,COL,CIN09,1,8,9
CIN201007180,2010,100718,CIN,COL,CIN09,1,0,1
CIN201007190,2010,100719,CIN,WAS,CIN09,2,7,9
CIN201007200,2010,100720,CIN,WAS,CIN09,7,8,15
CIN201007210,2010,100721,CIN,WAS,CIN09,8,5,13
CIN201007220,2010,100722,CIN,WAS,CIN09,7,1,8
CIN201007300,2010,100730,CIN,ATL,CIN09,6,4,10
CIN201007310,2010,100731,CIN,ATL,CIN09,2,5,7
CIN201008010,2010,100801,CIN,ATL,CIN09,1,2,3
CIN201008090,2010,100809,CIN,SLN,CIN09,7,3,10
CIN201008100,2010,100810,CIN,SLN,CIN09,8,4,12
CIN201008110,2010,100811,CIN,SLN,CIN09,6,1,7
CIN201008130,2010,100813,CIN,FLO,CIN09,2,7,9
CIN201008140,2010,100814,CIN,FLO,CIN09,4,5,9
CIN201008150,2010,100815,CIN,FLO,CIN09,0,2,2
CIN201008270,2010,100827,CIN,CHN,CIN09,1,7,8
CIN201008280,2010,100828,CIN,CHN,CIN09,3,2,5
CIN201008290,2010,100829,CIN,CHN,CIN09,5,7,12
CIN201008300,2010,100830,CIN,MIL,CIN09,4,5,9
CIN201008310,2010,100831,CIN,MIL,CIN09,4,8,12
CIN201009010,2010,100901,CIN,MIL,CIN09,1,6,7
CIN201009100,2010,100910,CIN,PIT,CIN09,3,4,7
CIN201009110,2010,100911,CIN,PIT,CIN09,4,5,9
CIN201009120,2010,100912,CIN,PIT,CIN09,3,1,4
CIN201009130,2010,100913,CIN,ARI,CIN09,2,7,9
CIN201009140,2010,100914,CIN,ARI,CIN09,3,1,4
CIN201009150,2010,100915,CIN,ARI,CIN09,5,7,12
CIN201009160,2010,100916,CIN,ARI,CIN09,3,1,4
CIN201009280,2010,100928,CIN,HOU,CIN09,2,3,5
CIN201009290,2010,100929,CIN,HOU,CIN09,2,0,2
CIN201009300,2010,100930,CIN,HOU,CIN09,1,9,10
CIN201010010,2010,101001,CIN,MIL,CIN09,4,3,7
CIN201010020,2010,101002,CIN,MIL,CIN09,4,7,11
CIN201010030,2010,101003,CIN,MIL,CIN09,2,3,5
CIN201010100,2010,101010,CIN,PHI,CIN09,2,0,2
CIN201103310,2011,20110331,CIN,MIL,CIN09,6,7,13
CIN201104020,2011,20110402,CIN,MIL,CIN09,2,4,6
CIN201104030,2011,20110403,CIN,MIL,CIN09,3,12,15
CIN201104050,2011,20110405,CIN,HOU,CIN09,2,8,10
CIN201104060,2011,20110406,CIN,HOU,CIN09,4,12,16
CIN201104070,2011,20110407,CIN,HOU,CIN09,3,2,5
CIN201104150,2011,20110415,CIN,PIT,CIN09,6,1,7
CIN201104160,2011,20110416,CIN,PIT,CIN09,2,11,13
CIN201104170,2011,20110417,CIN,PIT,CIN09,7,6,13
CIN201104180,2011,20110418,CIN,PIT,CIN09,9,3,12
CIN201104190,2011,20110419,CIN,ARI,CIN09,5,4,9
CIN201104200,2011,20110420,CIN,ARI,CIN09,3,1,4
CIN201104210,2011,20110421,CIN,ARI,CIN09,4,7,11
CIN201104290,2011,20110429,CIN,FLO,CIN09,7,6,13
CIN201104300,2011,20110430,CIN,FLO,CIN09,3,4,7
CIN201105010,2011,20110501,CIN,FLO,CIN09,9,5,14
CIN201105030,2011,20110503,CIN,HOU,CIN09,10,4,14
CIN201105040,2011,20110504,CIN,HOU,CIN09,2,3,5
CIN201105050,2011,20110505,CIN,HOU,CIN09,4,10,14
CIN201105130,2011,20110513,CIN,SLN,CIN09,5,6,11
CIN201105140,2011,20110514,CIN,SLN,CIN09,3,7,10
CIN201105150,2011,20110515,CIN,SLN,CIN09,7,9,16
CIN201105160,2011,20110516,CIN,CHN,CIN09,4,7,11
CIN201105170,2011,20110517,CIN,CHN,CIN09,5,7,12
CIN201105180,2011,20110518,CIN,PIT,CIN09,5,0,5
CIN201105190,2011,20110519,CIN,PIT,CIN09,5,3,8
CIN201105300,2011,20110530,CIN,MIL,CIN09,3,7,10
CIN201105310,2011,20110531,CIN,MIL,CIN09,7,2,9
CIN201106010,2011,20110601,CIN,MIL,CIN09,3,4,7
CIN201106030,2011,20110603,CIN,LAN,CIN09,1,2,3
CIN201106040,2011,20110604,CIN,LAN,CIN09,11,8,19
CIN201106050,2011,20110605,CIN,LAN,CIN09,9,6,15
CIN201106060,2011,20110606,CIN,CHN,CIN09,2,8,10
CIN201106070,2011,20110607,CIN,CHN,CIN09,2,8,10
CIN201106080,2011,20110608,CIN,CHN,CIN09,4,1,5
CIN201106170,2011,20110617,CIN,TOR,CIN09,3,2,5
CIN201106180,2011,20110618,CIN,TOR,CIN09,4,0,4
CIN201106190,2011,20110619,CIN,TOR,CIN09,1,2,3
CIN201106200,2011,20110620,CIN,NYA,CIN09,5,3,8
CIN201106221,2011,20110622,CIN,NYA,CIN09,4,2,6
CIN201106222,2011,20110622,CIN,NYA,CIN09,2,10,12
CIN201107010,2011,20110701,CIN,CLE,CIN09,8,2,10
CIN201107020,2011,20110702,CIN,CLE,CIN09,3,1,4
CIN201107030,2011,20110703,CIN,CLE,CIN09,5,7,12
CIN201107150,2011,20110715,CIN,SLN,CIN09,5,6,11
CIN201107160,2011,20110716,CIN,SLN,CIN09,4,1,5
CIN201107170,2011,20110717,CIN,SLN,CIN09,1,3,4
CIN201107220,2011,20110722,CIN,ATL,CIN09,6,4,10
CIN201107230,2011,20110723,CIN,ATL,CIN09,2,11,13
CIN201107240,2011,20110724,CIN,ATL,CIN09,3,4,7
CIN201107250,2011,20110725,CIN,NYN,CIN09,4,2,6
CIN201107260,2011,20110726,CIN,NYN,CIN09,8,6,14
CIN201107270,2011,20110727,CIN,NYN,CIN09,8,2,10
CIN201107280,2011,20110728,CIN,NYN,CIN09,10,9,19
CIN201107290,2011,20110729,CIN,SFN,CIN09,3,4,7
CIN201107300,2011,20110730,CIN,SFN,CIN09,2,7,9
CIN201107310,2011,20110731,CIN,SFN,CIN09,0,9,9
CIN201108080,2011,20110808,CIN,COL,CIN09,10,7,17
CIN201108090,2011,20110809,CIN,COL,CIN09,3,2,5
CIN201108100,2011,20110810,CIN,COL,CIN09,2,3,5
CIN201108110,2011,20110811,CIN,COL,CIN09,1,2,3
CIN201108120,2011,20110812,CIN,SDN,CIN09,3,5,8
CIN201108130,2011,20110813,CIN,SDN,CIN09,1,13,14
CIN201108140,2011,20110814,CIN,SDN,CIN09,7,3,10
CIN201108260,2011,20110826,CIN,WAS,CIN09,3,4,7
CIN201108270,2011,20110827,CIN,WAS,CIN09,3,6,9
CIN201108280,2011,20110828,CIN,WAS,CIN09,4,5,9
CIN201108290,2011,20110829,CIN,PHI,CIN09,3,2,5
CIN201108300,2011,20110830,CIN,PHI,CIN09,9,0,9
CIN201108310,2011,20110831,CIN,PHI,CIN09,3,0,3
CIN201109010,2011,20110901,CIN,PHI,CIN09,6,4,10
CIN201109120,2011,20110912,CIN,CHN,CIN09,12,8,20
CIN201109130,2011,20110913,CIN,CHN,CIN09,1,2,3
CIN201109140,2011,20110914,CIN,CHN,CIN09,2,7,9
CIN201109150,2011,20110915,CIN,CHN,CIN09,6,8,14
CIN201109160,2011,20110916,CIN,MIL,CIN09,6,3,9
CIN201109170,2011,20110917,CIN,MIL,CIN09,10,1,11
CIN201109180,2011,20110918,CIN,MIL,CIN09,8,1,9
CIN201109190,2011,20110919,CIN,HOU,CIN09,3,2,5
CIN201109200,2011,20110920,CIN,HOU,CIN09,4,6,10
CIN201109210,2011,20110921,CIN,HOU,CIN09,0,2,2
CIN201204050,2012,120405,CIN,MIA,CIN09,0,4,4
CIN201204070,2012,120407,CIN,MIA,CIN09,8,3,11
CIN201204080,2012,120408,CIN,MIA,CIN09,5,6,11
CIN201204090,2012,120409,CIN,SLN,CIN09,7,1,8
CIN201204100,2012,120410,CIN,SLN,CIN09,3,1,4
CIN201204110,2012,120411,CIN,SLN,CIN09,3,4,7
CIN201204240,2012,120424,CIN,SFN,CIN09,2,9,11
CIN201204250,2012,120425,CIN,SFN,CIN09,2,4,6
CIN201204260,2012,120426,CIN,SFN,CIN09,6,5,11
CIN201204270,2012,120427,CIN,HOU,CIN09,6,4,10
CIN201204280,2012,120428,CIN,HOU,CIN09,0,6,6
CIN201204290,2012,120429,CIN,HOU,CIN09,5,6,11
CIN201205020,2012,120502,CIN,CHN,CIN09,3,1,4
CIN201205030,2012,120503,CIN,CHN,CIN09,3,4,7
CIN201205110,2012,120511,CIN,WAS,CIN09,7,3,10
CIN201205120,2012,120512,CIN,WAS,CIN09,2,1,3
CIN201205130,2012,120513,CIN,WAS,CIN09,6,9,15
CIN201205210,2012,120521,CIN,ATL,CIN09,1,4,5
CIN201205220,2012,120522,CIN,ATL,CIN09,3,4,7
CIN201205230,2012,120523,CIN,ATL,CIN09,1,2,3
CIN201205240,2012,120524,CIN,ATL,CIN09,3,6,9
CIN201205250,2012,120525,CIN,COL,CIN09,6,3,9
CIN201205260,2012,120526,CIN,COL,CIN09,3,10,13
CIN201205270,2012,120527,CIN,COL,CIN09,5,7,12
CIN201206050,2012,120605,CIN,PIT,CIN09,8,4,12
CIN201206060,2012,120606,CIN,PIT,CIN09,4,5,9
CIN201206070,2012,120607,CIN,PIT,CIN09,5,4,9
CIN201206080,2012,120608,CIN,DET,CIN09,5,6,11
CIN201206090,2012,120609,CIN,DET,CIN09,3,2,5
CIN201206100,2012,120610,CIN,DET,CIN09,7,6,13
CIN201206120,2012,120612,CIN,CLE,CIN09,1,7,8
CIN201206130,2012,120613,CIN,CLE,CIN09,3,5,8
CIN201206140,2012,120614,CIN,CLE,CIN09,5,12,17
CIN201206220,2012,120622,CIN,MIN,CIN09,5,4,9
CIN201206230,2012,120623,CIN,MIN,CIN09,0,6,6
CIN201206240,2012,120624,CIN,MIN,CIN09,4,3,7
CIN201206250,2012,120625,CIN,MIL,CIN09,1,3,4
CIN201206260,2012,120626,CIN,MIL,CIN09,3,4,7
CIN201206270,2012,120627,CIN,MIL,CIN09,8,4,12
CIN201207130,2012,120713,CIN,SLN,CIN09,3,5,8
CIN201207140,2012,120714,CIN,SLN,CIN09,2,3,5
CIN201207150,2012,120715,CIN,SLN,CIN09,2,4,6
CIN201207160,2012,120716,CIN,ARI,CIN09,5,3,8
CIN201207170,2012,120717,CIN,ARI,CIN09,0,4,4
CIN201207180,2012,120718,CIN,ARI,CIN09,7,1,8
CIN201207190,2012,120719,CIN,ARI,CIN09,6,7,13
CIN201207200,2012,120720,CIN,MIL,CIN09,1,3,4
CIN201207210,2012,120721,CIN,MIL,CIN09,2,6,8
CIN201207220,2012,120722,CIN,MIL,CIN09,1,2,3
CIN201207300,2012,120730,CIN,SDN,CIN09,11,5,16
CIN201207310,2012,120731,CIN,SDN,CIN09,6,7,13
CIN201208010,2012,120801,CIN,SDN,CIN09,4,6,10
CIN201208020,2012,120802,CIN,SDN,CIN09,4,9,13
CIN201208030,2012,120803,CIN,PIT,CIN09,0,3,3
CIN201208040,2012,120804,CIN,PIT,CIN09,4,5,9
CIN201208050,2012,120805,CIN,PIT,CIN09,6,2,8
CIN201208140,2012,120814,CIN,NYN,CIN09,0,3,3
CIN201208150,2012,120815,CIN,NYN,CIN09,1,6,7
CIN201208160,2012,120816,CIN,NYN,CIN09,8,4,12
CIN201208170,2012,120817,CIN,CHN,CIN09,3,7,10
CIN201208181,2012,120818,CIN,CHN,CIN09,3,5,8
CIN201208182,2012,120818,CIN,CHN,CIN09,9,7,16
CIN201208190,2012,120819,CIN,CHN,CIN09,4,5,9
CIN201208240,2012,120824,CIN,SLN,CIN09,8,5,13
CIN201208250,2012,120825,CIN,SLN,CIN09,2,8,10
CIN201208260,2012,120826,CIN,SLN,CIN09,8,2,10
CIN201209030,2012,120903,CIN,PHI,CIN09,4,2,6
CIN201209040,2012,120904,CIN,PHI,CIN09,1,2,3
CIN201209050,2012,120905,CIN,PHI,CIN09,6,2,8
CIN201209070,2012,120907,CIN,HOU,CIN09,5,3,8
CIN201209080,2012,120908,CIN,HOU,CIN09,1,5,6
CIN201209090,2012,120909,CIN,HOU,CIN09,5,1,6
CIN201209100,2012,120910,CIN,PIT,CIN09,3,4,7
CIN201209110,2012,120911,CIN,PIT,CIN09,3,5,8
CIN201209120,2012,120912,CIN,PIT,CIN09,1,2,3
CIN201209210,2012,120921,CIN,LAN,CIN09,3,1,4
CIN201209220,2012,120922,CIN,LAN,CIN09,0,6,6
CIN201209230,2012,120923,CIN,LAN,CIN09,5,3,8
CIN201209250,2012,120925,CIN,MIL,CIN09,2,4,6
CIN201209260,2012,120926,CIN,MIL,CIN09,8,1,9
CIN201209270,2012,120927,CIN,MIL,CIN09,1,2,3
CIN201210090,2012,121009,CIN,SFN,CIN09,2,1,3
CIN201210100,2012,121010,CIN,SFN,CIN09,8,3,11
CIN201210110,2012,121011,CIN,SFN,CIN09,6,4,10
CIN201304010,2013,20130401,CIN,ANA,CIN09,3,1,4
CIN201304030,2013,20130403,CIN,ANA,CIN09,4,5,9
CIN201304040,2013,20130404,CIN,ANA,CIN09,4,5,9
CIN201304050,2013,20130405,CIN,WAS,CIN09,0,15,15
CIN201304060,2013,20130406,CIN,WAS,CIN09,7,6,13
CIN201304070,2013,20130407,CIN,WAS,CIN09,3,6,9
CIN201304150,2013,20130415,CIN,PHI,CIN09,2,4,6
CIN201304160,2013,20130416,CIN,PHI,CIN09,0,1,1
CIN201304170,2013,20130417,CIN,PHI,CIN09,2,11,13
CIN201304180,2013,20130418,CIN,MIA,CIN09,1,11,12
CIN201304190,2013,20130419,CIN,MIA,CIN09,2,1,3
CIN201304200,2013,20130420,CIN,MIA,CIN09,2,3,5
CIN201304210,2013,20130421,CIN,MIA,CIN09,6,10,16
CIN201304220,2013,20130422,CIN,CHN,CIN09,4,5,9
CIN201304230,2013,20130423,CIN,CHN,CIN09,4,2,6
CIN201304240,2013,20130424,CIN,CHN,CIN09,0,1,1
CIN201305060,2013,20130506,CIN,ATL,CIN09,7,4,11
CIN201305070,2013,20130507,CIN,ATL,CIN09,4,5,9
CIN201305080,2013,20130508,CIN,ATL,CIN09,7,2,9
CIN201305100,2013,20130510,CIN,MIL,CIN09,3,4,7
CIN201305110,2013,20130511,CIN,MIL,CIN09,7,13,20
CIN201305120,2013,20130512,CIN,MIL,CIN09,1,5,6
CIN201305240,2013,20130524,CIN,CHN,CIN09,4,7,11
CIN201305250,2013,20130525,CIN,CHN,CIN09,2,5,7
CIN201305260,2013,20130526,CIN,CHN,CIN09,5,4,9
CIN201305270,2013,20130527,CIN,CLE,CIN09,2,4,6
CIN201305280,2013,20130528,CIN,CLE,CIN09,2,8,10
CIN201306030,2013,20130603,CIN,COL,CIN09,0,3,3
CIN201306040,2013,20130604,CIN,COL,CIN09,5,4,9
CIN201306050,2013,20130605,CIN,COL,CIN09,12,4,16
CIN201306070,2013,20130607,CIN,SLN,CIN09,9,2,11
CIN201306080,2013,20130608,CIN,SLN,CIN09,2,4,6
CIN201306090,2013,20130609,CIN,SLN,CIN09,11,4,15
CIN201306140,2013,20130614,CIN,MIL,CIN09,3,4,7
CIN201306150,2013,20130615,CIN,MIL,CIN09,6,0,6
CIN201306160,2013,20130616,CIN,MIL,CIN09,1,5,6
CIN201306170,2013,20130617,CIN,PIT,CIN09,1,4,5
CIN201306180,2013,20130618,CIN,PIT,CIN09,4,0,4
CIN201306190,2013,20130619,CIN,PIT,CIN09,1,2,3
CIN201306200,2013,20130620,CIN,PIT,CIN09,5,3,8
CIN201307010,2013,20130701,CIN,SFN,CIN09,1,8,9
CIN201307020,2013,20130702,CIN,SFN,CIN09,0,3,3
CIN201307030,2013,20130703,CIN,SFN,CIN09,2,3,5
CIN201307050,2013,20130705,CIN,SEA,CIN09,4,2,6
CIN201307060,2013,20130706,CIN,SEA,CIN09,4,13,17
CIN201307070,2013,20130707,CIN,SEA,CIN09,3,1,4
CIN201307190,2013,20130719,CIN,PIT,CIN09,3,5,8
CIN201307200,2013,20130720,CIN,PIT,CIN09,4,5,9
CIN201307210,2013,20130721,CIN,PIT,CIN09,3,2,5
CIN201307232,2013,20130723,CIN,SFN,SFO03,5,3,8
CIN201308020,2013,20130802,CIN,SLN,CIN09,13,3,16
CIN201308030,2013,20130803,CIN,SLN,CIN09,3,8,11
CIN201308040,2013,20130804,CIN,SLN,CIN09,15,2,17
CIN201308060,2013,20130806,CIN,OAK,CIN09,1,3,4
CIN201308070,2013,20130807,CIN,OAK,CIN09,5,6,11
CIN201308090,2013,20130809,CIN,SDN,CIN09,2,7,9
CIN201308100,2013,20130810,CIN,SDN,CIN09,3,1,4
CIN201308110,2013,20130811,CIN,SDN,CIN09,2,3,5
CIN201308190,2013,20130819,CIN,ARI,CIN09,3,5,8
CIN201308200,2013,20130820,CIN,ARI,CIN09,5,2,7
CIN201308210,2013,20130821,CIN,ARI,CIN09,7,10,17
CIN201308220,2013,20130822,CIN,ARI,CIN09,1,2,3
CIN201308230,2013,20130823,CIN,MIL,CIN09,6,4,10
CIN201308240,2013,20130824,CIN,MIL,CIN09,3,6,9
CIN201308250,2013,20130825,CIN,MIL,CIN09,3,1,4
CIN201309020,2013,20130902,CIN,SLN,CIN09,2,7,9
CIN201309030,2013,20130903,CIN,SLN,CIN09,0,1,1
CIN201309040,2013,20130904,CIN,SLN,CIN09,5,4,9
CIN201309050,2013,20130905,CIN,SLN,CIN09,2,6,8
CIN201309060,2013,20130906,CIN,LAN,CIN09,2,3,5
CIN201309070,2013,20130907,CIN,LAN,CIN09,3,4,7
CIN201309080,2013,20130908,CIN,LAN,CIN09,2,3,5
CIN201309090,2013,20130909,CIN,CHN,CIN09,2,0,2
CIN201309100,2013,20130910,CIN,CHN,CIN09,9,1,10
CIN201309110,2013,20130911,CIN,CHN,CIN09,0,6,6
CIN201309230,2013,20130923,CIN,NYN,CIN09,2,3,5
CIN201309240,2013,20130924,CIN,NYN,CIN09,4,2,6
CIN201309250,2013,20130925,CIN,NYN,CIN09,1,0,1
CIN201309270,2013,20130927,CIN,PIT,CIN09,4,1,5
CIN201309280,2013,20130928,CIN,PIT,CIN09,8,3,11
CIN201309290,2013,20130929,CIN,PIT,CIN09,4,2,6
CLE201004120,2010,100412,CLE,TEX,CLE08,4,2,6
CLE201004140,2010,100414,CLE,TEX,CLE08,6,2,8
CLE201004150,2010,100415,CLE,TEX,CLE08,2,3,5
CLE201004160,2010,100416,CLE,CHA,CLE08,2,6,8
CLE201004170,2010,100417,CLE,CHA,CLE08,2,3,5
CLE201004180,2010,100418,CLE,CHA,CLE08,4,7,11
CLE201004300,2010,100430,CLE,MIN,CLE08,9,3,12
CLE201005010,2010,100501,CLE,MIN,CLE08,4,5,9
CLE201005020,2010,100502,CLE,MIN,CLE08,8,3,11
CLE201005030,2010,100503,CLE,TOR,CLE08,5,1,6
CLE201005040,2010,100504,CLE,TOR,CLE08,8,5,13
CLE201005050,2010,100505,CLE,TOR,CLE08,5,4,9
CLE201005080,2010,100508,CLE,DET,CLE08,6,4,10
CLE201005090,2010,100509,CLE,DET,CLE08,4,7,11
CLE201005190,2010,100519,CLE,KCA,CLE08,8,4,12
CLE201005200,2010,100520,CLE,KCA,CLE08,9,3,12
CLE201005210,2010,100521,CLE,CIN,CLE08,7,4,11
CLE201005220,2010,100522,CLE,CIN,CLE08,6,4,10
CLE201005230,2010,100523,CLE,CIN,CLE08,3,4,7
CLE201005240,2010,100524,CLE,CHA,CLE08,7,2,9
CLE201005250,2010,100525,CLE,CHA,CLE08,3,7,10
CLE201005260,2010,100526,CLE,CHA,CLE08,5,4,9
CLE201006070,2010,100607,CLE,BOS,CLE08,4,1,5
CLE201006080,2010,100608,CLE,BOS,CLE08,3,2,5
CLE201006090,2010,100609,CLE,BOS,CLE08,0,11,11
CLE201006100,2010,100610,CLE,BOS,CLE08,7,8,15
CLE201006110,2010,100611,CLE,WAS,CLE08,2,7,9
CLE201006120,2010,100612,CLE,WAS,CLE08,1,7,8
CLE201006130,2010,100613,CLE,WAS,CLE08,9,4,13
CLE201006150,2010,100615,CLE,NYN,CLE08,7,6,13
CLE201006160,2010,100616,CLE,NYN,CLE08,8,4,12
CLE201006170,2010,100617,CLE,NYN,CLE08,6,4,10
CLE201006280,2010,100628,CLE,TOR,CLE08,1,2,3
CLE201006290,2010,100629,CLE,TOR,CLE08,4,5,9
CLE201006300,2010,100630,CLE,TOR,CLE08,1,3,4
CLE201007010,2010,100701,CLE,TOR,CLE08,1,6,7
CLE201007020,2010,100702,CLE,OAK,CLE08,3,0,3
CLE201007030,2010,100703,CLE,OAK,CLE08,4,5,9
CLE201007040,2010,100704,CLE,OAK,CLE08,3,1,4
CLE201007160,2010,100716,CLE,DET,CLE08,2,8,10
CLE201007171,2010,100717,CLE,DET,CLE08,3,4,7
CLE201007172,2010,100717,CLE,DET,CLE08,1,2,3
CLE201007180,2010,100718,CLE,DET,CLE08,2,7,9
CLE201007230,2010,100723,CLE,TBA,CLE08,1,3,4
CLE201007240,2010,100724,CLE,TBA,CLE08,6,3,9
CLE201007250,2010,100725,CLE,TBA,CLE08,4,2,6
CLE201007260,2010,100726,CLE,NYA,CLE08,3,2,5
CLE201007270,2010,100727,CLE,NYA,CLE08,1,4,5
CLE201007280,2010,100728,CLE,NYA,CLE08,8,0,8
CLE201007290,2010,100729,CLE,NYA,CLE08,11,4,15
CLE201008060,2010,100806,CLE,MIN,CLE08,6,7,13
CLE201008070,2010,100807,CLE,MIN,CLE08,7,2,9
CLE201008080,2010,100808,CLE,MIN,CLE08,5,4,9
CLE201008100,2010,100810,CLE,BAL,CLE08,14,8,22
CLE201008110,2010,100811,CLE,BAL,CLE08,3,1,4
CLE201008120,2010,100812,CLE,BAL,CLE08,1,4,5
CLE201008130,2010,100813,CLE,SEA,CLE08,3,2,5
CLE201008140,2010,100814,CLE,SEA,CLE08,9,3,12
CLE201008150,2010,100815,CLE,SEA,CLE08,1,9,10
CLE201008240,2010,100824,CLE,OAK,CLE08,5,0,5
CLE201008250,2010,100825,CLE,OAK,CLE08,6,1,7
CLE201008260,2010,100826,CLE,OAK,CLE08,2,3,5
CLE201008270,2010,100827,CLE,KCA,CLE08,4,15,19
CLE201008280,2010,100828,CLE,KCA,CLE08,3,4,7
CLE201008290,2010,100829,CLE,KCA,CLE08,6,2,8
CLE201008300,2010,100830,CLE,CHA,CLE08,10,6,16
CLE201008310,2010,100831,CLE,CHA,CLE08,4,3,7
CLE201009010,2010,100901,CLE,CHA,CLE08,6,4,10
CLE201009100,2010,100910,CLE,MIN,CLE08,0,2,2
CLE201009110,2010,100911,CLE,MIN,CLE08,1,0,1
CLE201009120,2010,100912,CLE,MIN,CLE08,6,2,8
CLE201009140,2010,100914,CLE,ANA,CLE08,3,4,7
CLE201009150,2010,100915,CLE,ANA,CLE08,7,0,7
CLE201009160,2010,100916,CLE,ANA,CLE08,2,3,5
CLE201009230,2010,100923,CLE,KCA,CLE08,4,2,6
CLE201009240,2010,100924,CLE,KCA,CLE08,3,7,10
CLE201009250,2010,100925,CLE,KCA,CLE08,1,7,8
CLE201009260,2010,100926,CLE,KCA,CLE08,3,5,8
CLE201009270,2010,100927,CLE,DET,CLE08,3,6,9
CLE201009291,2010,100929,CLE,DET,CLE08,0,4,4
CLE201009292,2010,100929,CLE,DET,CLE08,3,4,7
CLE201104010,2011,20110401,CLE,CHA,CLE08,15,10,25
CLE201104020,2011,20110402,CLE,CHA,CLE08,8,3,11
CLE201104030,2011,20110403,CLE,CHA,CLE08,1,7,8
CLE201104050,2011,20110405,CLE,BOS,CLE08,1,3,4
CLE201104060,2011,20110406,CLE,BOS,CLE08,4,8,12
CLE201104070,2011,20110407,CLE,BOS,CLE08,0,1,1
CLE201104150,2011,20110415,CLE,BAL,CLE08,2,8,10
CLE201104160,2011,20110416,CLE,BAL,CLE08,3,8,11
CLE201104170,2011,20110417,CLE,BAL,CLE08,2,4,6
CLE201104260,2011,20110426,CLE,KCA,CLE08,4,9,13
CLE201104270,2011,20110427,CLE,KCA,CLE08,2,7,9
CLE201104280,2011,20110428,CLE,KCA,CLE08,2,8,10
CLE201104290,2011,20110429,CLE,DET,CLE08,5,9,14
CLE201104300,2011,20110430,CLE,DET,CLE08,2,3,5
CLE201105010,2011,20110501,CLE,DET,CLE08,4,5,9
CLE201105100,2011,20110510,CLE,TBA,CLE08,4,5,9
CLE201105110,2011,20110511,CLE,TBA,CLE08,8,2,10
CLE201105120,2011,20110512,CLE,TBA,CLE08,7,4,11
CLE201105130,2011,20110513,CLE,SEA,CLE08,4,5,9
CLE201105200,2011,20110520,CLE,CIN,CLE08,4,5,9
CLE201105210,2011,20110521,CLE,CIN,CLE08,1,2,3
CLE201105220,2011,20110522,CLE,CIN,CLE08,4,12,16
CLE201105230,2011,20110523,CLE,BOS,CLE08,2,3,5
CLE201105240,2011,20110524,CLE,BOS,CLE08,4,2,6
CLE201105250,2011,20110525,CLE,BOS,CLE08,14,2,16
CLE201106020,2011,20110602,CLE,TEX,CLE08,7,4,11
CLE201106030,2011,20110603,CLE,TEX,CLE08,11,2,13
CLE201106040,2011,20110604,CLE,TEX,CLE08,4,0,4
CLE201106050,2011,20110605,CLE,TEX,CLE08,2,0,2
CLE201106060,2011,20110606,CLE,MIN,CLE08,6,4,10
CLE201106070,2011,20110607,CLE,MIN,CLE08,0,1,1
CLE201106080,2011,20110608,CLE,MIN,CLE08,3,2,5
CLE201106170,2011,20110617,CLE,PIT,CLE08,1,5,6
CLE201106180,2011,20110618,CLE,PIT,CLE08,1,5,6
CLE201106190,2011,20110619,CLE,PIT,CLE08,2,5,7
CLE201106200,2011,20110620,CLE,COL,CLE08,8,7,15
CLE201106210,2011,20110621,CLE,COL,CLE08,4,3,7
CLE201106220,2011,20110622,CLE,COL,CLE08,3,4,7
CLE201107040,2011,20110704,CLE,NYA,CLE08,3,6,9
CLE201107050,2011,20110705,CLE,NYA,CLE08,9,2,11
CLE201107060,2011,20110706,CLE,NYA,CLE08,3,5,8
CLE201107070,2011,20110707,CLE,TOR,CLE08,4,5,9
CLE201107080,2011,20110708,CLE,TOR,CLE08,11,7,18
CLE201107090,2011,20110709,CLE,TOR,CLE08,5,4,9
CLE201107100,2011,20110710,CLE,TOR,CLE08,7,1,8
CLE201107220,2011,20110722,CLE,CHA,CLE08,3,0,3
CLE201107240,2011,20110724,CLE,CHA,CLE08,4,2,6
CLE201107250,2011,20110725,CLE,ANA,CLE08,2,3,5
CLE201107260,2011,20110726,CLE,ANA,CLE08,2,1,3
CLE201107270,2011,20110727,CLE,ANA,CLE08,3,1,4
CLE201107290,2011,20110729,CLE,KCA,CLE08,12,0,12
CLE201107300,2011,20110730,CLE,KCA,CLE08,2,5,7
CLE201107310,2011,20110731,CLE,KCA,CLE08,5,3,8
CLE201108090,2011,20110809,CLE,DET,CLE08,2,3,5
CLE201108100,2011,20110810,CLE,DET,CLE08,3,10,13
CLE201108110,2011,20110811,CLE,DET,CLE08,4,3,7
CLE201108120,2011,20110812,CLE,MIN,CLE08,2,3,5
CLE201108130,2011,20110813,CLE,MIN,CLE08,1,3,4
CLE201108220,2011,20110822,CLE,SEA,CLE08,3,2,5
CLE201108231,2011,20110823,CLE,SEA,CLE08,5,7,12
CLE201108232,2011,20110823,CLE,SEA,CLE08,12,7,19
CLE201108240,2011,20110824,CLE,SEA,CLE08,9,2,11
CLE201108260,2011,20110826,CLE,KCA,CLE08,1,2,3
CLE201108270,2011,20110827,CLE,KCA,CLE08,7,8,15
CLE201108280,2011,20110828,CLE,KCA,CLE08,2,1,3
CLE201108290,2011,20110829,CLE,OAK,CLE08,1,2,3
CLE201108300,2011,20110830,CLE,OAK,CLE08,2,6,8
CLE201108310,2011,20110831,CLE,OAK,CLE08,3,4,7
CLE201109010,2011,20110901,CLE,OAK,CLE08,7,0,7
CLE201109050,2011,20110905,CLE,DET,CLE08,4,2,6
CLE201109060,2011,20110906,CLE,DET,CLE08,10,1,11
CLE201109070,2011,20110907,CLE,DET,CLE08,8,6,14
CLE201109190,2011,20110919,CLE,SEA,CLE08,12,6,18
CLE201109201,2011,20110920,CLE,CHA,CLE08,3,4,7
CLE201109202,2011,20110920,CLE,CHA,CLE08,5,4,9
CLE201109210,2011,20110921,CLE,CHA,CLE08,8,4,12
CLE201109220,2011,20110922,CLE,CHA,CLE08,2,11,13
CLE201109230,2011,20110923,CLE,MIN,CLE08,5,6,11
CLE201109241,2011,20110924,CLE,MIN,CLE08,2,8,10
CLE201109242,2011,20110924,CLE,MIN,CLE08,6,7,13
CLE201109250,2011,20110925,CLE,MIN,CLE08,6,4,10
CLE201204050,2012,120405,CLE,TOR,CLE08,7,4,11
CLE201204070,2012,120407,CLE,TOR,CLE08,7,4,11
CLE201204080,2012,120408,CLE,TOR,CLE08,3,4,7
CLE201204090,2012,120409,CLE,CHA,CLE08,4,2,6
CLE201204110,2012,120411,CLE,CHA,CLE08,10,6,16
CLE201204240,2012,120424,CLE,KCA,CLE08,3,4,7
CLE201204250,2012,120425,CLE,KCA,CLE08,8,2,10
CLE201204260,2012,120426,CLE,KCA,CLE08,4,2,6
CLE201204270,2012,120427,CLE,ANA,CLE08,2,3,5
CLE201204280,2012,120428,CLE,ANA,CLE08,2,1,3
CLE201204290,2012,120429,CLE,ANA,CLE08,0,4,4
CLE201205040,2012,120504,CLE,TEX,CLE08,3,6,9
CLE201205050,2012,120505,CLE,TEX,CLE08,5,2,7
CLE201205060,2012,120506,CLE,TEX,CLE08,2,4,6
CLE201205071,2012,120507,CLE,CHA,CLE08,6,8,14
CLE201205072,2012,120507,CLE,CHA,CLE08,2,3,5
CLE201205080,2012,120508,CLE,CHA,CLE08,5,3,8
CLE201205090,2012,120509,CLE,CHA,CLE08,8,1,9
CLE201205160,2012,120516,CLE,SEA,CLE08,3,9,12
CLE201205170,2012,120517,CLE,SEA,CLE08,5,6,11
CLE201205180,2012,120518,CLE,MIA,CLE08,3,2,5
CLE201205190,2012,120519,CLE,MIA,CLE08,0,2,2
CLE201205200,2012,120520,CLE,MIA,CLE08,5,3,8
CLE201205220,2012,120522,CLE,DET,CLE08,3,5,8
CLE201205230,2012,120523,CLE,DET,CLE08,2,4,6
CLE201205240,2012,120524,CLE,DET,CLE08,1,2,3
CLE201205280,2012,120528,CLE,KCA,CLE08,5,8,13
CLE201205290,2012,120529,CLE,KCA,CLE08,8,2,10
CLE201205300,2012,120530,CLE,KCA,CLE08,6,3,9
CLE201206010,2012,120601,CLE,MIN,CLE08,1,7,8
CLE201206020,2012,120602,CLE,MIN,CLE08,7,4,11
CLE201206030,2012,120603,CLE,MIN,CLE08,6,3,9
CLE201206150,2012,120615,CLE,PIT,CLE08,0,2,2
CLE201206160,2012,120616,CLE,PIT,CLE08,9,2,11
CLE201206170,2012,120617,CLE,PIT,CLE08,9,5,14
CLE201206180,2012,120618,CLE,CIN,CLE08,9,10,19
CLE201206190,2012,120619,CLE,CIN,CLE08,2,3,5
CLE201206200,2012,120620,CLE,CIN,CLE08,1,8,9
CLE201207020,2012,120702,CLE,ANA,CLE08,3,0,3
CLE201207030,2012,120703,CLE,ANA,CLE08,5,9,14
CLE201207040,2012,120704,CLE,ANA,CLE08,3,12,15
CLE201207050,2012,120705,CLE,TBA,CLE08,1,3,4
CLE201207060,2012,120706,CLE,TBA,CLE08,10,3,13
CLE201207070,2012,120707,CLE,TBA,CLE08,3,7,10
CLE201207080,2012,120708,CLE,TBA,CLE08,7,6,13
CLE201207200,2012,120720,CLE,BAL,CLE08,10,2,12
CLE201207210,2012,120721,CLE,BAL,CLE08,3,1,4
CLE201207220,2012,120722,CLE,BAL,CLE08,4,3,7
CLE201207230,2012,120723,CLE,BAL,CLE08,1,3,4
CLE201207240,2012,120724,CLE,DET,CLE08,2,3,5
CLE201207250,2012,120725,CLE,DET,CLE08,5,3,8
CLE201207260,2012,120726,CLE,DET,CLE08,3,5,8
CLE201208060,2012,120806,CLE,MIN,CLE08,14,3,17
CLE201208070,2012,120807,CLE,MIN,CLE08,7,5,12
CLE201208080,2012,120808,CLE,MIN,CLE08,2,6,8
CLE201208090,2012,120809,CLE,BOS,CLE08,3,5,8
CLE201208100,2012,120810,CLE,BOS,CLE08,3,2,5
CLE201208110,2012,120811,CLE,BOS,CLE08,2,5,7
CLE201208120,2012,120812,CLE,BOS,CLE08,14,1,15
CLE201208240,2012,120824,CLE,NYA,CLE08,3,1,4
CLE201208250,2012,120825,CLE,NYA,CLE08,1,3,4
CLE201208260,2012,120826,CLE,NYA,CLE08,4,2,6
CLE201208270,2012,120827,CLE,OAK,CLE08,3,0,3
CLE201208280,2012,120828,CLE,OAK,CLE08,7,0,7
CLE201208290,2012,120829,CLE,OAK,CLE08,8,4,12
CLE201208300,2012,120830,CLE,OAK,CLE08,12,7,19
CLE201208310,2012,120831,CLE,TEX,CLE08,5,3,8
CLE201209010,2012,120901,CLE,TEX,CLE08,3,4,7
CLE201209020,2012,120902,CLE,TEX,CLE08,8,3,11
CLE201209140,2012,120914,CLE,DET,CLE08,4,0,4
CLE201209150,2012,120915,CLE,DET,CLE08,5,3,8
CLE201209160,2012,120916,CLE,DET,CLE08,6,7,13
CLE201209180,2012,120918,CLE,MIN,CLE08,6,5,11
CLE201209190,2012,120919,CLE,MIN,CLE08,6,4,10
CLE201209200,2012,120920,CLE,MIN,CLE08,3,4,7
CLE201209280,2012,120928,CLE,KCA,CLE08,5,8,13
CLE201209290,2012,120929,CLE,KCA,CLE08,7,6,13
CLE201209300,2012,120930,CLE,KCA,CLE08,3,15,18
CLE201210010,2012,121001,CLE,CHA,CLE08,11,0,11
CLE201210020,2012,121002,CLE,CHA,CLE08,3,4,7
CLE201210030,2012,121003,CLE,CHA,CLE08,9,0,9
CLE201304080,2013,20130408,CLE,NYA,CLE08,11,6,17
CLE201304090,2013,20130409,CLE,NYA,CLE08,14,1,15
CLE201304120,2013,20130412,CLE,CHA,CLE08,0,1,1
CLE201304130,2013,20130413,CLE,CHA,CLE08,4,9,13
CLE201304140,2013,20130414,CLE,CHA,CLE08,3,1,4
CLE201304160,2013,20130416,CLE,BOS,CLE08,7,2,9
CLE201304170,2013,20130417,CLE,BOS,CLE08,6,3,9
CLE201304180,2013,20130418,CLE,BOS,CLE08,6,3,9
CLE201304300,2013,20130430,CLE,PHI,CLE08,2,14,16
CLE201305010,2013,20130501,CLE,PHI,CLE08,0,6,6
CLE201305030,2013,20130503,CLE,MIN,CLE08,6,7,13
CLE201305040,2013,20130504,CLE,MIN,CLE08,3,7,10
CLE201305050,2013,20130505,CLE,MIN,CLE08,4,2,6
CLE201305060,2013,20130506,CLE,OAK,CLE08,3,7,10
CLE201305070,2013,20130507,CLE,OAK,CLE08,0,1,1
CLE201305080,2013,20130508,CLE,OAK,CLE08,3,4,7
CLE201305090,2013,20130509,CLE,OAK,CLE08,2,9,11
CLE201305131,2013,20130513,CLE,NYA,CLE08,0,1,1
CLE201305132,2013,20130513,CLE,NYA,CLE08,7,0,7
CLE201305170,2013,20130517,CLE,SEA,CLE08,3,6,9
CLE201305180,2013,20130518,CLE,SEA,CLE08,4,5,9
CLE201305190,2013,20130519,CLE,SEA,CLE08,0,6,6
CLE201305200,2013,20130520,CLE,SEA,CLE08,8,10,18
CLE201305210,2013,20130521,CLE,DET,CLE08,5,1,6
CLE201305220,2013,20130522,CLE,DET,CLE08,11,7,18
CLE201305290,2013,20130529,CLE,CIN,CLE08,2,5,7
CLE201305300,2013,20130530,CLE,CIN,CLE08,1,7,8
CLE201305310,2013,20130531,CLE,TBA,CLE08,9,2,11
CLE201306010,2013,20130601,CLE,TBA,CLE08,0,5,5
CLE201306020,2013,20130602,CLE,TBA,CLE08,11,3,14
CLE201306140,2013,20130614,CLE,WAS,CLE08,1,2,3
CLE201306150,2013,20130615,CLE,WAS,CLE08,7,6,13
CLE201306160,2013,20130616,CLE,WAS,CLE08,0,2,2
CLE201306170,2013,20130617,CLE,KCA,CLE08,2,1,3
CLE201306180,2013,20130618,CLE,KCA,CLE08,3,4,7
CLE201306190,2013,20130619,CLE,KCA,CLE08,3,6,9
CLE201306210,2013,20130621,CLE,MIN,CLE08,1,5,6
CLE201306220,2013,20130622,CLE,MIN,CLE08,7,8,15
CLE201306230,2013,20130623,CLE,MIN,CLE08,5,3,8
CLE201307050,2013,20130705,CLE,DET,CLE08,7,0,7
CLE201307060,2013,20130706,CLE,DET,CLE08,9,4,13
CLE201307070,2013,20130707,CLE,DET,CLE08,6,9,15
CLE201307080,2013,20130708,CLE,DET,CLE08,4,2,6
CLE201307090,2013,20130709,CLE,TOR,CLE08,0,3,3
CLE201307100,2013,20130710,CLE,TOR,CLE08,5,4,9
CLE201307110,2013,20130711,CLE,TOR,CLE08,2,4,6
CLE201307120,2013,20130712,CLE,KCA,CLE08,0,3,3
CLE201307130,2013,20130713,CLE,KCA,CLE08,3,5,8
CLE201307140,2013,20130714,CLE,KCA,CLE08,4,6,10
CLE201307260,2013,20130726,CLE,TEX,CLE08,8,11,19
CLE201307270,2013,20130727,CLE,TEX,CLE08,0,1,1
CLE201307280,2013,20130728,CLE,TEX,CLE08,0,6,6
CLE201307290,2013,20130729,CLE,CHA,CLE08,2,3,5
CLE201307300,2013,20130730,CLE,CHA,CLE08,4,7,11
CLE201307310,2013,20130731,CLE,CHA,CLE08,5,6,11
CLE201308010,2013,20130801,CLE,CHA,CLE08,1,6,7
CLE201308050,2013,20130805,CLE,DET,CLE08,4,2,6
CLE201308060,2013,20130806,CLE,DET,CLE08,5,1,6
CLE201308070,2013,20130807,CLE,DET,CLE08,6,5,11
CLE201308080,2013,20130808,CLE,DET,CLE08,10,3,13
CLE201308090,2013,20130809,CLE,ANA,CLE08,5,2,7
CLE201308100,2013,20130810,CLE,ANA,CLE08,7,2,9
CLE201308110,2013,20130811,CLE,ANA,CLE08,5,6,11
CLE201308230,2013,20130823,CLE,MIN,CLE08,5,1,6
CLE201308240,2013,20130824,CLE,MIN,CLE08,2,7,9
CLE201308250,2013,20130825,CLE,MIN,CLE08,1,3,4
CLE201309020,2013,20130902,CLE,BAL,CLE08,7,2,9
CLE201309030,2013,20130903,CLE,BAL,CLE08,3,4,7
CLE201309040,2013,20130904,CLE,BAL,CLE08,4,6,10
CLE201309060,2013,20130906,CLE,NYN,CLE08,1,8,9
CLE201309070,2013,20130907,CLE,NYN,CLE08,4,9,13
CLE201309080,2013,20130908,CLE,NYN,CLE08,2,1,3
CLE201309090,2013,20130909,CLE,KCA,CLE08,3,4,7
CLE201309100,2013,20130910,CLE,KCA,CLE08,6,3,9
CLE201309110,2013,20130911,CLE,KCA,CLE08,6,2,8
CLE201309190,2013,20130919,CLE,HOU,CLE08,1,2,3
CLE201309200,2013,20130920,CLE,HOU,CLE08,1,2,3
CLE201309210,2013,20130921,CLE,HOU,CLE08,1,4,5
CLE201309220,2013,20130922,CLE,HOU,CLE08,2,9,11
CLE201309240,2013,20130924,CLE,CHA,CLE08,4,5,9
CLE201309250,2013,20130925,CLE,CHA,CLE08,2,7,9
CLE201310020,2013,20131002,CLE,TBA,CLE08,4,0,4
COL201004090,2010,100409,COL,SDN,DEN02,0,7,7
COL201004100,2010,100410,COL,SDN,DEN02,5,4,9
COL201004110,2010,100411,COL,SDN,DEN02,2,4,6
COL201004130,2010,100413,COL,NYN,DEN02,3,11,14
COL201004140,2010,100414,COL,NYN,DEN02,5,6,11
COL201004150,2010,100415,COL,NYN,DEN02,5,0,5
COL201004241,2010,100424,COL,FLO,DEN02,4,1,5
COL201004242,2010,100424,COL,FLO,DEN02,1,8,9
COL201004250,2010,100425,COL,FLO,DEN02,4,8,12
COL201004260,2010,100426,COL,ARI,DEN02,5,3,8
COL201004270,2010,100427,COL,ARI,DEN02,1,12,13
COL201004280,2010,100428,COL,ARI,DEN02,12,11,23
COL201005100,2010,100510,COL,PHI,DEN02,9,5,14
COL201005120,2010,100512,COL,PHI,DEN02,3,4,7
COL201005130,2010,100513,COL,WAS,DEN02,14,6,20
COL201005151,2010,100515,COL,WAS,DEN02,2,6,8
COL201005152,2010,100515,COL,WAS,DEN02,3,4,7
COL201005160,2010,100516,COL,WAS,DEN02,1,2,3
COL201005250,2010,100525,COL,ARI,DEN02,2,3,5
COL201005260,2010,100526,COL,ARI,DEN02,3,7,10
COL201005270,2010,100527,COL,ARI,DEN02,2,8,10
COL201005280,2010,100528,COL,LAN,DEN02,5,4,9
COL201005290,2010,100529,COL,LAN,DEN02,3,11,14
COL201005300,2010,100530,COL,LAN,DEN02,4,3,7
COL201006070,2010,100607,COL,HOU,DEN02,1,5,6
COL201006080,2010,100608,COL,HOU,DEN02,4,3,7
COL201006090,2010,100609,COL,HOU,DEN02,6,2,8
COL201006100,2010,100610,COL,HOU,DEN02,5,4,9
COL201006110,2010,100611,COL,TOR,DEN02,3,5,8
COL201006120,2010,100612,COL,TOR,DEN02,0,1,1
COL201006130,2010,100613,COL,TOR,DEN02,3,10,13
COL201006180,2010,100618,COL,MIL,DEN02,0,2,2
COL201006190,2010,100619,COL,MIL,DEN02,7,8,15
COL201006200,2010,100620,COL,MIL,DEN02,6,1,7
COL201006220,2010,100622,COL,BOS,DEN02,1,2,3
COL201006230,2010,100623,COL,BOS,DEN02,6,8,14
COL201006240,2010,100624,COL,BOS,DEN02,13,11,24
COL201007010,2010,100701,COL,SFN,DEN02,3,7,10
COL201007020,2010,100702,COL,SFN,DEN02,3,6,9
COL201007030,2010,100703,COL,SFN,DEN02,11,8,19
COL201007040,2010,100704,COL,SFN,DEN02,3,4,7
COL201007060,2010,100706,COL,SLN,DEN02,9,12,21
COL201007070,2010,100707,COL,SLN,DEN02,7,8,15
COL201007080,2010,100708,COL,SLN,DEN02,2,4,6
COL201007090,2010,100709,COL,SDN,DEN02,8,10,18
COL201007100,2010,100710,COL,SDN,DEN02,2,4,6
COL201007110,2010,100711,COL,SDN,DEN02,9,7,16
COL201007270,2010,100727,COL,PIT,DEN02,4,2,6
COL201007280,2010,100728,COL,PIT,DEN02,6,2,8
COL201007290,2010,100729,COL,PIT,DEN02,3,9,12
COL201007300,2010,100730,COL,CHN,DEN02,2,17,19
COL201007310,2010,100731,COL,CHN,DEN02,5,6,11
COL201008010,2010,100801,COL,CHN,DEN02,7,8,15
COL201008030,2010,100803,COL,SFN,DEN02,10,0,10
COL201008040,2010,100804,COL,SFN,DEN02,1,6,7
COL201008130,2010,100813,COL,MIL,DEN02,4,5,9
COL201008140,2010,100814,COL,MIL,DEN02,5,4,9
COL201008150,2010,100815,COL,MIL,DEN02,5,6,11
COL201008230,2010,100823,COL,ATL,DEN02,4,5,9
COL201008240,2010,100824,COL,ATL,DEN02,2,5,7
COL201008250,2010,100825,COL,ATL,DEN02,10,12,22
COL201008270,2010,100827,COL,LAN,DEN02,6,2,8
COL201008280,2010,100828,COL,LAN,DEN02,3,5,8
COL201008290,2010,100829,COL,LAN,DEN02,5,10,15
COL201009020,2010,100902,COL,PHI,DEN02,12,11,23
COL201009060,2010,100906,COL,CIN,DEN02,5,10,15
COL201009070,2010,100907,COL,CIN,DEN02,3,4,7
COL201009080,2010,100908,COL,CIN,DEN02,2,9,11
COL201009090,2010,100909,COL,CIN,DEN02,5,6,11
COL201009100,2010,100910,COL,ARI,DEN02,4,13,17
COL201009110,2010,100911,COL,ARI,DEN02,1,2,3
COL201009120,2010,100912,COL,ARI,DEN02,2,4,6
COL201009130,2010,100913,COL,SDN,DEN02,6,4,10
COL201009140,2010,100914,COL,SDN,DEN02,7,6,13
COL201009150,2010,100915,COL,SDN,DEN02,6,9,15
COL201009240,2010,100924,COL,SFN,DEN02,2,1,3
COL201009250,2010,100925,COL,SFN,DEN02,9,10,19
COL201009260,2010,100926,COL,SFN,DEN02,4,2,6
COL201009270,2010,100927,COL,LAN,DEN02,3,1,4
COL201009280,2010,100928,COL,LAN,DEN02,9,7,16
COL201009290,2010,100929,COL,LAN,DEN02,7,6,13
COL201104010,2011,20110401,COL,ARI,DEN02,7,6,13
COL201104020,2011,20110402,COL,ARI,DEN02,1,3,4
COL201104050,2011,20110405,COL,LAN,DEN02,0,3,3
COL201104060,2011,20110406,COL,LAN,DEN02,5,7,12
COL201104150,2011,20110415,COL,CHN,DEN02,0,5,5
COL201104160,2011,20110416,COL,CHN,DEN02,8,3,11
COL201104170,2011,20110417,COL,CHN,DEN02,5,9,14
COL201104180,2011,20110418,COL,SFN,DEN02,8,1,9
COL201104190,2011,20110419,COL,SFN,DEN02,6,3,9
COL201104200,2011,20110420,COL,SFN,DEN02,2,10,12
COL201104290,2011,20110429,COL,PIT,DEN02,3,0,3
COL201104300,2011,20110430,COL,PIT,DEN02,1,4,5
COL201105010,2011,20110501,COL,PIT,DEN02,8,4,12
COL201105090,2011,20110509,COL,NYN,DEN02,1,2,3
COL201105100,2011,20110510,COL,NYN,DEN02,4,3,7
COL201105120,2011,20110512,COL,NYN,DEN02,9,5,14
COL201105130,2011,20110513,COL,SDN,DEN02,7,12,19
COL201105140,2011,20110514,COL,SDN,DEN02,9,7,16
COL201105150,2011,20110515,COL,SDN,DEN02,8,2,10
COL201105160,2011,20110516,COL,SFN,DEN02,4,7,11
COL201105170,2011,20110517,COL,SFN,DEN02,3,5,8
COL201105241,2011,20110524,COL,ARI,DEN02,4,12,16
COL201105242,2011,20110524,COL,ARI,DEN02,5,2,7
COL201105250,2011,20110525,COL,ARI,DEN02,2,1,3
COL201105260,2011,20110526,COL,ARI,DEN02,6,3,9
COL201105270,2011,20110527,COL,SLN,DEN02,10,3,13
COL201105280,2011,20110528,COL,SLN,DEN02,4,15,19
COL201105290,2011,20110529,COL,SLN,DEN02,4,3,7
COL201106090,2011,20110609,COL,LAN,DEN02,7,9,16
COL201106100,2011,20110610,COL,LAN,DEN02,5,6,11
COL201106110,2011,20110611,COL,LAN,DEN02,11,7,18
COL201106120,2011,20110612,COL,LAN,DEN02,10,8,18
COL201106130,2011,20110613,COL,SDN,DEN02,3,1,4
COL201106140,2011,20110614,COL,SDN,DEN02,3,6,9
COL201106150,2011,20110615,COL,SDN,DEN02,3,6,9
COL201106170,2011,20110617,COL,DET,DEN02,6,13,19
COL201106180,2011,20110618,COL,DET,DEN02,4,5,9
COL201106190,2011,20110619,COL,DET,DEN02,9,1,10
COL201106280,2011,20110628,COL,CHA,DEN02,2,3,5
COL201106290,2011,20110629,COL,CHA,DEN02,3,2,5
COL201106300,2011,20110630,COL,CHA,DEN02,6,4,10
COL201107010,2011,20110701,COL,KCA,DEN02,0,9,9
COL201107020,2011,20110702,COL,KCA,DEN02,6,9,15
COL201107030,2011,20110703,COL,KCA,DEN02,16,8,24
COL201107140,2011,20110714,COL,MIL,DEN02,3,12,15
COL201107150,2011,20110715,COL,MIL,DEN02,0,4,4
COL201107160,2011,20110716,COL,MIL,DEN02,8,7,15
COL201107170,2011,20110717,COL,MIL,DEN02,4,3,7
COL201107180,2011,20110718,COL,ATL,DEN02,7,4,11
COL201107190,2011,20110719,COL,ATL,DEN02,3,12,15
COL201107200,2011,20110720,COL,ATL,DEN02,2,3,5
COL201107210,2011,20110721,COL,ATL,DEN02,9,6,15
COL201108010,2011,20110801,COL,PHI,DEN02,4,3,7
COL201108020,2011,20110802,COL,PHI,DEN02,5,0,5
COL201108030,2011,20110803,COL,PHI,DEN02,8,6,14
COL201108040,2011,20110804,COL,WAS,DEN02,3,6,9
COL201108050,2011,20110805,COL,WAS,DEN02,5,3,8
COL201108060,2011,20110806,COL,WAS,DEN02,7,15,22
COL201108070,2011,20110807,COL,WAS,DEN02,3,2,5
COL201108150,2011,20110815,COL,FLO,DEN02,4,7,11
COL201108160,2011,20110816,COL,FLO,DEN02,6,5,11
COL201108170,2011,20110817,COL,FLO,DEN02,5,12,17
COL201108190,2011,20110819,COL,LAN,DEN02,8,2,10
COL201108200,2011,20110820,COL,LAN,DEN02,6,7,13
COL201108210,2011,20110821,COL,LAN,DEN02,3,5,8
COL201108220,2011,20110822,COL,HOU,DEN02,5,9,14
COL201108230,2011,20110823,COL,HOU,DEN02,6,8,14
COL201108240,2011,20110824,COL,HOU,DEN02,6,7,13
COL201109050,2011,20110905,COL,ARI,DEN02,10,7,17
COL201109060,2011,20110906,COL,ARI,DEN02,3,8,11
COL201109070,2011,20110907,COL,ARI,DEN02,5,3,8
COL201109090,2011,20110909,COL,CIN,DEN02,4,1,5
COL201109100,2011,20110910,COL,CIN,DEN02,7,12,19
COL201109110,2011,20110911,COL,CIN,DEN02,1,4,5
COL201109150,2011,20110915,COL,SFN,DEN02,8,5,13
COL201109160,2011,20110916,COL,SFN,DEN02,9,1,10
COL201109170,2011,20110917,COL,SFN,DEN02,6,5,11
COL201109180,2011,20110918,COL,SFN,DEN02,12,5,17
COL201109190,2011,20110919,COL,SDN,DEN02,8,2,10
COL201109200,2011,20110920,COL,SDN,DEN02,2,1,3
COL201109210,2011,20110921,COL,SDN,DEN02,4,0,4
COL201204090,2012,120409,COL,SFN,DEN02,7,0,7
COL201204110,2012,120411,COL,SFN,DEN02,8,17,25
COL201204120,2012,120412,COL,SFN,DEN02,4,2,6
COL201204130,2012,120413,COL,ARI,DEN02,6,7,13
COL201204140,2012,120414,COL,ARI,DEN02,7,8,15
COL201204150,2012,120415,COL,ARI,DEN02,5,2,7
COL201204160,2012,120416,COL,SDN,DEN02,7,1,8
COL201204170,2012,120417,COL,SDN,DEN02,3,5,8
COL201204180,2012,120418,COL,SDN,DEN02,4,8,12
COL201204270,2012,120427,COL,NYN,DEN02,9,18,27
COL201204280,2012,120428,COL,NYN,DEN02,7,5,12
COL201204290,2012,120429,COL,NYN,DEN02,6,5,11
COL201204300,2012,120430,COL,LAN,DEN02,2,6,8
COL201205010,2012,120501,COL,LAN,DEN02,7,6,13
COL201205020,2012,120502,COL,LAN,DEN02,5,8,13
COL201205040,2012,120504,COL,ATL,DEN02,9,8,17
COL201205050,2012,120505,COL,ATL,DEN02,13,9,22
COL201205060,2012,120506,COL,ATL,DEN02,7,2,9
COL201205160,2012,120516,COL,ARI,DEN02,1,6,7
COL201205170,2012,120517,COL,ARI,DEN02,9,7,16
COL201205180,2012,120518,COL,SEA,DEN02,4,0,4
COL201205190,2012,120519,COL,SEA,DEN02,10,3,13
COL201205200,2012,120520,COL,SEA,DEN02,6,4,10
COL201205281,2012,120528,COL,HOU,DEN02,7,9,16
COL201205282,2012,120528,COL,HOU,DEN02,6,7,13
COL201205300,2012,120530,COL,HOU,DEN02,5,13,18
COL201205310,2012,120531,COL,HOU,DEN02,5,11,16
COL201206010,2012,120601,COL,LAN,DEN02,3,13,16
COL201206020,2012,120602,COL,LAN,DEN02,6,2,8
COL201206030,2012,120603,COL,LAN,DEN02,2,3,5
COL201206080,2012,120608,COL,ANA,DEN02,7,2,9
COL201206090,2012,120609,COL,ANA,DEN02,11,5,16
COL201206100,2012,120610,COL,ANA,DEN02,10,8,18
COL201206120,2012,120612,COL,OAK,DEN02,8,5,13
COL201206130,2012,120613,COL,OAK,DEN02,10,8,18
COL201206140,2012,120614,COL,OAK,DEN02,8,2,10
COL201206250,2012,120625,COL,WAS,DEN02,2,4,6
COL201206260,2012,120626,COL,WAS,DEN02,12,5,17
COL201206270,2012,120627,COL,WAS,DEN02,11,5,16
COL201206280,2012,120628,COL,WAS,DEN02,10,11,21
COL201206290,2012,120629,COL,SDN,DEN02,2,10,12
COL201206300,2012,120630,COL,SDN,DEN02,8,4,12
COL201207010,2012,120701,COL,SDN,DEN02,2,0,2
COL201207130,2012,120713,COL,PHI,DEN02,2,6,8
COL201207140,2012,120714,COL,PHI,DEN02,8,5,13
COL201207150,2012,120715,COL,PHI,DEN02,5,1,6
COL201207160,2012,120716,COL,PIT,DEN02,4,5,9
COL201207170,2012,120717,COL,PIT,DEN02,6,2,8
COL201207180,2012,120718,COL,PIT,DEN02,9,6,15
COL201207270,2012,120727,COL,CIN,DEN02,3,0,3
COL201207280,2012,120728,COL,CIN,DEN02,9,7,16
COL201207290,2012,120729,COL,CIN,DEN02,7,2,9
COL201207310,2012,120731,COL,SLN,DEN02,11,6,17
COL201208010,2012,120801,COL,SLN,DEN02,9,6,15
COL201208020,2012,120802,COL,SLN,DEN02,2,8,10
COL201208030,2012,120803,COL,SFN,DEN02,16,4,20
COL201208040,2012,120804,COL,SFN,DEN02,11,6,17
COL201208050,2012,120805,COL,SFN,DEN02,8,3,11
COL201208130,2012,120813,COL,MIL,DEN02,6,9,15
COL201208140,2012,120814,COL,MIL,DEN02,6,8,14
COL201208150,2012,120815,COL,MIL,DEN02,6,7,13
COL201208160,2012,120816,COL,MIA,DEN02,3,5,8
COL201208170,2012,120817,COL,MIA,DEN02,6,5,11
COL201208180,2012,120818,COL,MIA,DEN02,6,5,11
COL201208190,2012,120819,COL,MIA,DEN02,2,3,5
COL201208270,2012,120827,COL,LAN,DEN02,0,10,10
COL201208280,2012,120828,COL,LAN,DEN02,4,8,12
COL201208290,2012,120829,COL,LAN,DEN02,10,8,18
COL201208310,2012,120831,COL,SDN,DEN02,5,4,9
COL201209010,2012,120901,COL,SDN,DEN02,1,9,10
COL201209020,2012,120902,COL,SDN,DEN02,10,11,21
COL201209100,2012,120910,COL,SFN,DEN02,5,6,11
COL201209110,2012,120911,COL,SFN,DEN02,9,8,17
COL201209120,2012,120912,COL,SFN,DEN02,8,3,11
COL201209210,2012,120921,COL,ARI,DEN02,15,5,20
COL201209220,2012,120922,COL,ARI,DEN02,8,7,15
COL201209230,2012,120923,COL,ARI,DEN02,10,7,17
COL201209240,2012,120924,COL,ARI,DEN02,2,4,6
COL201209250,2012,120925,COL,CHN,DEN02,5,10,15
COL201209260,2012,120926,COL,CHN,DEN02,0,6,6
COL201209270,2012,120927,COL,CHN,DEN02,5,7,12
COL201304050,2013,20130405,COL,SDN,DEN02,2,5,7
COL201304060,2013,20130406,COL,SDN,DEN02,3,6,9
COL201304070,2013,20130407,COL,SDN,DEN02,1,9,10
COL201304161,2013,20130416,COL,NYN,DEN02,4,8,12
COL201304162,2013,20130416,COL,NYN,DEN02,8,9,17
COL201304180,2013,20130418,COL,NYN,DEN02,3,11,14
COL201304190,2013,20130419,COL,ARI,DEN02,1,3,4
COL201304200,2013,20130420,COL,ARI,DEN02,3,4,7
COL201304210,2013,20130421,COL,ARI,DEN02,5,4,9
COL201304231,2013,20130423,COL,ATL,DEN02,4,3,7
COL201304232,2013,20130423,COL,ATL,DEN02,10,2,12
COL201304240,2013,20130424,COL,ATL,DEN02,5,6,11
COL201305030,2013,20130503,COL,TBA,DEN02,7,4,11
COL201305040,2013,20130504,COL,TBA,DEN02,3,9,12
COL201305050,2013,20130505,COL,TBA,DEN02,8,3,11
COL201305070,2013,20130507,COL,NYA,DEN02,0,2,2
COL201305080,2013,20130508,COL,NYA,DEN02,3,2,5
COL201305090,2013,20130509,COL,NYA,DEN02,3,1,4
COL201305160,2013,20130516,COL,SFN,DEN02,8,6,14
COL201305170,2013,20130517,COL,SFN,DEN02,9,10,19
COL201305180,2013,20130518,COL,SFN,DEN02,2,10,12
COL201305190,2013,20130519,COL,SFN,DEN02,0,5,5
COL201305200,2013,20130520,COL,ARI,DEN02,5,1,6
COL201305210,2013,20130521,COL,ARI,DEN02,4,5,9
COL201305220,2013,20130522,COL,ARI,DEN02,1,4,5
COL201305290,2013,20130529,COL,HOU,DEN02,6,3,9
COL201305300,2013,20130530,COL,HOU,DEN02,7,5,12
COL201305310,2013,20130531,COL,LAN,DEN02,7,5,12
COL201306010,2013,20130601,COL,LAN,DEN02,6,7,13
COL201306020,2013,20130602,COL,LAN,DEN02,2,7,9
COL201306060,2013,20130606,COL,SDN,DEN02,6,5,11
COL201306070,2013,20130607,COL,SDN,DEN02,9,10,19
COL201306080,2013,20130608,COL,SDN,DEN02,4,2,6
COL201306090,2013,20130609,COL,SDN,DEN02,7,8,15
COL201306110,2013,20130611,COL,WAS,DEN02,3,8,11
COL201306120,2013,20130612,COL,WAS,DEN02,5,1,6
COL201306130,2013,20130613,COL,WAS,DEN02,5,4,9
COL201306140,2013,20130614,COL,PHI,DEN02,8,7,15
COL201306150,2013,20130615,COL,PHI,DEN02,5,10,15
COL201306160,2013,20130616,COL,PHI,DEN02,2,5,7
COL201306270,2013,20130627,COL,NYN,DEN02,3,2,5
COL201306280,2013,20130628,COL,SFN,DEN02,1,4,5
COL201306290,2013,20130629,COL,SFN,DEN02,1,2,3
COL201306300,2013,20130630,COL,SFN,DEN02,5,2,7
COL201307020,2013,20130702,COL,LAN,DEN02,8,0,8
COL201307030,2013,20130703,COL,LAN,DEN02,10,8,18
COL201307040,2013,20130704,COL,LAN,DEN02,5,9,14
COL201307190,2013,20130719,COL,CHN,DEN02,3,1,4
COL201307200,2013,20130720,COL,CHN,DEN02,3,9,12
COL201307210,2013,20130721,COL,CHN,DEN02,3,4,7
COL201307220,2013,20130722,COL,MIA,DEN02,3,1,4
COL201307230,2013,20130723,COL,MIA,DEN02,4,2,6
COL201307240,2013,20130724,COL,MIA,DEN02,1,2,3
COL201307250,2013,20130725,COL,MIA,DEN02,5,3,8
COL201307260,2013,20130726,COL,MIL,DEN02,3,8,11
COL201307270,2013,20130727,COL,MIL,DEN02,7,5,12
COL201307280,2013,20130728,COL,MIL,DEN02,5,6,11
COL201308090,2013,20130809,COL,PIT,DEN02,1,10,11
COL201308100,2013,20130810,COL,PIT,DEN02,4,6,10
COL201308110,2013,20130811,COL,PIT,DEN02,2,3,5
COL201308120,2013,20130812,COL,SDN,DEN02,2,14,16
COL201308130,2013,20130813,COL,SDN,DEN02,7,5,12
COL201308140,2013,20130814,COL,SDN,DEN02,2,4,6
COL201308260,2013,20130826,COL,SFN,DEN02,1,6,7
COL201308270,2013,20130827,COL,SFN,DEN02,5,3,8
COL201308280,2013,20130828,COL,SFN,DEN02,4,5,9
COL201308300,2013,20130830,COL,CIN,DEN02,6,9,15
COL201308310,2013,20130831,COL,CIN,DEN02,8,3,11
COL201309010,2013,20130901,COL,CIN,DEN02,4,7,11
COL201309020,2013,20130902,COL,LAN,DEN02,10,8,18
COL201309030,2013,20130903,COL,LAN,DEN02,7,4,11
COL201309040,2013,20130904,COL,LAN,DEN02,5,7,12
COL201309160,2013,20130916,COL,SLN,DEN02,2,6,8
COL201309170,2013,20130917,COL,SLN,DEN02,11,4,15
COL201309180,2013,20130918,COL,SLN,DEN02,4,3,7
COL201309190,2013,20130919,COL,SLN,DEN02,6,7,13
COL201309200,2013,20130920,COL,ARI,DEN02,4,9,13
COL201309210,2013,20130921,COL,ARI,DEN02,7,2,9
COL201309220,2013,20130922,COL,ARI,DEN02,13,9,22
COL201309240,2013,20130924,COL,BOS,DEN02,3,8,11
COL201309250,2013,20130925,COL,BOS,DEN02,15,5,20
DET201004090,2010,100409,DET,CLE,DET05,2,5,7
DET201004100,2010,100410,DET,CLE,DET05,2,4,6
DET201004110,2010,100411,DET,CLE,DET05,8,9,17
DET201004120,2010,100412,DET,KCA,DET05,10,5,15
DET201004130,2010,100413,DET,KCA,DET05,5,6,11
DET201004140,2010,100414,DET,KCA,DET05,7,3,10
DET201004270,2010,100427,DET,MIN,DET05,2,0,2
DET201004280,2010,100428,DET,MIN,DET05,6,11,17
DET201004290,2010,100429,DET,MIN,DET05,0,3,3
DET201004300,2010,100430,DET,ANA,DET05,6,10,16
DET201005010,2010,100501,DET,ANA,DET05,2,3,5
DET201005020,2010,100502,DET,ANA,DET05,1,5,6
DET201005100,2010,100510,DET,NYA,DET05,4,5,9
DET201005121,2010,100512,DET,NYA,DET05,0,2,2
DET201005122,2010,100512,DET,NYA,DET05,8,0,8
DET201005130,2010,100513,DET,NYA,DET05,0,6,6
DET201005140,2010,100514,DET,BOS,DET05,7,2,9
DET201005150,2010,100515,DET,BOS,DET05,6,7,13
DET201005160,2010,100516,DET,BOS,DET05,1,5,6
DET201005180,2010,100518,DET,CHA,DET05,6,2,8
DET201005280,2010,100528,DET,OAK,DET05,5,4,9
DET201005290,2010,100529,DET,OAK,DET05,6,0,6
DET201005300,2010,100530,DET,OAK,DET05,2,10,12
DET201005310,2010,100531,DET,OAK,DET05,4,1,5
DET201006010,2010,100601,DET,CLE,DET05,3,2,5
DET201006020,2010,100602,DET,CLE,DET05,0,3,3
DET201006030,2010,100603,DET,CLE,DET05,6,12,18
DET201006110,2010,100611,DET,PIT,DET05,2,6,8
DET201006120,2010,100612,DET,PIT,DET05,3,4,7
DET201006130,2010,100613,DET,PIT,DET05,3,4,7
DET201006150,2010,100615,DET,WAS,DET05,4,7,11
DET201006160,2010,100616,DET,WAS,DET05,3,8,11
DET201006170,2010,100617,DET,WAS,DET05,3,8,11
DET201006180,2010,100618,DET,ARI,DET05,5,7,12
DET201006190,2010,100619,DET,ARI,DET05,6,5,11
DET201006200,2010,100620,DET,ARI,DET05,1,3,4
DET201007020,2010,100702,DET,SEA,DET05,1,7,8
DET201007030,2010,100703,DET,SEA,DET05,1,6,7
DET201007040,2010,100704,DET,SEA,DET05,8,1,9
DET201007050,2010,100705,DET,BAL,DET05,9,12,21
DET201007060,2010,100706,DET,BAL,DET05,5,7,12
DET201007070,2010,100707,DET,BAL,DET05,2,4,6
DET201007090,2010,100709,DET,MIN,DET05,3,7,10
DET201007100,2010,100710,DET,MIN,DET05,4,7,11
DET201007110,2010,100711,DET,MIN,DET05,6,3,9
DET201007190,2010,100719,DET,TEX,DET05,8,6,14
DET201007200,2010,100720,DET,TEX,DET05,8,0,8
DET201007210,2010,100721,DET,TEX,DET05,1,4,5
DET201007220,2010,100722,DET,TOR,DET05,2,5,7
DET201007240,2010,100724,DET,TOR,DET05,3,2,5
DET201007251,2010,100725,DET,TOR,DET05,5,3,8
DET201007252,2010,100725,DET,TOR,DET05,5,6,11
DET201008031,2010,100803,DET,CHA,DET05,12,2,14
DET201008032,2010,100803,DET,CHA,DET05,1,7,8
DET201008040,2010,100804,DET,CHA,DET05,4,1,5
DET201008050,2010,100805,DET,CHA,DET05,6,4,10
DET201008060,2010,100806,DET,ANA,DET05,4,2,6
DET201008070,2010,100807,DET,ANA,DET05,10,1,11
DET201008080,2010,100808,DET,ANA,DET05,4,9,13
DET201008090,2010,100809,DET,TBA,DET05,6,3,9
DET201008100,2010,100810,DET,TBA,DET05,8,0,8
DET201008110,2010,100811,DET,TBA,DET05,2,3,5
DET201008200,2010,100820,DET,CLE,DET05,0,6,6
DET201008210,2010,100821,DET,CLE,DET05,2,5,7
DET201008220,2010,100822,DET,CLE,DET05,1,8,9
DET201008230,2010,100823,DET,KCA,DET05,3,12,15
DET201008240,2010,100824,DET,KCA,DET05,1,9,10
DET201008250,2010,100825,DET,KCA,DET05,4,3,7
DET201009060,2010,100906,DET,CHA,DET05,5,4,9
DET201009070,2010,100907,DET,CHA,DET05,1,9,10
DET201009080,2010,100908,DET,CHA,DET05,1,5,6
DET201009090,2010,100909,DET,CHA,DET05,3,6,9
DET201009100,2010,100910,DET,BAL,DET05,6,3,9
DET201009110,2010,100911,DET,BAL,DET05,5,3,8
DET201009120,2010,100912,DET,BAL,DET05,2,6,8
DET201009200,2010,100920,DET,KCA,DET05,5,7,12
DET201009210,2010,100921,DET,KCA,DET05,9,6,15
DET201009220,2010,100922,DET,KCA,DET05,2,4,6
DET201009240,2010,100924,DET,MIN,DET05,1,10,11
DET201009250,2010,100925,DET,MIN,DET05,10,11,21
DET201009260,2010,100926,DET,MIN,DET05,1,5,6
DET201104080,2011,20110408,DET,KCA,DET05,2,5,7
DET201104090,2011,20110409,DET,KCA,DET05,3,1,4
DET201104100,2011,20110410,DET,KCA,DET05,9,5,14
DET201104110,2011,20110411,DET,TEX,DET05,2,0,2
DET201104120,2011,20110412,DET,TEX,DET05,4,5,9
DET201104130,2011,20110413,DET,TEX,DET05,2,3,5
DET201104220,2011,20110422,DET,CHA,DET05,3,9,12
DET201104230,2011,20110423,DET,CHA,DET05,0,9,9
DET201104240,2011,20110424,DET,CHA,DET05,0,3,3
DET201104260,2011,20110426,DET,SEA,DET05,7,3,10
DET201104270,2011,20110427,DET,SEA,DET05,10,1,11
DET201104280,2011,20110428,DET,SEA,DET05,7,2,9
DET201105020,2011,20110502,DET,NYA,DET05,5,3,8
DET201105030,2011,20110503,DET,NYA,DET05,2,4,6
DET201105040,2011,20110504,DET,NYA,DET05,0,4,4
DET201105050,2011,20110505,DET,NYA,DET05,3,6,9
DET201105130,2011,20110513,DET,KCA,DET05,1,3,4
DET201105140,2011,20110514,DET,KCA,DET05,0,3,3
DET201105160,2011,20110516,DET,TOR,DET05,4,2,6
DET201105230,2011,20110523,DET,TBA,DET05,3,6,9
DET201105240,2011,20110524,DET,TBA,DET05,6,7,13
DET201105260,2011,20110526,DET,BOS,DET05,14,1,15
DET201105270,2011,20110527,DET,BOS,DET05,6,3,9
DET201105291,2011,20110529,DET,BOS,DET05,4,3,7
DET201105292,2011,20110529,DET,BOS,DET05,0,3,3
DET201105300,2011,20110530,DET,MIN,DET05,5,6,11
DET201105310,2011,20110531,DET,MIN,DET05,7,8,15
DET201106010,2011,20110601,DET,MIN,DET05,2,4,6
DET201106090,2011,20110609,DET,SEA,DET05,1,4,5
DET201106100,2011,20110610,DET,SEA,DET05,3,2,5
DET201106110,2011,20110611,DET,SEA,DET05,1,8,9
DET201106120,2011,20110612,DET,SEA,DET05,7,3,10
DET201106130,2011,20110613,DET,TBA,DET05,1,2,3
DET201106140,2011,20110614,DET,CLE,DET05,0,4,4
DET201106150,2011,20110615,DET,CLE,DET05,6,4,10
DET201106160,2011,20110616,DET,CLE,DET05,2,6,8
DET201106240,2011,20110624,DET,ARI,DET05,7,6,13
DET201106250,2011,20110625,DET,ARI,DET05,0,6,6
DET201106260,2011,20110626,DET,ARI,DET05,3,8,11
DET201106270,2011,20110627,DET,TOR,DET05,2,4,6
DET201106280,2011,20110628,DET,NYN,DET05,14,3,17
DET201106290,2011,20110629,DET,NYN,DET05,16,9,25
DET201106300,2011,20110630,DET,NYN,DET05,2,5,7
DET201107010,2011,20110701,DET,SFN,DET05,4,3,7
DET201107020,2011,20110702,DET,SFN,DET05,15,3,18
DET201107030,2011,20110703,DET,SFN,DET05,3,6,9
DET201107150,2011,20110715,DET,CHA,DET05,8,2,10
DET201107160,2011,20110716,DET,CHA,DET05,5,0,5
DET201107170,2011,20110717,DET,CHA,DET05,3,4,7
DET201107190,2011,20110719,DET,OAK,DET05,3,8,11
DET201107200,2011,20110720,DET,OAK,DET05,7,5,12
DET201107280,2011,20110728,DET,ANA,DET05,12,7,19
DET201107290,2011,20110729,DET,ANA,DET05,2,12,14
DET201107300,2011,20110730,DET,ANA,DET05,5,1,6
DET201107310,2011,20110731,DET,ANA,DET05,2,3,5
DET201108020,2011,20110802,DET,TEX,DET05,5,6,11
DET201108030,2011,20110803,DET,TEX,DET05,4,5,9
DET201108040,2011,20110804,DET,TEX,DET05,5,2,7
DET201108150,2011,20110815,DET,MIN,DET05,9,6,15
DET201108160,2011,20110816,DET,MIN,DET05,1,7,8
DET201108170,2011,20110817,DET,MIN,DET05,6,5,11
DET201108190,2011,20110819,DET,CLE,DET05,1,4,5
DET201108200,2011,20110820,DET,CLE,DET05,1,10,11
DET201108210,2011,20110821,DET,CLE,DET05,7,8,15
DET201108290,2011,20110829,DET,KCA,DET05,9,5,14
DET201108300,2011,20110830,DET,KCA,DET05,1,2,3
DET201108310,2011,20110831,DET,KCA,DET05,4,5,9
DET201109010,2011,20110901,DET,KCA,DET05,11,8,19
DET201109020,2011,20110902,DET,CHA,DET05,1,8,9
DET201109030,2011,20110903,DET,CHA,DET05,8,9,17
DET201109040,2011,20110904,DET,CHA,DET05,2,18,20
DET201109090,2011,20110909,DET,MIN,DET05,4,8,12
DET201109100,2011,20110910,DET,MIN,DET05,2,3,5
DET201109110,2011,20110911,DET,MIN,DET05,1,2,3
DET201109220,2011,20110922,DET,BAL,DET05,6,5,11
DET201109230,2011,20110923,DET,BAL,DET05,3,4,7
DET201109240,2011,20110924,DET,BAL,DET05,6,5,11
DET201109250,2011,20110925,DET,BAL,DET05,6,10,16
DET201109260,2011,20110926,DET,CLE,DET05,0,14,14
DET201109270,2011,20110927,DET,CLE,DET05,6,9,15
DET201109280,2011,20110928,DET,CLE,DET05,4,5,9
DET201110030,2011,20111003,DET,NYA,DET05,4,5,9
DET201110040,2011,20111004,DET,NYA,DET05,10,1,11
DET201110110,2011,20111011,DET,TEX,DET05,2,5,7
DET201110120,2011,20111012,DET,TEX,DET05,7,3,10
DET201110130,2011,20111013,DET,TEX,DET05,5,7,12
DET201204050,2012,120405,DET,BOS,DET05,2,3,5
DET201204070,2012,120407,DET,BOS,DET05,0,10,10
DET201204080,2012,120408,DET,BOS,DET05,12,13,25
DET201204100,2012,120410,DET,TBA,DET05,2,5,7
DET201204110,2012,120411,DET,TBA,DET05,4,2,6
DET201204120,2012,120412,DET,TBA,DET05,2,7,9
DET201204190,2012,120419,DET,TEX,DET05,10,3,13
DET201204211,2012,120421,DET,TEX,DET05,10,4,14
DET201204212,2012,120421,DET,TEX,DET05,2,3,5
DET201204220,2012,120422,DET,TEX,DET05,3,2,5
DET201204240,2012,120424,DET,SEA,DET05,7,4,11
DET201204250,2012,120425,DET,SEA,DET05,9,1,10
DET201204260,2012,120426,DET,SEA,DET05,5,4,9
DET201205010,2012,120501,DET,KCA,DET05,3,9,12
DET201205020,2012,120502,DET,KCA,DET05,3,2,5
DET201205040,2012,120504,DET,CHA,DET05,4,5,9
DET201205050,2012,120505,DET,CHA,DET05,3,2,5
DET201205060,2012,120506,DET,CHA,DET05,1,3,4
DET201205160,2012,120516,DET,MIN,DET05,11,7,18
DET201205170,2012,120517,DET,MIN,DET05,4,3,7
DET201205180,2012,120518,DET,PIT,DET05,0,6,6
DET201205190,2012,120519,DET,PIT,DET05,4,3,7
DET201205200,2012,120520,DET,PIT,DET05,3,4,7
DET201206010,2012,120601,DET,NYA,DET05,9,4,13
DET201206020,2012,120602,DET,NYA,DET05,3,4,7
DET201206030,2012,120603,DET,NYA,DET05,5,1,6
DET201206050,2012,120605,DET,CLE,DET05,4,2,6
DET201206060,2012,120606,DET,CLE,DET05,9,6,15
DET201206070,2012,120607,DET,CLE,DET05,5,7,12
DET201206150,2012,120615,DET,COL,DET05,12,4,16
DET201206160,2012,120616,DET,COL,DET05,1,4,5
DET201206170,2012,120617,DET,COL,DET05,0,5,5
DET201206190,2012,120619,DET,SLN,DET05,3,6,9
DET201206200,2012,120620,DET,SLN,DET05,3,1,4
DET201206210,2012,120621,DET,SLN,DET05,1,2,3
DET201207020,2012,120702,DET,MIN,DET05,6,4,10
DET201207030,2012,120703,DET,MIN,DET05,8,6,14
DET201207040,2012,120704,DET,MIN,DET05,1,5,6
DET201207050,2012,120705,DET,MIN,DET05,3,7,10
DET201207060,2012,120706,DET,KCA,DET05,2,4,6
DET201207070,2012,120707,DET,KCA,DET05,7,8,15
DET201207080,2012,120708,DET,KCA,DET05,1,7,8
DET201207160,2012,120716,DET,ANA,DET05,6,8,14
DET201207170,2012,120717,DET,ANA,DET05,13,0,13
DET201207180,2012,120718,DET,ANA,DET05,2,7,9
DET201207190,2012,120719,DET,ANA,DET05,1,5,6
DET201207200,2012,120720,DET,CHA,DET05,2,4,6
DET201207210,2012,120721,DET,CHA,DET05,1,7,8
DET201207220,2012,120722,DET,CHA,DET05,4,6,10
DET201208030,2012,120803,DET,CLE,DET05,2,10,12
DET201208040,2012,120804,DET,CLE,DET05,1,6,7
DET201208050,2012,120805,DET,CLE,DET05,8,10,18
DET201208060,2012,120806,DET,NYA,DET05,2,7,9
DET201208070,2012,120807,DET,NYA,DET05,5,6,11
DET201208080,2012,120808,DET,NYA,DET05,12,8,20
DET201208090,2012,120809,DET,NYA,DET05,4,3,7
DET201208170,2012,120817,DET,BAL,DET05,3,5,8
DET201208180,2012,120818,DET,BAL,DET05,3,2,5
DET201208190,2012,120819,DET,BAL,DET05,7,5,12
DET201208210,2012,120821,DET,TOR,DET05,3,5,8
DET201208220,2012,120822,DET,TOR,DET05,2,3,5
DET201208230,2012,120823,DET,TOR,DET05,2,3,5
DET201208240,2012,120824,DET,ANA,DET05,2,1,3
DET201208250,2012,120825,DET,ANA,DET05,3,5,8
DET201208260,2012,120826,DET,ANA,DET05,2,5,7
DET201208310,2012,120831,DET,CHA,DET05,4,7,11
DET201209010,2012,120901,DET,CHA,DET05,1,5,6
DET201209020,2012,120902,DET,CHA,DET05,2,4,6
DET201209030,2012,120903,DET,CLE,DET05,3,2,5
DET201209040,2012,120904,DET,CLE,DET05,3,2,5
DET201209050,2012,120905,DET,CLE,DET05,1,7,8
DET201209180,2012,120918,DET,OAK,DET05,2,12,14
DET201209190,2012,120919,DET,OAK,DET05,2,6,8
DET201209200,2012,120920,DET,OAK,DET05,12,4,16
DET201209220,2012,120922,DET,MIN,DET05,0,8,8
DET201209231,2012,120923,DET,MIN,DET05,10,4,14
DET201209232,2012,120923,DET,MIN,DET05,2,1,3
DET201209240,2012,120924,DET,KCA,DET05,2,6,8
DET201209250,2012,120925,DET,KCA,DET05,0,2,2
DET201209260,2012,120926,DET,KCA,DET05,4,5,9
DET201209270,2012,120927,DET,KCA,DET05,4,5,9
DET201210060,2012,121006,DET,OAK,DET05,1,3,4
DET201210070,2012,121007,DET,OAK,DET05,4,5,9
DET201210160,2012,121016,DET,NYA,DET05,1,2,3
DET201210180,2012,121018,DET,NYA,DET05,1,8,9
DET201210270,2012,121027,DET,SFN,DET05,2,0,2
DET201210280,2012,121028,DET,SFN,DET05,4,3,7
DET201304050,2013,20130405,DET,NYA,DET05,3,8,11
DET201304060,2013,20130406,DET,NYA,DET05,4,8,12
DET201304070,2013,20130407,DET,NYA,DET05,7,0,7
DET201304090,2013,20130409,DET,TOR,DET05,3,7,10
DET201304100,2013,20130410,DET,TOR,DET05,8,6,14
DET201304110,2013,20130411,DET,TOR,DET05,1,11,12
DET201304240,2013,20130424,DET,KCA,DET05,5,7,12
DET201304250,2013,20130425,DET,KCA,DET05,8,3,11
DET201304260,2013,20130426,DET,ATL,DET05,0,10,10
DET201304270,2013,20130427,DET,ATL,DET05,4,7,11
DET201304280,2013,20130428,DET,ATL,DET05,3,8,11
DET201304290,2013,20130429,DET,MIN,DET05,3,4,7
DET201304300,2013,20130430,DET,MIN,DET05,1,6,7
DET201305010,2013,20130501,DET,MIN,DET05,6,2,8
DET201305100,2013,20130510,DET,CLE,DET05,4,10,14
DET201305110,2013,20130511,DET,CLE,DET05,7,6,13
DET201305120,2013,20130512,DET,CLE,DET05,4,3,7
DET201305130,2013,20130513,DET,HOU,DET05,2,7,9
DET201305140,2013,20130514,DET,HOU,DET05,2,6,8
DET201305150,2013,20130515,DET,HOU,DET05,7,5,12
DET201305230,2013,20130523,DET,MIN,DET05,6,7,13
DET201305240,2013,20130524,DET,MIN,DET05,0,6,6
DET201305250,2013,20130525,DET,MIN,DET05,3,2,5
DET201305260,2013,20130526,DET,MIN,DET05,1,6,7
DET201305270,2013,20130527,DET,PIT,DET05,5,6,11
DET201305280,2013,20130528,DET,PIT,DET05,1,0,1
DET201306040,2013,20130604,DET,TBA,DET05,1,10,11
DET201306050,2013,20130605,DET,TBA,DET05,3,0,3
DET201306060,2013,20130606,DET,TBA,DET05,2,5,7
DET201306070,2013,20130607,DET,CLE,DET05,5,7,12
DET201306080,2013,20130608,DET,CLE,DET05,4,6,10
DET201306090,2013,20130609,DET,CLE,DET05,1,4,5
DET201306170,2013,20130617,DET,BAL,DET05,1,5,6
DET201306180,2013,20130618,DET,BAL,DET05,5,2,7
DET201306190,2013,20130619,DET,BAL,DET05,13,3,16
DET201306200,2013,20130620,DET,BOS,DET05,3,4,7
DET201306210,2013,20130621,DET,BOS,DET05,10,6,16
DET201306220,2013,20130622,DET,BOS,DET05,3,10,13
DET201306230,2013,20130623,DET,BOS,DET05,5,7,12
DET201306250,2013,20130625,DET,ANA,DET05,14,8,22
DET201306260,2013,20130626,DET,ANA,DET05,7,4,11
DET201306270,2013,20130627,DET,ANA,DET05,3,1,4
DET201307090,2013,20130709,DET,CHA,DET05,11,4,15
DET201307100,2013,20130710,DET,CHA,DET05,5,8,13
DET201307110,2013,20130711,DET,CHA,DET05,6,3,9
DET201307120,2013,20130712,DET,TEX,DET05,2,7,9
DET201307130,2013,20130713,DET,TEX,DET05,7,1,8
DET201307140,2013,20130714,DET,TEX,DET05,0,5,5
DET201307260,2013,20130726,DET,PHI,DET05,1,2,3
DET201307270,2013,20130727,DET,PHI,DET05,0,10,10
DET201307280,2013,20130728,DET,PHI,DET05,4,12,16
DET201307300,2013,20130730,DET,WAS,DET05,1,5,6
DET201307310,2013,20130731,DET,WAS,DET05,1,11,12
DET201308020,2013,20130802,DET,CHA,DET05,1,2,3
DET201308030,2013,20130803,DET,CHA,DET05,0,3,3
DET201308040,2013,20130804,DET,CHA,DET05,2,3,5
DET201308150,2013,20130815,DET,KCA,DET05,1,4,5
DET201308161,2013,20130816,DET,KCA,DET05,2,1,3
DET201308162,2013,20130816,DET,KCA,DET05,3,0,3
DET201308170,2013,20130817,DET,KCA,DET05,5,6,11
DET201308180,2013,20130818,DET,KCA,DET05,3,6,9
DET201308200,2013,20130820,DET,MIN,DET05,6,3,9
DET201308210,2013,20130821,DET,MIN,DET05,1,7,8
DET201308220,2013,20130822,DET,MIN,DET05,7,6,13
DET201308260,2013,20130826,DET,OAK,DET05,8,6,14
DET201308270,2013,20130827,DET,OAK,DET05,6,3,9
DET201308280,2013,20130828,DET,OAK,DET05,14,4,18
DET201308290,2013,20130829,DET,OAK,DET05,6,7,13
DET201308300,2013,20130830,DET,CLE,DET05,2,7,9
DET201308310,2013,20130831,DET,CLE,DET05,5,10,15
DET201309010,2013,20130901,DET,CLE,DET05,4,0,4
DET201309130,2013,20130913,DET,KCA,DET05,3,6,9
DET201309140,2013,20130914,DET,KCA,DET05,1,0,1
DET201309150,2013,20130915,DET,KCA,DET05,2,3,5
DET201309160,2013,20130916,DET,SEA,DET05,2,4,6
DET201309170,2013,20130917,DET,SEA,DET05,2,6,8
DET201309180,2013,20130918,DET,SEA,DET05,8,0,8
DET201309190,2013,20130919,DET,SEA,DET05,4,5,9
DET201309200,2013,20130920,DET,CHA,DET05,5,12,17
DET201309210,2013,20130921,DET,CHA,DET05,6,7,13
DET201309220,2013,20130922,DET,CHA,DET05,6,3,9
DET201310070,2013,20131007,DET,OAK,DET05,6,3,9
DET201310080,2013,20131008,DET,OAK,DET05,6,8,14
DET201310150,2013,20131015,DET,BOS,DET05,1,0,1
DET201310160,2013,20131016,DET,BOS,DET05,3,7,10
DET201310170,2013,20131017,DET,BOS,DET05,4,3,7
FLO201004090,2010,100409,FLO,LAN,MIA01,7,3,10
FLO201004100,2010,100410,FLO,LAN,MIA01,6,7,13
FLO201004110,2010,100411,FLO,LAN,MIA01,5,6,11
FLO201004120,2010,100412,FLO,CIN,MIA01,6,5,11
FLO201004130,2010,100413,FLO,CIN,MIA01,10,8,18
FLO201004140,2010,100414,FLO,CIN,MIA01,3,5,8
FLO201004150,2010,100415,FLO,CIN,MIA01,2,10,12
FLO201004260,2010,100426,FLO,SDN,MIA01,1,10,11
FLO201004270,2010,100427,FLO,SDN,MIA01,4,1,5
FLO201004280,2010,100428,FLO,SDN,MIA01,6,4,10
FLO201004300,2010,100430,FLO,WAS,MIA01,7,1,8
FLO201005010,2010,100501,FLO,WAS,MIA01,1,7,8
FLO201005020,2010,100502,FLO,WAS,MIA01,3,9,12
FLO201005040,2010,100504,FLO,SFN,MIA01,9,6,15
FLO201005050,2010,100505,FLO,SFN,MIA01,3,2,5
FLO201005060,2010,100506,FLO,SFN,MIA01,6,3,9
FLO201005130,2010,100513,FLO,NYN,MIA01,1,2,3
FLO201005140,2010,100514,FLO,NYN,MIA01,2,7,9
FLO201005150,2010,100515,FLO,NYN,MIA01,5,7,12
FLO201005160,2010,100516,FLO,NYN,MIA01,8,10,18
FLO201005170,2010,100517,FLO,ARI,MIA01,5,1,6
FLO201005180,2010,100518,FLO,ARI,MIA01,0,8,8
FLO201005250,2010,100525,FLO,ATL,MIA01,4,6,10
FLO201005260,2010,100526,FLO,ATL,MIA01,7,3,10
FLO201005270,2010,100527,FLO,ATL,MIA01,8,3,11
FLO201005280,2010,100528,FLO,PHI,MIA01,3,2,5
FLO201005290,2010,100529,FLO,PHI,MIA01,1,0,1
FLO201005300,2010,100530,FLO,PHI,MIA01,0,1,1
FLO201005310,2010,100531,FLO,MIL,MIA01,5,13,18
FLO201006010,2010,100601,FLO,MIL,MIA01,4,6,10
FLO201006020,2010,100602,FLO,MIL,MIA01,7,4,11
FLO201006030,2010,100603,FLO,MIL,MIA01,2,3,5
FLO201006150,2010,100615,FLO,TEX,MIA01,3,2,5
FLO201006160,2010,100616,FLO,TEX,MIA01,6,3,9
FLO201006170,2010,100617,FLO,TEX,MIA01,6,4,10
FLO201006180,2010,100618,FLO,TBA,MIA01,4,7,11
FLO201006190,2010,100619,FLO,TBA,MIA01,9,8,17
FLO201006200,2010,100620,FLO,TBA,MIA01,1,4,5
FLO201006250,2010,100625,FLO,SDN,MIA01,3,0,3
FLO201006260,2010,100626,FLO,SDN,MIA01,2,1,3
FLO201006270,2010,100627,FLO,SDN,MIA01,4,2,6
FLO201006280,2010,100628,FLO,NYN,SJU01,3,10,13
FLO201006290,2010,100629,FLO,NYN,SJU01,6,7,13
FLO201006300,2010,100630,FLO,NYN,SJU01,6,5,11
FLO201007160,2010,100716,FLO,WAS,MIA01,4,0,4
FLO201007170,2010,100717,FLO,WAS,MIA01,0,2,2
FLO201007180,2010,100718,FLO,WAS,MIA01,0,1,1
FLO201007190,2010,100719,FLO,COL,MIA01,8,9,17
FLO201007200,2010,100720,FLO,COL,MIA01,10,0,10
FLO201007210,2010,100721,FLO,COL,MIA01,2,5,7
FLO201007220,2010,100722,FLO,COL,MIA01,2,3,5
FLO201007230,2010,100723,FLO,ATL,MIA01,6,7,13
FLO201007240,2010,100724,FLO,ATL,MIA01,10,5,15
FLO201007250,2010,100725,FLO,ATL,MIA01,4,5,9
FLO201008030,2010,100803,FLO,PHI,MIA01,6,1,7
FLO201008040,2010,100804,FLO,PHI,MIA01,7,2,9
FLO201008050,2010,100805,FLO,PHI,MIA01,5,4,9
FLO201008060,2010,100806,FLO,SLN,MIA01,7,0,7
FLO201008070,2010,100807,FLO,SLN,MIA01,4,5,9
FLO201008200,2010,100820,FLO,HOU,MIA01,0,9,9
FLO201008210,2010,100821,FLO,HOU,MIA01,3,6,9
FLO201008220,2010,100822,FLO,HOU,MIA01,2,1,3
FLO201008300,2010,100830,FLO,WAS,MIA01,9,3,12
FLO201008310,2010,100831,FLO,WAS,MIA01,0,1,1
FLO201009010,2010,100901,FLO,WAS,MIA01,10,16,26
FLO201009030,2010,100903,FLO,ATL,MIA01,1,6,7
FLO201009040,2010,100904,FLO,ATL,MIA01,2,0,2
FLO201009050,2010,100905,FLO,ATL,MIA01,6,7,13
FLO201009130,2010,100913,FLO,PHI,MIA01,11,4,15
FLO201009140,2010,100914,FLO,PHI,MIA01,2,1,3
FLO201009150,2010,100915,FLO,PHI,MIA01,10,5,15
FLO201009170,2010,100917,FLO,CHN,MIA01,2,0,2
FLO201009180,2010,100918,FLO,CHN,MIA01,5,3,8
FLO201009190,2010,100919,FLO,CHN,MIA01,13,3,16
FLO201009200,2010,100920,FLO,SLN,MIA01,0,4,4
FLO201009210,2010,100921,FLO,NYN,MIA01,2,5,7
FLO201009220,2010,100922,FLO,NYN,MIA01,5,7,12
FLO201009300,2010,100930,FLO,PIT,MIA01,9,11,20
FLO201010010,2010,101001,FLO,PIT,MIA01,5,1,6
FLO201010020,2010,101002,FLO,PIT,MIA01,0,2,2
FLO201010030,2010,101003,FLO,PIT,MIA01,2,5,7
FLO201104010,2011,20110401,FLO,NYN,MIA01,2,6,8
FLO201104020,2011,20110402,FLO,NYN,MIA01,6,4,10
FLO201104030,2011,20110403,FLO,NYN,MIA01,9,2,11
FLO201104050,2011,20110405,FLO,WAS,MIA01,2,3,5
FLO201104060,2011,20110406,FLO,WAS,MIA01,4,7,11
FLO201104070,2011,20110407,FLO,WAS,MIA01,5,3,8
FLO201104190,2011,20110419,FLO,PIT,MIA01,0,6,6
FLO201104200,2011,20110420,FLO,PIT,MIA01,0,6,6
FLO201104210,2011,20110421,FLO,PIT,MIA01,5,9,14
FLO201104220,2011,20110422,FLO,COL,MIA01,1,4,5
FLO201104230,2011,20110423,FLO,COL,MIA01,3,1,4
FLO201104240,2011,20110424,FLO,COL,MIA01,3,6,9
FLO201104250,2011,20110425,FLO,LAN,MIA01,4,5,9
FLO201104260,2011,20110426,FLO,LAN,MIA01,2,4,6
FLO201104270,2011,20110427,FLO,LAN,MIA01,5,4,9
FLO201105060,2011,20110506,FLO,WAS,MIA01,3,2,5
FLO201105070,2011,20110507,FLO,WAS,MIA01,5,2,7
FLO201105080,2011,20110508,FLO,WAS,MIA01,0,8,8
FLO201105090,2011,20110509,FLO,PHI,MIA01,6,4,10
FLO201105100,2011,20110510,FLO,PHI,MIA01,1,2,3
FLO201105110,2011,20110511,FLO,PHI,MIA01,5,3,8
FLO201105180,2011,20110518,FLO,CHN,MIA01,7,5,12
FLO201105190,2011,20110519,FLO,CHN,MIA01,5,1,6
FLO201105200,2011,20110520,FLO,TBA,MIA01,3,5,8
FLO201105210,2011,20110521,FLO,TBA,MIA01,3,5,8
FLO201105220,2011,20110522,FLO,TBA,MIA01,4,0,4
FLO201106030,2011,20110603,FLO,MIL,MIA01,6,5,11
FLO201106040,2011,20110604,FLO,MIL,MIA01,3,2,5
FLO201106050,2011,20110605,FLO,MIL,MIA01,6,5,11
FLO201106060,2011,20110606,FLO,MIL,MIA01,7,2,9
FLO201106070,2011,20110607,FLO,ATL,MIA01,1,0,1
FLO201106080,2011,20110608,FLO,ATL,MIA01,3,2,5
FLO201106090,2011,20110609,FLO,ATL,MIA01,3,2,5
FLO201106100,2011,20110610,FLO,ARI,MIA01,4,6,10
FLO201106110,2011,20110611,FLO,ARI,MIA01,9,5,14
FLO201106120,2011,20110612,FLO,ARI,MIA01,5,1,6
FLO201106130,2011,20110613,FLO,ARI,MIA01,12,9,21
FLO201106200,2011,20110620,FLO,ANA,MIA01,2,1,3
FLO201106210,2011,20110621,FLO,ANA,MIA01,2,5,7
FLO201106220,2011,20110622,FLO,ANA,MIA01,6,5,11
FLO201106240,2011,20110624,FLO,SEA,SEA03,5,1,6
FLO201106250,2011,20110625,FLO,SEA,SEA03,2,4,6
FLO201106260,2011,20110626,FLO,SEA,SEA03,2,1,3
FLO201107040,2011,20110704,FLO,PHI,MIA01,1,0,1
FLO201107050,2011,20110705,FLO,PHI,MIA01,14,2,16
FLO201107060,2011,20110706,FLO,PHI,MIA01,6,7,13
FLO201107070,2011,20110707,FLO,HOU,MIA01,0,5,5
FLO201107080,2011,20110708,FLO,HOU,MIA01,3,6,9
FLO201107090,2011,20110709,FLO,HOU,MIA01,1,6,7
FLO201107100,2011,20110710,FLO,HOU,MIA01,4,5,9
FLO201107190,2011,20110719,FLO,SDN,MIA01,4,0,4
FLO201107200,2011,20110720,FLO,SDN,MIA01,14,3,17
FLO201107210,2011,20110721,FLO,SDN,MIA01,5,3,8
FLO201107220,2011,20110722,FLO,NYN,MIA01,7,6,13
FLO201107230,2011,20110723,FLO,NYN,MIA01,5,8,13
FLO201107240,2011,20110724,FLO,NYN,MIA01,4,5,9
FLO201108040,2011,20110804,FLO,SLN,MIA01,7,4,11
FLO201108050,2011,20110805,FLO,SLN,MIA01,3,2,5
FLO201108060,2011,20110806,FLO,SLN,MIA01,2,1,3
FLO201108070,2011,20110807,FLO,SLN,MIA01,8,4,12
FLO201108080,2011,20110808,FLO,ATL,MIA01,8,5,13
FLO201108090,2011,20110809,FLO,ATL,MIA01,4,3,7
FLO201108100,2011,20110810,FLO,ATL,MIA01,6,2,8
FLO201108120,2011,20110812,FLO,SFN,MIA01,1,2,3
FLO201108130,2011,20110813,FLO,SFN,MIA01,3,0,3
FLO201108140,2011,20110814,FLO,SFN,MIA01,5,2,7
FLO201108230,2011,20110823,FLO,CIN,MIA01,8,6,14
FLO201108241,2011,20110824,FLO,CIN,MIA01,5,6,11
FLO201108242,2011,20110824,FLO,CIN,MIA01,3,2,5
FLO201109020,2011,20110902,FLO,PHI,MIA01,5,3,8
FLO201109030,2011,20110903,FLO,PHI,MIA01,4,8,12
FLO201109040,2011,20110904,FLO,PHI,MIA01,4,5,9
FLO201109050,2011,20110905,FLO,NYN,MIA01,3,9,12
FLO201109060,2011,20110906,FLO,NYN,MIA01,7,4,11
FLO201109070,2011,20110907,FLO,NYN,MIA01,1,0,1
FLO201109190,2011,20110919,FLO,ATL,MIA01,5,6,11
FLO201109200,2011,20110920,FLO,ATL,MIA01,4,0,4
FLO201109210,2011,20110921,FLO,ATL,MIA01,0,4,4
FLO201109260,2011,20110926,FLO,WAS,MIA01,6,4,10
FLO201109270,2011,20110927,FLO,WAS,MIA01,2,3,5
FLO201109280,2011,20110928,FLO,WAS,MIA01,3,1,4
HOU201004050,2010,100405,HOU,SFN,HOU03,5,2,7
HOU201004060,2010,100406,HOU,SFN,HOU03,3,0,3
HOU201004070,2010,100407,HOU,SFN,HOU03,10,4,14
HOU201004090,2010,100409,HOU,PHI,HOU03,8,0,8
HOU201004100,2010,100410,HOU,PHI,HOU03,9,6,15
HOU201004110,2010,100411,HOU,PHI,HOU03,2,1,3
HOU201004200,2010,100420,HOU,FLO,HOU03,5,7,12
HOU201004210,2010,100421,HOU,FLO,HOU03,4,5,9
HOU201004220,2010,100422,HOU,FLO,HOU03,5,1,6
HOU201004230,2010,100423,HOU,PIT,HOU03,3,4,7
HOU201004240,2010,100424,HOU,PIT,HOU03,2,5,7
HOU201004250,2010,100425,HOU,PIT,HOU03,3,10,13
HOU201004270,2010,100427,HOU,CIN,HOU03,6,2,8
HOU201004280,2010,100428,HOU,CIN,HOU03,6,4,10
HOU201004290,2010,100429,HOU,CIN,HOU03,4,2,6
HOU201005030,2010,100503,HOU,ARI,HOU03,9,1,10
HOU201005040,2010,100504,HOU,ARI,HOU03,1,0,1
HOU201005050,2010,100505,HOU,ARI,HOU03,2,4,6
HOU201005060,2010,100506,HOU,ARI,HOU03,6,3,9
HOU201005070,2010,100507,HOU,SDN,HOU03,7,0,7
HOU201005080,2010,100508,HOU,SDN,HOU03,2,1,3
HOU201005090,2010,100509,HOU,SDN,HOU03,3,4,7
HOU201005190,2010,100519,HOU,COL,HOU03,3,7,10
HOU201005200,2010,100520,HOU,COL,HOU03,4,0,4
HOU201005210,2010,100521,HOU,TBA,HOU03,1,2,3
HOU201005220,2010,100522,HOU,TBA,HOU03,4,2,6
HOU201005230,2010,100523,HOU,TBA,HOU03,10,6,16
HOU201005310,2010,100531,HOU,WAS,HOU03,14,4,18
HOU201006010,2010,100601,HOU,WAS,HOU03,7,8,15
HOU201006020,2010,100602,HOU,WAS,HOU03,1,5,6
HOU201006030,2010,100603,HOU,WAS,HOU03,4,6,10
HOU201006040,2010,100604,HOU,CHN,HOU03,1,3,4
HOU201006050,2010,100605,HOU,CHN,HOU03,8,5,13
HOU201006060,2010,100606,HOU,CHN,HOU03,3,6,9
HOU201006180,2010,100618,HOU,TEX,HOU03,9,3,12
HOU201006190,2010,100619,HOU,TEX,HOU03,5,1,6
HOU201006200,2010,100620,HOU,TEX,HOU03,5,4,9
HOU201006220,2010,100622,HOU,SFN,HOU03,3,1,4
HOU201006230,2010,100623,HOU,SFN,HOU03,3,6,9
HOU201006240,2010,100624,HOU,SFN,HOU03,5,7,12
HOU201007060,2010,100706,HOU,PIT,HOU03,2,6,8
HOU201007070,2010,100707,HOU,PIT,HOU03,3,6,9
HOU201007080,2010,100708,HOU,PIT,HOU03,0,2,2
HOU201007090,2010,100709,HOU,SLN,HOU03,8,0,8
HOU201007100,2010,100710,HOU,SLN,HOU03,1,4,5
HOU201007110,2010,100711,HOU,SLN,HOU03,4,2,6
HOU201007230,2010,100723,HOU,CIN,HOU03,6,4,10
HOU201007240,2010,100724,HOU,CIN,HOU03,7,0,7
HOU201007250,2010,100725,HOU,CIN,HOU03,0,4,4
HOU201007260,2010,100726,HOU,CHN,HOU03,5,2,7
HOU201007270,2010,100727,HOU,CHN,HOU03,1,6,7
HOU201007280,2010,100728,HOU,CHN,HOU03,1,8,9
HOU201007300,2010,100730,HOU,MIL,HOU03,0,5,5
HOU201007310,2010,100731,HOU,MIL,HOU03,0,6,6
HOU201008010,2010,100801,HOU,MIL,HOU03,2,5,7
HOU201008090,2010,100809,HOU,ATL,HOU03,4,10,14
HOU201008100,2010,100810,HOU,ATL,HOU03,4,2,6
HOU201008110,2010,100811,HOU,ATL,HOU03,8,2,10
HOU201008130,2010,100813,HOU,PIT,HOU03,1,4,5
HOU201008140,2010,100814,HOU,PIT,HOU03,2,3,5
HOU201008150,2010,100815,HOU,PIT,HOU03,2,8,10
HOU201008160,2010,100816,HOU,NYN,HOU03,3,1,4
HOU201008170,2010,100817,HOU,NYN,HOU03,3,4,7
HOU201008180,2010,100818,HOU,NYN,HOU03,3,2,5
HOU201008190,2010,100819,HOU,NYN,HOU03,2,3,5
HOU201008300,2010,100830,HOU,SLN,HOU03,0,3,3
HOU201008310,2010,100831,HOU,SLN,HOU03,0,3,3
HOU201009010,2010,100901,HOU,SLN,HOU03,2,5,7
HOU201009090,2010,100909,HOU,LAN,HOU03,2,3,5
HOU201009100,2010,100910,HOU,LAN,HOU03,4,2,6
HOU201009110,2010,100911,HOU,LAN,HOU03,6,3,9
HOU201009120,2010,100912,HOU,LAN,HOU03,4,7,11
HOU201009130,2010,100913,HOU,MIL,HOU03,2,4,6
HOU201009140,2010,100914,HOU,MIL,HOU03,2,3,5
HOU201009150,2010,100915,HOU,MIL,HOU03,8,6,14
HOU201009170,2010,100917,HOU,CIN,HOU03,3,5,8
HOU201009180,2010,100918,HOU,CIN,HOU03,11,1,12
HOU201009190,2010,100919,HOU,CIN,HOU03,3,4,7
HOU201010010,2010,101001,HOU,CHN,HOU03,2,0,2
HOU201010020,2010,101002,HOU,CHN,HOU03,8,3,11
HOU201010030,2010,101003,HOU,CHN,HOU03,0,4,4
HOU201104080,2011,20110408,HOU,FLO,HOU03,4,3,7
HOU201104090,2011,20110409,HOU,FLO,HOU03,7,5,12
HOU201104100,2011,20110410,HOU,FLO,HOU03,1,7,8
HOU201104110,2011,20110411,HOU,CHN,HOU03,5,4,9
HOU201104120,2011,20110412,HOU,CHN,HOU03,2,11,13
HOU201104130,2011,20110413,HOU,CHN,HOU03,9,5,14
HOU201104140,2011,20110414,HOU,SDN,HOU03,0,1,1
HOU201104150,2011,20110415,HOU,SDN,HOU03,4,2,6
HOU201104160,2011,20110416,HOU,SDN,HOU03,3,5,8
HOU201104170,2011,20110417,HOU,SDN,HOU03,8,6,14
HOU201104260,2011,20110426,HOU,SLN,HOU03,5,6,11
HOU201104270,2011,20110427,HOU,SLN,HOU03,6,5,11
HOU201104280,2011,20110428,HOU,SLN,HOU03,11,7,18
HOU201104290,2011,20110429,HOU,MIL,HOU03,5,0,5
HOU201104300,2011,20110430,HOU,MIL,HOU03,1,2,3
HOU201105010,2011,20110501,HOU,MIL,HOU03,0,5,5
HOU201105090,2011,20110509,HOU,CIN,HOU03,6,1,7
HOU201105100,2011,20110510,HOU,CIN,HOU03,7,3,10
HOU201105110,2011,20110511,HOU,CIN,HOU03,3,4,7
HOU201105130,2011,20110513,HOU,NYN,HOU03,6,4,10
HOU201105140,2011,20110514,HOU,NYN,HOU03,3,7,10
HOU201105150,2011,20110515,HOU,NYN,HOU03,7,4,11
HOU201105230,2011,20110523,HOU,LAN,HOU03,3,4,7
HOU201105240,2011,20110524,HOU,LAN,HOU03,5,4,9
HOU201105250,2011,20110525,HOU,LAN,HOU03,1,2,3
HOU201105270,2011,20110527,HOU,ARI,HOU03,7,6,13
HOU201105280,2011,20110528,HOU,ARI,HOU03,11,3,14
HOU201105290,2011,20110529,HOU,ARI,HOU03,4,2,6
HOU201106070,2011,20110607,HOU,SLN,HOU03,7,4,11
HOU201106080,2011,20110608,HOU,SLN,HOU03,1,4,5
HOU201106090,2011,20110609,HOU,SLN,HOU03,9,2,11
HOU201106100,2011,20110610,HOU,ATL,HOU03,11,4,15
HOU201106110,2011,20110611,HOU,ATL,HOU03,6,3,9
HOU201106120,2011,20110612,HOU,ATL,HOU03,4,1,5
HOU201106130,2011,20110613,HOU,ATL,HOU03,3,8,11
HOU201106140,2011,20110614,HOU,PIT,HOU03,1,0,1
HOU201106150,2011,20110615,HOU,PIT,HOU03,7,3,10
HOU201106160,2011,20110616,HOU,PIT,HOU03,5,4,9
HOU201106240,2011,20110624,HOU,TBA,HOU03,5,1,6
HOU201106250,2011,20110625,HOU,TBA,HOU03,7,2,9
HOU201106260,2011,20110626,HOU,TBA,HOU03,14,10,24
HOU201106280,2011,20110628,HOU,TEX,HOU03,7,3,10
HOU201106290,2011,20110629,HOU,TEX,HOU03,3,2,5
HOU201106300,2011,20110630,HOU,TEX,HOU03,0,7,7
HOU201107010,2011,20110701,HOU,BOS,HOU03,7,5,12
HOU201107020,2011,20110702,HOU,BOS,HOU03,10,4,14
HOU201107030,2011,20110703,HOU,BOS,HOU03,2,1,3
HOU201107150,2011,20110715,HOU,PIT,HOU03,4,0,4
HOU201107160,2011,20110716,HOU,PIT,HOU03,4,6,10
HOU201107170,2011,20110717,HOU,PIT,HOU03,7,5,12
HOU201107180,2011,20110718,HOU,WAS,HOU03,5,2,7
HOU201107190,2011,20110719,HOU,WAS,HOU03,6,7,13
HOU201107200,2011,20110720,HOU,WAS,HOU03,2,3,5
HOU201108010,2011,20110801,HOU,CIN,HOU03,3,4,7
HOU201108020,2011,20110802,HOU,CIN,HOU03,5,1,6
HOU201108030,2011,20110803,HOU,CIN,HOU03,4,5,9
HOU201108050,2011,20110805,HOU,MIL,HOU03,8,1,9
HOU201108060,2011,20110806,HOU,MIL,HOU03,7,5,12
HOU201108070,2011,20110807,HOU,MIL,HOU03,7,3,10
HOU201108150,2011,20110815,HOU,CHN,HOU03,4,3,7
HOU201108160,2011,20110816,HOU,CHN,HOU03,5,6,11
HOU201108170,2011,20110817,HOU,CHN,HOU03,3,4,7
HOU201108190,2011,20110819,HOU,SFN,HOU03,0,6,6
HOU201108200,2011,20110820,HOU,SFN,HOU03,5,7,12
HOU201108210,2011,20110821,HOU,SFN,HOU03,6,4,10
HOU201108290,2011,20110829,HOU,PIT,HOU03,4,7,11
HOU201108300,2011,20110830,HOU,PIT,HOU03,2,8,10
HOU201108310,2011,20110831,HOU,PIT,HOU03,0,2,2
HOU201109020,2011,20110902,HOU,MIL,HOU03,8,2,10
HOU201109030,2011,20110903,HOU,MIL,HOU03,8,2,10
HOU201109040,2011,20110904,HOU,MIL,HOU03,4,0,4
HOU201109120,2011,20110912,HOU,PHI,HOU03,1,5,6
HOU201109130,2011,20110913,HOU,PHI,HOU03,2,5,7
HOU201109140,2011,20110914,HOU,PHI,HOU03,1,0,1
HOU201109220,2011,20110922,HOU,COL,HOU03,6,9,15
HOU201109230,2011,20110923,HOU,COL,HOU03,2,11,13
HOU201109240,2011,20110924,HOU,COL,HOU03,4,2,6
HOU201109250,2011,20110925,HOU,COL,HOU03,19,3,22
HOU201109260,2011,20110926,HOU,SLN,HOU03,4,5,9
HOU201109270,2011,20110927,HOU,SLN,HOU03,13,6,19
HOU201109280,2011,20110928,HOU,SLN,HOU03,8,0,8
HOU201204060,2012,120406,HOU,COL,HOU03,5,3,8
HOU201204070,2012,120407,HOU,COL,HOU03,3,7,10
HOU201204080,2012,120408,HOU,COL,HOU03,2,3,5
HOU201204090,2012,120409,HOU,ATL,HOU03,3,8,11
HOU201204100,2012,120410,HOU,ATL,HOU03,6,4,10
HOU201204110,2012,120411,HOU,ATL,HOU03,6,3,9
HOU201204200,2012,120420,HOU,LAN,HOU03,3,1,4
HOU201204210,2012,120421,HOU,LAN,HOU03,5,1,6
HOU201204220,2012,120422,HOU,LAN,HOU03,0,12,12
HOU201204300,2012,120430,HOU,NYN,HOU03,3,4,7
HOU201205010,2012,120501,HOU,NYN,HOU03,3,6,9
HOU201205020,2012,120502,HOU,NYN,HOU03,1,8,9
HOU201205040,2012,120504,HOU,SLN,HOU03,4,5,9
HOU201205050,2012,120505,HOU,SLN,HOU03,2,8,10
HOU201205060,2012,120506,HOU,SLN,HOU03,8,1,9
HOU201205070,2012,120507,HOU,MIA,HOU03,4,0,4
HOU201205080,2012,120508,HOU,MIA,HOU03,2,3,5
HOU201205090,2012,120509,HOU,MIA,HOU03,5,3,8
HOU201205160,2012,120516,HOU,MIL,HOU03,3,8,11
HOU201205170,2012,120517,HOU,MIL,HOU03,0,4,4
HOU201205180,2012,120518,HOU,TEX,HOU03,4,1,5
HOU201205190,2012,120519,HOU,TEX,HOU03,5,6,11
HOU201205200,2012,120520,HOU,TEX,HOU03,6,1,7
HOU201205210,2012,120521,HOU,CHN,HOU03,4,8,12
HOU201205220,2012,120522,HOU,CHN,HOU03,1,2,3
HOU201205230,2012,120523,HOU,CHN,HOU03,1,5,6
HOU201206010,2012,120601,HOU,CIN,HOU03,4,1,5
HOU201206020,2012,120602,HOU,CIN,HOU03,12,9,21
HOU201206030,2012,120603,HOU,CIN,HOU03,3,5,8
HOU201206050,2012,120605,HOU,SLN,HOU03,8,9,17
HOU201206060,2012,120606,HOU,SLN,HOU03,4,3,7
HOU201206070,2012,120607,HOU,SLN,HOU03,14,2,16
HOU201206180,2012,120618,HOU,KCA,HOU03,7,9,16
HOU201206190,2012,120619,HOU,KCA,HOU03,2,0,2
HOU201206200,2012,120620,HOU,KCA,HOU03,2,1,3
HOU201206220,2012,120622,HOU,CLE,HOU03,2,0,2
HOU201206230,2012,120623,HOU,CLE,HOU03,1,8,9
HOU201206240,2012,120624,HOU,CLE,HOU03,1,7,8
HOU201206250,2012,120625,HOU,SDN,HOU03,8,7,15
HOU201206260,2012,120626,HOU,SDN,HOU03,3,5,8
HOU201206270,2012,120627,HOU,SDN,HOU03,0,1,1
HOU201206280,2012,120628,HOU,SDN,HOU03,7,3,10
HOU201207060,2012,120706,HOU,MIL,HOU03,7,1,8
HOU201207070,2012,120707,HOU,MIL,HOU03,3,6,9
HOU201207080,2012,120708,HOU,MIL,HOU03,5,3,8
HOU201207230,2012,120723,HOU,CIN,HOU03,8,3,11
HOU201207240,2012,120724,HOU,CIN,HOU03,4,2,6
HOU201207250,2012,120725,HOU,CIN,HOU03,5,3,8
HOU201207260,2012,120726,HOU,PIT,HOU03,5,3,8
HOU201207270,2012,120727,HOU,PIT,HOU03,6,5,11
HOU201207280,2012,120728,HOU,PIT,HOU03,4,3,7
HOU201207290,2012,120729,HOU,PIT,HOU03,5,9,14
HOU201208060,2012,120806,HOU,WAS,HOU03,5,4,9
HOU201208070,2012,120807,HOU,WAS,HOU03,3,2,5
HOU201208080,2012,120808,HOU,WAS,HOU03,4,3,7
HOU201208090,2012,120809,HOU,WAS,HOU03,5,0,5
HOU201208100,2012,120810,HOU,MIL,HOU03,3,4,7
HOU201208110,2012,120811,HOU,MIL,HOU03,5,6,11
HOU201208120,2012,120812,HOU,MIL,HOU03,5,3,8
HOU201208170,2012,120817,HOU,ARI,HOU03,3,1,4
HOU201208180,2012,120818,HOU,ARI,HOU03,12,4,16
HOU201208190,2012,120819,HOU,ARI,HOU03,8,1,9
HOU201208280,2012,120828,HOU,SFN,HOU03,3,2,5
HOU201208290,2012,120829,HOU,SFN,HOU03,6,4,10
HOU201208300,2012,120830,HOU,SFN,HOU03,8,4,12
HOU201208310,2012,120831,HOU,CIN,HOU03,9,3,12
HOU201209010,2012,120901,HOU,CIN,HOU03,1,2,3
HOU201209020,2012,120902,HOU,CIN,HOU03,5,3,8
HOU201209100,2012,120910,HOU,CHN,HOU03,4,1,5
HOU201209110,2012,120911,HOU,CHN,HOU03,0,1,1
HOU201209120,2012,120912,HOU,CHN,HOU03,5,1,6
HOU201209130,2012,120913,HOU,PHI,HOU03,4,6,10
HOU201209140,2012,120914,HOU,PHI,HOU03,12,6,18
HOU201209150,2012,120915,HOU,PHI,HOU03,0,5,5
HOU201209160,2012,120916,HOU,PHI,HOU03,6,7,13
HOU201209210,2012,120921,HOU,PIT,HOU03,1,7,8
HOU201209220,2012,120922,HOU,PIT,HOU03,1,4,5
HOU201209230,2012,120923,HOU,PIT,HOU03,8,1,9
HOU201209240,2012,120924,HOU,SLN,HOU03,6,1,7
HOU201209250,2012,120925,HOU,SLN,HOU03,4,0,4
HOU201209260,2012,120926,HOU,SLN,HOU03,0,2,2
HOU201303310,2013,20130331,HOU,TEX,HOU03,2,8,10
HOU201304020,2013,20130402,HOU,TEX,HOU03,7,0,7
HOU201304030,2013,20130403,HOU,TEX,HOU03,4,0,4
HOU201304050,2013,20130405,HOU,OAK,HOU03,8,3,11
HOU201304060,2013,20130406,HOU,OAK,HOU03,6,3,9
HOU201304070,2013,20130407,HOU,OAK,HOU03,9,3,12
HOU201304190,2013,20130419,HOU,CLE,HOU03,2,3,5
HOU201304200,2013,20130420,HOU,CLE,HOU03,19,6,25
HOU201304210,2013,20130421,HOU,CLE,HOU03,5,4,9
HOU201304220,2013,20130422,HOU,SEA,HOU03,7,1,8
HOU201304230,2013,20130423,HOU,SEA,HOU03,2,3,5
HOU201304240,2013,20130424,HOU,SEA,HOU03,3,10,13
HOU201305020,2013,20130502,HOU,DET,HOU03,7,3,10
HOU201305030,2013,20130503,HOU,DET,HOU03,4,3,7
HOU201305040,2013,20130504,HOU,DET,HOU03,17,2,19
HOU201305050,2013,20130505,HOU,DET,HOU03,9,0,9
HOU201305070,2013,20130507,HOU,ANA,HOU03,6,7,13
HOU201305080,2013,20130508,HOU,ANA,HOU03,1,3,4
HOU201305090,2013,20130509,HOU,ANA,HOU03,6,5,11
HOU201305100,2013,20130510,HOU,TEX,HOU03,4,2,6
HOU201305110,2013,20130511,HOU,TEX,HOU03,8,7,15
HOU201305120,2013,20130512,HOU,TEX,HOU03,12,7,19
HOU201305200,2013,20130520,HOU,KCA,HOU03,5,6,11
HOU201305210,2013,20130521,HOU,KCA,HOU03,7,3,10
HOU201305220,2013,20130522,HOU,KCA,HOU03,1,3,4
HOU201305240,2013,20130524,HOU,OAK,HOU03,6,5,11
HOU201305250,2013,20130525,HOU,OAK,HOU03,11,5,16
HOU201305260,2013,20130526,HOU,OAK,HOU03,6,2,8
HOU201305270,2013,20130527,HOU,COL,HOU03,2,3,5
HOU201305280,2013,20130528,HOU,COL,HOU03,2,1,3
HOU201306040,2013,20130604,HOU,BAL,HOU03,4,1,5
HOU201306050,2013,20130605,HOU,BAL,HOU03,7,11,18
HOU201306060,2013,20130606,HOU,BAL,HOU03,3,1,4
HOU201306140,2013,20130614,HOU,CHA,HOU03,1,2,3
HOU201306150,2013,20130615,HOU,CHA,HOU03,3,4,7
HOU201306160,2013,20130616,HOU,CHA,HOU03,4,5,9
HOU201306170,2013,20130617,HOU,CHA,HOU03,4,2,6
HOU201306180,2013,20130618,HOU,MIL,HOU03,1,10,11
HOU201306190,2013,20130619,HOU,MIL,HOU03,3,1,4
HOU201306200,2013,20130620,HOU,MIL,HOU03,4,7,11
HOU201306250,2013,20130625,HOU,SLN,HOU03,13,5,18
HOU201306260,2013,20130626,HOU,SLN,HOU03,3,4,7
HOU201306280,2013,20130628,HOU,ANA,HOU03,4,2,6
HOU201306290,2013,20130629,HOU,ANA,HOU03,7,2,9
HOU201306300,2013,20130630,HOU,ANA,HOU03,3,1,4
HOU201307010,2013,20130701,HOU,TBA,HOU03,12,0,12
HOU201307020,2013,20130702,HOU,TBA,HOU03,8,0,8
HOU201307030,2013,20130703,HOU,TBA,HOU03,1,4,5
HOU201307040,2013,20130704,HOU,TBA,HOU03,7,5,12
HOU201307190,2013,20130719,HOU,SEA,HOU03,10,7,17
HOU201307200,2013,20130720,HOU,SEA,HOU03,4,2,6
HOU201307210,2013,20130721,HOU,SEA,HOU03,12,5,17
HOU201307220,2013,20130722,HOU,OAK,HOU03,4,3,7
HOU201307230,2013,20130723,HOU,OAK,HOU03,4,5,9
HOU201307240,2013,20130724,HOU,OAK,HOU03,4,3,7
HOU201308050,2013,20130805,HOU,BOS,HOU03,0,2,2
HOU201308060,2013,20130806,HOU,BOS,HOU03,15,10,25
HOU201308070,2013,20130807,HOU,BOS,HOU03,7,5,12
HOU201308090,2013,20130809,HOU,TEX,HOU03,9,5,14
HOU201308100,2013,20130810,HOU,TEX,HOU03,5,4,9
HOU201308110,2013,20130811,HOU,TEX,HOU03,6,1,7
HOU201308120,2013,20130812,HOU,TEX,HOU03,2,1,3
HOU201308230,2013,20130823,HOU,TOR,HOU03,4,12,16
HOU201308240,2013,20130824,HOU,TOR,HOU03,5,8,13
HOU201308250,2013,20130825,HOU,TOR,HOU03,2,1,3
HOU201308290,2013,20130829,HOU,SEA,HOU03,3,2,5
HOU201308300,2013,20130830,HOU,SEA,HOU03,7,1,8
HOU201308310,2013,20130831,HOU,SEA,HOU03,3,1,4
HOU201309010,2013,20130901,HOU,SEA,HOU03,0,2,2
HOU201309020,2013,20130902,HOU,MIN,HOU03,10,6,16
HOU201309030,2013,20130903,HOU,MIN,HOU03,9,6,15
HOU201309040,2013,20130904,HOU,MIN,HOU03,5,6,11
HOU201309130,2013,20130913,HOU,ANA,HOU03,7,9,16
HOU201309140,2013,20130914,HOU,ANA,HOU03,6,2,8
HOU201309150,2013,20130915,HOU,ANA,HOU03,2,1,3
HOU201309160,2013,20130916,HOU,CIN,HOU03,6,1,7
HOU201309170,2013,20130917,HOU,CIN,HOU03,10,0,10
HOU201309180,2013,20130918,HOU,CIN,HOU03,6,5,11
HOU201309270,2013,20130927,HOU,NYA,HOU03,3,2,5
HOU201309280,2013,20130928,HOU,NYA,HOU03,2,1,3
HOU201309290,2013,20130929,HOU,NYA,HOU03,5,1,6
KCA201004050,2010,100405,KCA,DET,KAN06,8,4,12
KCA201004070,2010,100407,KCA,DET,KAN06,2,3,5
KCA201004080,2010,100408,KCA,DET,KAN06,7,3,10
KCA201004090,2010,100409,KCA,BOS,KAN06,3,4,7
KCA201004100,2010,100410,KCA,BOS,KAN06,8,3,11
KCA201004110,2010,100411,KCA,BOS,KAN06,8,6,14
KCA201004230,2010,100423,KCA,MIN,KAN06,8,3,11
KCA201004240,2010,100424,KCA,MIN,KAN06,9,7,16
KCA201004250,2010,100425,KCA,MIN,KAN06,3,4,7
KCA201004260,2010,100426,KCA,SEA,KAN06,1,3,4
KCA201004270,2010,100427,KCA,SEA,KAN06,3,2,5
KCA201004280,2010,100428,KCA,SEA,KAN06,6,5,11
KCA201005110,2010,100511,KCA,CLE,KAN06,8,2,10
KCA201005120,2010,100512,KCA,CLE,KAN06,4,0,4
KCA201005130,2010,100513,KCA,CLE,KAN06,4,6,10
KCA201005140,2010,100514,KCA,CHA,KAN06,1,6,7
KCA201005150,2010,100515,KCA,CHA,KAN06,5,4,9
KCA201005160,2010,100516,KCA,CHA,KAN06,3,5,8
KCA201005210,2010,100521,KCA,COL,KAN06,2,9,11
KCA201005220,2010,100522,KCA,COL,KAN06,3,0,3
KCA201005230,2010,100523,KCA,COL,KAN06,11,7,18
KCA201005250,2010,100525,KCA,TEX,KAN06,8,7,15
KCA201005260,2010,100526,KCA,TEX,KAN06,2,5,7
KCA201005310,2010,100531,KCA,ANA,KAN06,7,1,8
KCA201006010,2010,100601,KCA,ANA,KAN06,3,6,9
KCA201006020,2010,100602,KCA,ANA,KAN06,7,2,9
KCA201006030,2010,100603,KCA,ANA,KAN06,5,4,9
KCA201006040,2010,100604,KCA,DET,KAN06,3,7,10
KCA201006050,2010,100605,KCA,DET,KAN06,4,2,6
KCA201006060,2010,100606,KCA,DET,KAN06,2,7,9
KCA201006150,2010,100615,KCA,HOU,KAN06,7,15,22
KCA201006160,2010,100616,KCA,HOU,KAN06,4,2,6
KCA201006170,2010,100617,KCA,HOU,KAN06,2,5,7
KCA201006250,2010,100625,KCA,SLN,KAN06,2,4,6
KCA201006260,2010,100626,KCA,SLN,KAN06,5,3,8
KCA201006270,2010,100627,KCA,SLN,KAN06,3,10,13
KCA201006280,2010,100628,KCA,CHA,KAN06,1,3,4
KCA201006290,2010,100629,KCA,CHA,KAN06,4,3,7
KCA201006300,2010,100630,KCA,CHA,KAN06,6,7,13
KCA201007160,2010,100716,KCA,OAK,KAN06,5,1,6
KCA201007170,2010,100717,KCA,OAK,KAN06,6,5,11
KCA201007180,2010,100718,KCA,OAK,KAN06,9,6,15
KCA201007190,2010,100719,KCA,TOR,KAN06,4,5,9
KCA201007200,2010,100720,KCA,TOR,KAN06,13,1,14
KCA201007210,2010,100721,KCA,TOR,KAN06,2,5,7
KCA201007260,2010,100726,KCA,MIN,KAN06,19,1,20
KCA201007270,2010,100727,KCA,MIN,KAN06,11,2,13
KCA201007280,2010,100728,KCA,MIN,KAN06,6,4,10
KCA201007290,2010,100729,KCA,BAL,KAN06,6,5,11
KCA201007300,2010,100730,KCA,BAL,KAN06,5,7,12
KCA201007310,2010,100731,KCA,BAL,KAN06,3,4,7
KCA201008010,2010,100801,KCA,BAL,KAN06,4,5,9
KCA201008120,2010,100812,KCA,NYA,KAN06,4,3,7
KCA201008130,2010,100813,KCA,NYA,KAN06,3,4,7
KCA201008140,2010,100814,KCA,NYA,KAN06,8,3,11
KCA201008150,2010,100815,KCA,NYA,KAN06,0,1,1
KCA201008170,2010,100817,KCA,CLE,KAN06,1,2,3
KCA201008180,2010,100818,KCA,CLE,KAN06,7,9,16
KCA201008190,2010,100819,KCA,CLE,KAN06,7,3,10
KCA201008211,2010,100821,KCA,CHA,KAN06,5,6,11
KCA201008212,2010,100821,KCA,CHA,KAN06,7,6,13
KCA201008220,2010,100822,KCA,CHA,KAN06,2,3,5
KCA201008300,2010,100830,KCA,TEX,KAN06,3,0,3
KCA201008310,2010,100831,KCA,TEX,KAN06,9,10,19
KCA201009010,2010,100901,KCA,TEX,KAN06,4,3,7
KCA201009030,2010,100903,KCA,DET,KAN06,9,5,14
KCA201009040,2010,100904,KCA,DET,KAN06,6,4,10
KCA201009050,2010,100905,KCA,DET,KAN06,1,2,3
KCA201009130,2010,100913,KCA,OAK,KAN06,3,1,4
KCA201009140,2010,100914,KCA,OAK,KAN06,3,11,14
KCA201009150,2010,100915,KCA,OAK,KAN06,3,6,9
KCA201009170,2010,100917,KCA,CLE,KAN06,11,4,15
KCA201009180,2010,100918,KCA,CLE,KAN06,6,4,10
KCA201009190,2010,100919,KCA,CLE,KAN06,4,6,10
KCA201009270,2010,100927,KCA,MIN,KAN06,8,10,18
KCA201009280,2010,100928,KCA,MIN,KAN06,1,10,11
KCA201009290,2010,100929,KCA,MIN,KAN06,4,2,6
KCA201009300,2010,100930,KCA,TBA,KAN06,2,3,5
KCA201010010,2010,101001,KCA,TBA,KAN06,0,7,7
KCA201010020,2010,101002,KCA,TBA,KAN06,4,0,4
KCA201010030,2010,101003,KCA,TBA,KAN06,3,2,5
KCA201103310,2011,20110331,KCA,ANA,KAN06,4,2,6
KCA201104010,2011,20110401,KCA,ANA,KAN06,1,2,3
KCA201104020,2011,20110402,KCA,ANA,KAN06,4,5,9
KCA201104030,2011,20110403,KCA,ANA,KAN06,9,12,21
KCA201104050,2011,20110405,KCA,CHA,KAN06,6,7,13
KCA201104060,2011,20110406,KCA,CHA,KAN06,10,7,17
KCA201104140,2011,20110414,KCA,SEA,KAN06,1,5,6
KCA201104150,2011,20110415,KCA,SEA,KAN06,5,6,11
KCA201104160,2011,20110416,KCA,SEA,KAN06,0,7,7
KCA201104170,2011,20110417,KCA,SEA,KAN06,3,2,5
KCA201104180,2011,20110418,KCA,CLE,KAN06,7,3,10
KCA201104190,2011,20110419,KCA,CLE,KAN06,4,5,9
KCA201104200,2011,20110420,KCA,CLE,KAN06,7,5,12
KCA201104210,2011,20110421,KCA,CLE,KAN06,2,3,5
KCA201104290,2011,20110429,KCA,MIN,KAN06,3,4,7
KCA201104300,2011,20110430,KCA,MIN,KAN06,2,11,13
KCA201105010,2011,20110501,KCA,MIN,KAN06,3,10,13
KCA201105030,2011,20110503,KCA,BAL,KAN06,5,6,11
KCA201105040,2011,20110504,KCA,BAL,KAN06,3,2,5
KCA201105050,2011,20110505,KCA,BAL,KAN06,1,9,10
KCA201105060,2011,20110506,KCA,OAK,KAN06,3,2,5
KCA201105070,2011,20110507,KCA,OAK,KAN06,3,4,7
KCA201105080,2011,20110508,KCA,OAK,KAN06,5,2,7
KCA201105160,2011,20110516,KCA,CLE,KAN06,19,1,20
KCA201105170,2011,20110517,KCA,CLE,KAN06,7,3,10
KCA201105180,2011,20110518,KCA,TEX,KAN06,5,4,9
KCA201105190,2011,20110519,KCA,TEX,KAN06,1,2,3
KCA201105200,2011,20110520,KCA,SLN,KAN06,0,3,3
KCA201105210,2011,20110521,KCA,SLN,KAN06,3,0,3
KCA201105220,2011,20110522,KCA,SLN,KAN06,9,8,17
KCA201105300,2011,20110530,KCA,ANA,KAN06,10,8,18
KCA201105310,2011,20110531,KCA,ANA,KAN06,3,7,10
KCA201106010,2011,20110601,KCA,ANA,KAN06,0,2,2
KCA201106020,2011,20110602,KCA,MIN,KAN06,8,2,10
KCA201106030,2011,20110603,KCA,MIN,KAN06,5,2,7
KCA201106040,2011,20110604,KCA,MIN,KAN06,7,2,9
KCA201106050,2011,20110605,KCA,MIN,KAN06,6,0,6
KCA201106060,2011,20110606,KCA,TOR,KAN06,2,3,5
KCA201106070,2011,20110607,KCA,TOR,KAN06,8,5,13
KCA201106080,2011,20110608,KCA,TOR,KAN06,9,8,17
KCA201106090,2011,20110609,KCA,TOR,KAN06,2,3,5
KCA201106210,2011,20110621,KCA,ARI,KAN06,7,2,9
KCA201106220,2011,20110622,KCA,ARI,KAN06,3,2,5
KCA201106230,2011,20110623,KCA,ARI,KAN06,5,3,8
KCA201106240,2011,20110624,KCA,CHN,KAN06,6,4,10
KCA201106250,2011,20110625,KCA,CHN,KAN06,2,3,5
KCA201106260,2011,20110626,KCA,CHN,KAN06,3,6,9
KCA201107070,2011,20110707,KCA,DET,KAN06,3,1,4
KCA201107080,2011,20110708,KCA,DET,KAN06,6,4,10
KCA201107090,2011,20110709,KCA,DET,KAN06,6,13,19
KCA201107100,2011,20110710,KCA,DET,KAN06,2,1,3
KCA201107180,2011,20110718,KCA,CHA,KAN06,5,2,7
KCA201107190,2011,20110719,KCA,CHA,KAN06,2,4,6
KCA201107200,2011,20110720,KCA,CHA,KAN06,1,2,3
KCA201107220,2011,20110722,KCA,TBA,KAN06,4,10,14
KCA201107230,2011,20110723,KCA,TBA,KAN06,4,5,9
KCA201107240,2011,20110724,KCA,TBA,KAN06,5,0,5
KCA201108020,2011,20110802,KCA,BAL,KAN06,8,2,10
KCA201108030,2011,20110803,KCA,BAL,KAN06,2,6,8
KCA201108040,2011,20110804,KCA,BAL,KAN06,4,9,13
KCA201108050,2011,20110805,KCA,DET,KAN06,4,3,7
KCA201108060,2011,20110806,KCA,DET,KAN06,4,3,7
KCA201108070,2011,20110807,KCA,DET,KAN06,3,4,7
KCA201108150,2011,20110815,KCA,NYA,KAN06,7,4,11
KCA201108160,2011,20110816,KCA,NYA,KAN06,9,7,16
KCA201108170,2011,20110817,KCA,NYA,KAN06,4,5,9
KCA201108180,2011,20110818,KCA,BOS,KAN06,4,3,7
KCA201108190,2011,20110819,KCA,BOS,KAN06,7,1,8
KCA201108200,2011,20110820,KCA,BOS,KAN06,4,9,13
KCA201108210,2011,20110821,KCA,BOS,KAN06,6,1,7
KCA201109020,2011,20110902,KCA,CLE,KAN06,5,4,9
KCA201109030,2011,20110903,KCA,CLE,KAN06,1,5,6
KCA201109040,2011,20110904,KCA,CLE,KAN06,9,6,15
KCA201109130,2011,20110913,KCA,MIN,KAN06,0,4,4
KCA201109140,2011,20110914,KCA,MIN,KAN06,3,7,10
KCA201109150,2011,20110915,KCA,CHA,KAN06,2,7,9
KCA201109160,2011,20110916,KCA,CHA,KAN06,6,7,13
KCA201109170,2011,20110917,KCA,CHA,KAN06,3,10,13
KCA201109180,2011,20110918,KCA,CHA,KAN06,10,5,15
KCA201109200,2011,20110920,KCA,DET,KAN06,2,10,12
KCA201109210,2011,20110921,KCA,DET,KAN06,6,3,9
KCA201204130,2012,120413,KCA,CLE,KAN06,8,3,11
KCA201204140,2012,120414,KCA,CLE,KAN06,11,9,20
KCA201204150,2012,120415,KCA,CLE,KAN06,13,7,20
KCA201204160,2012,120416,KCA,DET,KAN06,3,2,5
KCA201204170,2012,120417,KCA,DET,KAN06,3,1,4
KCA201204180,2012,120418,KCA,DET,KAN06,4,3,7
KCA201204200,2012,120420,KCA,TOR,KAN06,4,3,7
KCA201204210,2012,120421,KCA,TOR,KAN06,9,5,14
KCA201204220,2012,120422,KCA,TOR,KAN06,5,3,8
KCA201204230,2012,120423,KCA,TOR,KAN06,4,1,5
KCA201205030,2012,120503,KCA,NYA,KAN06,3,4,7
KCA201205040,2012,120504,KCA,NYA,KAN06,6,2,8
KCA201205050,2012,120505,KCA,NYA,KAN06,1,5,6
KCA201205060,2012,120506,KCA,NYA,KAN06,10,4,14
KCA201205070,2012,120507,KCA,BOS,KAN06,11,5,16
KCA201205080,2012,120508,KCA,BOS,KAN06,4,6,10
KCA201205090,2012,120509,KCA,BOS,KAN06,3,4,7
KCA201205160,2012,120516,KCA,BAL,KAN06,4,3,7
KCA201205170,2012,120517,KCA,BAL,KAN06,5,3,8
KCA201205180,2012,120518,KCA,ARI,KAN06,6,4,10
KCA201205190,2012,120519,KCA,ARI,KAN06,3,7,10
KCA201205200,2012,120520,KCA,ARI,KAN06,2,0,2
KCA201206010,2012,120601,KCA,OAK,KAN06,0,2,2
KCA201206020,2012,120602,KCA,OAK,KAN06,9,3,12
KCA201206030,2012,120603,KCA,OAK,KAN06,0,2,2
KCA201206040,2012,120604,KCA,MIN,KAN06,10,7,17
KCA201206050,2012,120605,KCA,MIN,KAN06,0,1,1
KCA201206060,2012,120606,KCA,MIN,KAN06,4,2,6
KCA201206120,2012,120612,KCA,MIL,KAN06,1,2,3
KCA201206130,2012,120613,KCA,MIL,KAN06,3,4,7
KCA201206140,2012,120614,KCA,MIL,KAN06,3,4,7
KCA201206220,2012,120622,KCA,SLN,KAN06,11,4,15
KCA201206230,2012,120623,KCA,SLN,KAN06,8,2,10
KCA201206240,2012,120624,KCA,SLN,KAN06,11,8,19
KCA201206250,2012,120625,KCA,TBA,KAN06,0,8,8
KCA201206260,2012,120626,KCA,TBA,KAN06,2,8,10
KCA201206270,2012,120627,KCA,TBA,KAN06,4,5,9
KCA201207130,2012,120713,KCA,CHA,KAN06,9,8,17
KCA201207140,2012,120714,KCA,CHA,KAN06,3,6,9
KCA201207150,2012,120715,KCA,CHA,KAN06,2,1,3
KCA201207160,2012,120716,KCA,SEA,KAN06,9,4,13
KCA201207170,2012,120717,KCA,SEA,KAN06,9,6,15
KCA201207180,2012,120718,KCA,SEA,KAN06,7,8,15
KCA201207190,2012,120719,KCA,SEA,KAN06,6,1,7
KCA201207200,2012,120720,KCA,MIN,KAN06,2,1,3
KCA201207210,2012,120721,KCA,MIN,KAN06,3,7,10
KCA201207220,2012,120722,KCA,MIN,KAN06,7,5,12
KCA201207310,2012,120731,KCA,CLE,KAN06,3,8,11
KCA201208010,2012,120801,KCA,CLE,KAN06,2,5,7
KCA201208020,2012,120802,KCA,CLE,KAN06,6,7,13
KCA201208030,2012,120803,KCA,TEX,KAN06,5,3,8
KCA201208040,2012,120804,KCA,TEX,KAN06,4,2,6
KCA201208050,2012,120805,KCA,TEX,KAN06,6,7,13
KCA201208140,2012,120814,KCA,OAK,KAN06,0,5,5
KCA201208150,2012,120815,KCA,OAK,KAN06,2,3,5
KCA201208160,2012,120816,KCA,OAK,KAN06,3,0,3
KCA201208170,2012,120817,KCA,CHA,KAN06,2,4,6
KCA201208180,2012,120818,KCA,CHA,KAN06,4,9,13
KCA201208190,2012,120819,KCA,CHA,KAN06,2,5,7
KCA201208280,2012,120828,KCA,DET,KAN06,8,9,17
KCA201208290,2012,120829,KCA,DET,KAN06,0,1,1
KCA201208300,2012,120830,KCA,DET,KAN06,1,2,3
KCA201209011,2012,120901,KCA,MIN,KAN06,3,1,4
KCA201209012,2012,120901,KCA,MIN,KAN06,8,7,15
KCA201209020,2012,120902,KCA,MIN,KAN06,4,6,10
KCA201209030,2012,120903,KCA,TEX,KAN06,8,4,12
KCA201209040,2012,120904,KCA,TEX,KAN06,3,6,9
KCA201209050,2012,120905,KCA,TEX,KAN06,7,6,13
KCA201209060,2012,120906,KCA,TEX,KAN06,5,4,9
KCA201209140,2012,120914,KCA,ANA,KAN06,9,7,16
KCA201209150,2012,120915,KCA,ANA,KAN06,2,3,5
KCA201209160,2012,120916,KCA,ANA,KAN06,4,3,7
KCA201209180,2012,120918,KCA,CHA,KAN06,3,2,5
KCA201209190,2012,120919,KCA,CHA,KAN06,0,3,3
KCA201209200,2012,120920,KCA,CHA,KAN06,3,4,7
KCA201209210,2012,120921,KCA,CLE,KAN06,3,6,9
KCA201209220,2012,120922,KCA,CLE,KAN06,3,5,8
KCA201209230,2012,120923,KCA,CLE,KAN06,15,4,19
KCA201210010,2012,121001,KCA,DET,KAN06,6,3,9
KCA201210020,2012,121002,KCA,DET,KAN06,2,4,6
KCA201210030,2012,121003,KCA,DET,KAN06,1,0,1
KCA201304080,2013,20130408,KCA,MIN,KAN06,1,3,4
KCA201304090,2013,20130409,KCA,MIN,KAN06,4,7,11
KCA201304100,2013,20130410,KCA,MIN,KAN06,0,3,3
KCA201304120,2013,20130412,KCA,TOR,KAN06,8,4,12
KCA201304130,2013,20130413,KCA,TOR,KAN06,3,2,5
KCA201304140,2013,20130414,KCA,TOR,KAN06,2,3,5
KCA201304270,2013,20130427,KCA,CLE,KAN06,2,3,5
KCA201304281,2013,20130428,KCA,CLE,KAN06,0,9,9
KCA201304282,2013,20130428,KCA,CLE,KAN06,10,3,13
KCA201304290,2013,20130429,KCA,CLE,KAN06,9,0,9
KCA201304300,2013,20130430,KCA,TBA,KAN06,2,8,10
KCA201305010,2013,20130501,KCA,TBA,KAN06,8,9,17
KCA201305040,2013,20130504,KCA,CHA,KAN06,0,2,2
KCA201305050,2013,20130505,KCA,CHA,KAN06,5,6,11
KCA201305060,2013,20130506,KCA,CHA,KAN06,2,1,3
KCA201305100,2013,20130510,KCA,NYA,KAN06,11,6,17
KCA201305110,2013,20130511,KCA,NYA,KAN06,3,2,5
KCA201305120,2013,20130512,KCA,NYA,KAN06,4,2,6
KCA201305230,2013,20130523,KCA,ANA,KAN06,5,4,9
KCA201305240,2013,20130524,KCA,ANA,KAN06,5,2,7
KCA201305250,2013,20130525,KCA,ANA,KAN06,7,0,7
KCA201305260,2013,20130526,KCA,ANA,KAN06,5,2,7
KCA201305270,2013,20130527,KCA,SLN,KAN06,6,3,9
KCA201305280,2013,20130528,KCA,SLN,KAN06,4,1,5
KCA201306040,2013,20130604,KCA,MIN,KAN06,3,0,3
KCA201306050,2013,20130605,KCA,MIN,KAN06,1,4,5
KCA201306060,2013,20130606,KCA,MIN,KAN06,3,7,10
KCA201306070,2013,20130607,KCA,HOU,KAN06,2,4,6
KCA201306080,2013,20130608,KCA,HOU,KAN06,2,7,9
KCA201306090,2013,20130609,KCA,HOU,KAN06,0,2,2
KCA201306100,2013,20130610,KCA,DET,KAN06,2,3,5
KCA201306110,2013,20130611,KCA,DET,KAN06,3,2,5
KCA201306120,2013,20130612,KCA,DET,KAN06,2,3,5
KCA201306210,2013,20130621,KCA,CHA,KAN06,9,1,10
KCA201306220,2013,20130622,KCA,CHA,KAN06,3,2,5
KCA201306230,2013,20130623,KCA,CHA,KAN06,6,7,13
KCA201306250,2013,20130625,KCA,ATL,KAN06,4,3,7
KCA201306260,2013,20130626,KCA,ATL,KAN06,3,4,7
KCA201307020,2013,20130702,KCA,CLE,KAN06,6,5,11
KCA201307030,2013,20130703,KCA,CLE,KAN06,5,6,11
KCA201307040,2013,20130704,KCA,CLE,KAN06,7,10,17
KCA201307050,2013,20130705,KCA,OAK,KAN06,6,3,9
KCA201307060,2013,20130706,KCA,OAK,KAN06,3,4,7
KCA201307070,2013,20130707,KCA,OAK,KAN06,10,4,14
KCA201307190,2013,20130719,KCA,DET,KAN06,0,1,1
KCA201307200,2013,20130720,KCA,DET,KAN06,5,6,11
KCA201307210,2013,20130721,KCA,DET,KAN06,4,1,5
KCA201307220,2013,20130722,KCA,BAL,KAN06,9,2,11
KCA201307230,2013,20130723,KCA,BAL,KAN06,2,3,5
KCA201307240,2013,20130724,KCA,BAL,KAN06,3,4,7
KCA201307250,2013,20130725,KCA,BAL,KAN06,1,7,8
KCA201308050,2013,20130805,KCA,MIN,KAN06,0,13,13
KCA201308060,2013,20130806,KCA,MIN,KAN06,7,0,7
KCA201308070,2013,20130807,KCA,MIN,KAN06,2,5,7
KCA201308080,2013,20130808,KCA,BOS,KAN06,1,5,6
KCA201308090,2013,20130809,KCA,BOS,KAN06,6,9,15
KCA201308100,2013,20130810,KCA,BOS,KAN06,5,3,8
KCA201308110,2013,20130811,KCA,BOS,KAN06,3,4,7
KCA201308120,2013,20130812,KCA,MIA,KAN06,2,6,8
KCA201308130,2013,20130813,KCA,MIA,KAN06,1,0,1
KCA201308140,2013,20130814,KCA,MIA,KAN06,5,2,7
KCA201308200,2013,20130820,KCA,CHA,KAN06,2,0,2
KCA201308210,2013,20130821,KCA,CHA,KAN06,5,2,7
KCA201308220,2013,20130822,KCA,CHA,KAN06,4,3,7
KCA201308230,2013,20130823,KCA,WAS,KAN06,11,10,21
KCA201308240,2013,20130824,KCA,WAS,KAN06,7,2,9
KCA201308250,2013,20130825,KCA,WAS,KAN06,4,6,10
KCA201308260,2013,20130826,KCA,TBA,KAN06,1,11,12
KCA201309020,2013,20130902,KCA,SEA,KAN06,1,3,4
KCA201309030,2013,20130903,KCA,SEA,KAN06,3,4,7
KCA201309040,2013,20130904,KCA,SEA,KAN06,6,4,10
KCA201309050,2013,20130905,KCA,SEA,KAN06,6,7,13
KCA201309060,2013,20130906,KCA,DET,KAN06,16,2,18
KCA201309070,2013,20130907,KCA,DET,KAN06,3,4,7
KCA201309080,2013,20130908,KCA,DET,KAN06,2,5,7
KCA201309160,2013,20130916,KCA,CLE,KAN06,1,7,8
KCA201309170,2013,20130917,KCA,CLE,KAN06,5,3,8
KCA201309180,2013,20130918,KCA,CLE,KAN06,2,7,9
KCA201309200,2013,20130920,KCA,TEX,KAN06,1,2,3
KCA201309210,2013,20130921,KCA,TEX,KAN06,3,1,4
KCA201309220,2013,20130922,KCA,TEX,KAN06,0,4,4
LAN201004130,2010,100413,LAN,ARI,LOS03,5,9,14
LAN201004140,2010,100414,LAN,ARI,LOS03,9,7,16
LAN201004150,2010,100415,LAN,ARI,LOS03,5,6,11
LAN201004160,2010,100416,LAN,SFN,LOS03,8,10,18
LAN201004170,2010,100417,LAN,SFN,LOS03,9,0,9
LAN201004180,2010,100418,LAN,SFN,LOS03,1,2,3
LAN201004290,2010,100429,LAN,PIT,LOS03,2,0,2
LAN201004300,2010,100430,LAN,PIT,LOS03,2,6,8
LAN201005010,2010,100501,LAN,PIT,LOS03,1,5,6
LAN201005020,2010,100502,LAN,PIT,LOS03,3,9,12
LAN201005040,2010,100504,LAN,MIL,LOS03,11,6,17
LAN201005050,2010,100505,LAN,MIL,LOS03,11,3,14
LAN201005060,2010,100506,LAN,MIL,LOS03,3,7,10
LAN201005070,2010,100507,LAN,COL,LOS03,5,6,11
LAN201005080,2010,100508,LAN,COL,LOS03,8,0,8
LAN201005090,2010,100509,LAN,COL,LOS03,0,2,2
LAN201005170,2010,100517,LAN,HOU,LOS03,2,6,8
LAN201005180,2010,100518,LAN,HOU,LOS03,3,7,10
LAN201005190,2010,100519,LAN,SDN,LOS03,10,5,15
LAN201005200,2010,100520,LAN,SDN,LOS03,1,4,5
LAN201005210,2010,100521,LAN,DET,LOS03,1,4,5
LAN201005220,2010,100522,LAN,DET,LOS03,4,6,10
LAN201005230,2010,100523,LAN,DET,LOS03,6,2,8
LAN201005310,2010,100531,LAN,ARI,LOS03,4,5,9
LAN201006010,2010,100601,LAN,ARI,LOS03,0,1,1
LAN201006020,2010,100602,LAN,ARI,LOS03,0,1,1
LAN201006030,2010,100603,LAN,ATL,LOS03,4,3,7
LAN201006040,2010,100604,LAN,ATL,LOS03,4,5,9
LAN201006050,2010,100605,LAN,ATL,LOS03,9,3,12
LAN201006060,2010,100606,LAN,ATL,LOS03,4,5,9
LAN201006070,2010,100607,LAN,SLN,LOS03,4,12,16
LAN201006080,2010,100608,LAN,SLN,LOS03,0,1,1
LAN201006090,2010,100609,LAN,SLN,LOS03,3,4,7
LAN201006110,2010,100611,LAN,ANA,LOS03,10,1,11
LAN201006120,2010,100612,LAN,ANA,LOS03,4,2,6
LAN201006130,2010,100613,LAN,ANA,LOS03,6,5,11
LAN201006250,2010,100625,LAN,NYA,LOS03,2,1,3
LAN201006260,2010,100626,LAN,NYA,LOS03,4,9,13
LAN201006270,2010,100627,LAN,NYA,LOS03,8,6,14
LAN201007050,2010,100705,LAN,FLO,LOS03,6,5,11
LAN201007060,2010,100706,LAN,FLO,LOS03,3,7,10
LAN201007070,2010,100707,LAN,FLO,LOS03,4,0,4
LAN201007080,2010,100708,LAN,CHN,LOS03,2,3,5
LAN201007090,2010,100709,LAN,CHN,LOS03,7,9,16
LAN201007100,2010,100710,LAN,CHN,LOS03,7,3,10
LAN201007110,2010,100711,LAN,CHN,LOS03,0,7,7
LAN201007190,2010,100719,LAN,SFN,LOS03,5,2,7
LAN201007200,2010,100720,LAN,SFN,LOS03,7,5,12
LAN201007210,2010,100721,LAN,SFN,LOS03,0,2,2
LAN201007220,2010,100722,LAN,NYN,LOS03,0,2,2
LAN201007230,2010,100723,LAN,NYN,LOS03,6,1,7
LAN201007240,2010,100724,LAN,NYN,LOS03,2,3,5
LAN201007250,2010,100725,LAN,NYN,LOS03,0,1,1
LAN201008020,2010,100802,LAN,SDN,LOS03,10,5,15
LAN201008030,2010,100803,LAN,SDN,LOS03,1,2,3
LAN201008040,2010,100804,LAN,SDN,LOS03,0,9,9
LAN201008050,2010,100805,LAN,SDN,LOS03,5,0,5
LAN201008060,2010,100806,LAN,WAS,LOS03,6,3,9
LAN201008070,2010,100807,LAN,WAS,LOS03,2,3,5
LAN201008080,2010,100808,LAN,WAS,LOS03,3,8,11
LAN201008170,2010,100817,LAN,COL,LOS03,0,6,6
LAN201008180,2010,100818,LAN,COL,LOS03,3,2,5
LAN201008190,2010,100819,LAN,COL,LOS03,0,2,2
LAN201008200,2010,100820,LAN,CIN,LOS03,3,1,4
LAN201008210,2010,100821,LAN,CIN,LOS03,5,8,13
LAN201008220,2010,100822,LAN,CIN,LOS03,5,2,7
LAN201008300,2010,100830,LAN,PHI,LOS03,0,3,3
LAN201008310,2010,100831,LAN,PHI,LOS03,8,4,12
LAN201009010,2010,100901,LAN,PHI,LOS03,5,1,6
LAN201009030,2010,100903,LAN,SFN,LOS03,2,4,6
LAN201009040,2010,100904,LAN,SFN,LOS03,5,4,9
LAN201009050,2010,100905,LAN,SFN,LOS03,3,0,3
LAN201009170,2010,100917,LAN,COL,LOS03,7,5,12
LAN201009180,2010,100918,LAN,COL,LOS03,12,2,14
LAN201009190,2010,100919,LAN,COL,LOS03,6,7,13
LAN201009210,2010,100921,LAN,SDN,LOS03,6,0,6
LAN201009220,2010,100922,LAN,SDN,LOS03,3,1,4
LAN201009230,2010,100923,LAN,SDN,LOS03,1,3,4
LAN201010010,2010,101001,LAN,ARI,LOS03,7,5,12
LAN201010020,2010,101002,LAN,ARI,LOS03,2,3,5
LAN201010030,2010,101003,LAN,ARI,LOS03,1,3,4
LAN201103310,2011,20110331,LAN,SFN,LOS03,1,2,3
LAN201104010,2011,20110401,LAN,SFN,LOS03,3,4,7
LAN201104020,2011,20110402,LAN,SFN,LOS03,10,0,10
LAN201104030,2011,20110403,LAN,SFN,LOS03,5,7,12
LAN201104140,2011,20110414,LAN,SLN,LOS03,9,5,14
LAN201104150,2011,20110415,LAN,SLN,LOS03,11,2,13
LAN201104160,2011,20110416,LAN,SLN,LOS03,9,2,11
LAN201104170,2011,20110417,LAN,SLN,LOS03,1,2,3
LAN201104180,2011,20110418,LAN,ATL,LOS03,2,4,6
LAN201104190,2011,20110419,LAN,ATL,LOS03,10,1,11
LAN201104200,2011,20110420,LAN,ATL,LOS03,1,6,7
LAN201104210,2011,20110421,LAN,ATL,LOS03,3,5,8
LAN201104290,2011,20110429,LAN,SDN,LOS03,2,3,5
LAN201104300,2011,20110430,LAN,SDN,LOS03,5,2,7
LAN201105010,2011,20110501,LAN,SDN,LOS03,7,0,7
LAN201105020,2011,20110502,LAN,CHN,LOS03,2,5,7
LAN201105030,2011,20110503,LAN,CHN,LOS03,4,1,5
LAN201105040,2011,20110504,LAN,CHN,LOS03,5,1,6
LAN201105130,2011,20110513,LAN,ARI,LOS03,3,4,7
LAN201105140,2011,20110514,LAN,ARI,LOS03,1,0,1
LAN201105150,2011,20110515,LAN,ARI,LOS03,4,1,5
LAN201105160,2011,20110516,LAN,MIL,LOS03,2,1,3
LAN201105170,2011,20110517,LAN,MIL,LOS03,0,3,3
LAN201105180,2011,20110518,LAN,SFN,LOS03,8,5,13
LAN201105190,2011,20110519,LAN,SFN,LOS03,3,1,4
LAN201105270,2011,20110527,LAN,FLO,LOS03,2,3,5
LAN201105280,2011,20110528,LAN,FLO,LOS03,6,1,7
LAN201105290,2011,20110529,LAN,FLO,LOS03,0,8,8
LAN201105300,2011,20110530,LAN,COL,LOS03,1,7,8
LAN201105310,2011,20110531,LAN,COL,LOS03,2,8,10
LAN201106010,2011,20110601,LAN,COL,LOS03,3,0,3
LAN201106130,2011,20110613,LAN,CIN,LOS03,6,4,10
LAN201106140,2011,20110614,LAN,CIN,LOS03,3,2,5
LAN201106150,2011,20110615,LAN,CIN,LOS03,7,2,9
LAN201106170,2011,20110617,LAN,HOU,LOS03,7,3,10
LAN201106180,2011,20110618,LAN,HOU,LOS03,7,0,7
LAN201106190,2011,20110619,LAN,HOU,LOS03,0,1,1
LAN201106200,2011,20110620,LAN,DET,LOS03,0,4,4
LAN201106210,2011,20110621,LAN,DET,LOS03,1,6,7
LAN201106220,2011,20110622,LAN,DET,LOS03,7,5,12
LAN201106240,2011,20110624,LAN,ANA,LOS03,8,3,11
LAN201106250,2011,20110625,LAN,ANA,LOS03,6,1,7
LAN201106260,2011,20110626,LAN,ANA,LOS03,2,3,5
LAN201107040,2011,20110704,LAN,NYN,LOS03,5,2,7
LAN201107050,2011,20110705,LAN,NYN,LOS03,6,0,6
LAN201107060,2011,20110706,LAN,NYN,LOS03,5,3,8
LAN201107070,2011,20110707,LAN,NYN,LOS03,0,6,6
LAN201107080,2011,20110708,LAN,SDN,LOS03,0,1,1
LAN201107090,2011,20110709,LAN,SDN,LOS03,0,1,1
LAN201107100,2011,20110710,LAN,SDN,LOS03,1,4,5
LAN201107220,2011,20110722,LAN,WAS,LOS03,7,2,9
LAN201107230,2011,20110723,LAN,WAS,LOS03,6,7,13
LAN201107240,2011,20110724,LAN,WAS,LOS03,1,3,4
LAN201107250,2011,20110725,LAN,COL,LOS03,5,8,13
LAN201107260,2011,20110726,LAN,COL,LOS03,2,3,5
LAN201107270,2011,20110727,LAN,COL,LOS03,3,1,4
LAN201107290,2011,20110729,LAN,ARI,LOS03,5,9,14
LAN201107300,2011,20110730,LAN,ARI,LOS03,6,4,10
LAN201107310,2011,20110731,LAN,ARI,LOS03,6,3,9
LAN201108080,2011,20110808,LAN,PHI,LOS03,5,3,8
LAN201108090,2011,20110809,LAN,PHI,LOS03,2,1,3
LAN201108100,2011,20110810,LAN,PHI,LOS03,9,8,17
LAN201108120,2011,20110812,LAN,HOU,LOS03,0,1,1
LAN201108130,2011,20110813,LAN,HOU,LOS03,1,6,7
LAN201108140,2011,20110814,LAN,HOU,LOS03,0,7,7
LAN201108260,2011,20110826,LAN,COL,LOS03,1,6,7
LAN201108270,2011,20110827,LAN,COL,LOS03,6,7,13
LAN201108280,2011,20110828,LAN,COL,LOS03,7,6,13
LAN201108290,2011,20110829,LAN,SDN,LOS03,1,4,5
LAN201108300,2011,20110830,LAN,SDN,LOS03,5,8,13
LAN201108310,2011,20110831,LAN,SDN,LOS03,2,4,6
LAN201109120,2011,20110912,LAN,ARI,LOS03,7,2,9
LAN201109130,2011,20110913,LAN,ARI,LOS03,5,4,9
LAN201109140,2011,20110914,LAN,ARI,LOS03,2,3,5
LAN201109150,2011,20110915,LAN,PIT,LOS03,6,2,8
LAN201109160,2011,20110916,LAN,PIT,LOS03,2,7,9
LAN201109170,2011,20110917,LAN,PIT,LOS03,1,6,7
LAN201109180,2011,20110918,LAN,PIT,LOS03,1,15,16
LAN201109200,2011,20110920,LAN,SFN,LOS03,1,2,3
LAN201109210,2011,20110921,LAN,SFN,LOS03,8,5,13
LAN201109220,2011,20110922,LAN,SFN,LOS03,2,8,10
LAN201204100,2012,120410,LAN,PIT,LOS03,1,2,3
LAN201204110,2012,120411,LAN,PIT,LOS03,1,4,5
LAN201204120,2012,120412,LAN,PIT,LOS03,2,3,5
LAN201204130,2012,120413,LAN,SDN,LOS03,8,9,17
LAN201204140,2012,120414,LAN,SDN,LOS03,1,6,7
LAN201204150,2012,120415,LAN,SDN,LOS03,4,5,9
LAN201204230,2012,120423,LAN,ATL,LOS03,2,7,9
LAN201204240,2012,120424,LAN,ATL,LOS03,4,3,7
LAN201204250,2012,120425,LAN,ATL,LOS03,4,2,6
LAN201204270,2012,120427,LAN,WAS,LOS03,2,3,5
LAN201204280,2012,120428,LAN,WAS,LOS03,3,4,7
LAN201204290,2012,120429,LAN,WAS,LOS03,0,2,2
LAN201205070,2012,120507,LAN,SFN,LOS03,1,9,10
LAN201205080,2012,120508,LAN,SFN,LOS03,2,1,3
LAN201205090,2012,120509,LAN,SFN,LOS03,2,6,8
LAN201205110,2012,120511,LAN,COL,LOS03,3,7,10
LAN201205120,2012,120512,LAN,COL,LOS03,1,2,3
LAN201205130,2012,120513,LAN,COL,LOS03,5,11,16
LAN201205140,2012,120514,LAN,ARI,LOS03,1,3,4
LAN201205150,2012,120515,LAN,ARI,LOS03,5,1,6
LAN201205180,2012,120518,LAN,SLN,LOS03,5,6,11
LAN201205190,2012,120519,LAN,SLN,LOS03,0,6,6
LAN201205200,2012,120520,LAN,SLN,LOS03,5,6,11
LAN201205250,2012,120525,LAN,HOU,LOS03,3,1,4
LAN201205260,2012,120526,LAN,HOU,LOS03,3,6,9
LAN201205270,2012,120527,LAN,HOU,LOS03,1,5,6
LAN201205280,2012,120528,LAN,MIL,LOS03,3,2,5
LAN201205290,2012,120529,LAN,MIL,LOS03,2,1,3
LAN201205300,2012,120530,LAN,MIL,LOS03,6,3,9
LAN201205310,2012,120531,LAN,MIL,LOS03,6,2,8
LAN201206110,2012,120611,LAN,ANA,LOS03,3,2,5
LAN201206120,2012,120612,LAN,ANA,LOS03,2,5,7
LAN201206130,2012,120613,LAN,ANA,LOS03,2,1,3
LAN201206150,2012,120615,LAN,CHA,LOS03,6,7,13
LAN201206160,2012,120616,LAN,CHA,LOS03,5,4,9
LAN201206170,2012,120617,LAN,CHA,LOS03,1,2,3
LAN201206280,2012,120628,LAN,NYN,LOS03,3,2,5
LAN201206290,2012,120629,LAN,NYN,LOS03,9,0,9
LAN201206300,2012,120630,LAN,NYN,LOS03,5,0,5
LAN201207010,2012,120701,LAN,NYN,LOS03,3,8,11
LAN201207020,2012,120702,LAN,CIN,LOS03,8,2,10
LAN201207030,2012,120703,LAN,CIN,LOS03,1,3,4
LAN201207040,2012,120704,LAN,CIN,LOS03,1,4,5
LAN201207130,2012,120713,LAN,SDN,LOS03,1,2,3
LAN201207140,2012,120714,LAN,SDN,LOS03,7,6,13
LAN201207150,2012,120715,LAN,SDN,LOS03,7,2,9
LAN201207160,2012,120716,LAN,PHI,LOS03,3,2,5
LAN201207170,2012,120717,LAN,PHI,LOS03,3,2,5
LAN201207180,2012,120718,LAN,PHI,LOS03,3,5,8
LAN201207300,2012,120730,LAN,ARI,LOS03,7,2,9
LAN201207310,2012,120731,LAN,ARI,LOS03,8,2,10
LAN201208010,2012,120801,LAN,ARI,LOS03,4,0,4
LAN201208030,2012,120803,LAN,CHN,LOS03,1,6,7
LAN201208040,2012,120804,LAN,CHN,LOS03,1,3,4
LAN201208050,2012,120805,LAN,CHN,LOS03,6,7,13
LAN201208060,2012,120806,LAN,COL,LOS03,2,0,2
LAN201208070,2012,120807,LAN,COL,LOS03,3,1,4
LAN201208080,2012,120808,LAN,COL,LOS03,4,6,10
LAN201208200,2012,120820,LAN,SFN,LOS03,2,1,3
LAN201208210,2012,120821,LAN,SFN,LOS03,4,1,5
LAN201208220,2012,120822,LAN,SFN,LOS03,8,4,12
LAN201208240,2012,120824,LAN,MIA,LOS03,4,11,15
LAN201208250,2012,120825,LAN,MIA,LOS03,2,8,10
LAN201208260,2012,120826,LAN,MIA,LOS03,6,2,8
LAN201208300,2012,120830,LAN,ARI,LOS03,2,0,2
LAN201208310,2012,120831,LAN,ARI,LOS03,4,3,7
LAN201209010,2012,120901,LAN,ARI,LOS03,1,2,3
LAN201209020,2012,120902,LAN,ARI,LOS03,4,5,9
LAN201209030,2012,120903,LAN,SDN,LOS03,3,4,7
LAN201209040,2012,120904,LAN,SDN,LOS03,6,3,9
LAN201209050,2012,120905,LAN,SDN,LOS03,4,3,7
LAN201209130,2012,120913,LAN,SLN,LOS03,2,1,3
LAN201209140,2012,120914,LAN,SLN,LOS03,5,8,13
LAN201209150,2012,120915,LAN,SLN,LOS03,3,4,7
LAN201209160,2012,120916,LAN,SLN,LOS03,5,2,7
LAN201209280,2012,120928,LAN,COL,LOS03,0,8,8
LAN201209290,2012,120929,LAN,COL,LOS03,0,3,3
LAN201209300,2012,120930,LAN,COL,LOS03,1,7,8
LAN201210010,2012,121001,LAN,SFN,LOS03,2,3,5
LAN201210020,2012,121002,LAN,SFN,LOS03,4,3,7
LAN201210030,2012,121003,LAN,SFN,LOS03,1,5,6
LAN201304010,2013,20130401,LAN,SFN,LOS03,0,4,4
LAN201304020,2013,20130402,LAN,SFN,LOS03,3,0,3
LAN201304030,2013,20130403,LAN,SFN,LOS03,5,3,8
LAN201304050,2013,20130405,LAN,PIT,LOS03,0,3,3
LAN201304060,2013,20130406,LAN,PIT,LOS03,0,1,1
LAN201304070,2013,20130407,LAN,PIT,LOS03,2,6,8
LAN201304150,2013,20130415,LAN,SDN,LOS03,6,3,9
LAN201304160,2013,20130416,LAN,SDN,LOS03,9,2,11
LAN201304170,2013,20130417,LAN,SDN,LOS03,7,2,9
LAN201304260,2013,20130426,LAN,MIL,LOS03,5,7,12
LAN201304270,2013,20130427,LAN,MIL,LOS03,6,4,10
LAN201304280,2013,20130428,LAN,MIL,LOS03,0,2,2
LAN201304290,2013,20130429,LAN,COL,LOS03,12,2,14
LAN201304300,2013,20130430,LAN,COL,LOS03,2,6,8
LAN201305010,2013,20130501,LAN,COL,LOS03,7,3,10
LAN201305060,2013,20130506,LAN,ARI,LOS03,9,2,11
LAN201305070,2013,20130507,LAN,ARI,LOS03,5,3,8
LAN201305080,2013,20130508,LAN,ARI,LOS03,3,2,5
LAN201305100,2013,20130510,LAN,MIA,LOS03,5,4,9
LAN201305110,2013,20130511,LAN,MIA,LOS03,1,7,8
LAN201305120,2013,20130512,LAN,MIA,LOS03,3,5,8
LAN201305130,2013,20130513,LAN,WAS,LOS03,6,2,8
LAN201305140,2013,20130514,LAN,WAS,LOS03,0,2,2
LAN201305150,2013,20130515,LAN,WAS,LOS03,1,3,4
LAN201305240,2013,20130524,LAN,SLN,LOS03,7,0,7
LAN201305250,2013,20130525,LAN,SLN,LOS03,3,5,8
LAN201305260,2013,20130526,LAN,SLN,LOS03,5,3,8
LAN201305270,2013,20130527,LAN,ANA,LOS03,7,8,15
LAN201305280,2013,20130528,LAN,ANA,LOS03,0,3,3
LAN201306030,2013,20130603,LAN,SDN,LOS03,1,2,3
LAN201306040,2013,20130604,LAN,SDN,LOS03,7,9,16
LAN201306050,2013,20130605,LAN,SDN,LOS03,6,2,8
LAN201306060,2013,20130606,LAN,ATL,LOS03,0,5,5
LAN201306070,2013,20130607,LAN,ATL,LOS03,1,2,3
LAN201306080,2013,20130608,LAN,ATL,LOS03,2,1,3
LAN201306090,2013,20130609,LAN,ATL,LOS03,8,1,9
LAN201306100,2013,20130610,LAN,ARI,LOS03,5,4,9
LAN201306110,2013,20130611,LAN,ARI,LOS03,3,5,8
LAN201306120,2013,20130612,LAN,ARI,LOS03,8,6,14
LAN201306240,2013,20130624,LAN,SFN,LOS03,1,3,4
LAN201306250,2013,20130625,LAN,SFN,LOS03,5,6,11
LAN201306260,2013,20130626,LAN,SFN,LOS03,2,4,6
LAN201306270,2013,20130627,LAN,PHI,LOS03,4,6,10
LAN201306280,2013,20130628,LAN,PHI,LOS03,16,1,17
LAN201306290,2013,20130629,LAN,PHI,LOS03,3,4,7
LAN201306300,2013,20130630,LAN,PHI,LOS03,1,6,7
LAN201307110,2013,20130711,LAN,COL,LOS03,1,6,7
LAN201307120,2013,20130712,LAN,COL,LOS03,3,0,3
LAN201307130,2013,20130713,LAN,COL,LOS03,0,1,1
LAN201307140,2013,20130714,LAN,COL,LOS03,3,1,4
LAN201307250,2013,20130725,LAN,CIN,LOS03,5,2,7
LAN201307260,2013,20130726,LAN,CIN,LOS03,1,2,3
LAN201307270,2013,20130727,LAN,CIN,LOS03,1,4,5
LAN201307280,2013,20130728,LAN,CIN,LOS03,0,1,1
LAN201307300,2013,20130730,LAN,NYA,LOS03,2,3,5
LAN201307310,2013,20130731,LAN,NYA,LOS03,3,0,3
LAN201308090,2013,20130809,LAN,TBA,LOS03,6,7,13
LAN201308100,2013,20130810,LAN,TBA,LOS03,0,5,5
LAN201308110,2013,20130811,LAN,TBA,LOS03,2,8,10
LAN201308120,2013,20130812,LAN,NYN,LOS03,2,4,6
LAN201308130,2013,20130813,LAN,NYN,LOS03,2,4,6
LAN201308140,2013,20130814,LAN,NYN,LOS03,4,5,9
LAN201308230,2013,20130823,LAN,BOS,LOS03,0,2,2
LAN201308240,2013,20130824,LAN,BOS,LOS03,4,2,6
LAN201308250,2013,20130825,LAN,BOS,LOS03,8,1,9
LAN201308260,2013,20130826,LAN,CHN,LOS03,2,6,8
LAN201308270,2013,20130827,LAN,CHN,LOS03,3,2,5
LAN201308280,2013,20130828,LAN,CHN,LOS03,0,4,4
LAN201308300,2013,20130830,LAN,SDN,LOS03,2,9,11
LAN201308310,2013,20130831,LAN,SDN,LOS03,1,2,3
LAN201309010,2013,20130901,LAN,SDN,LOS03,1,2,3
LAN201309090,2013,20130909,LAN,ARI,LOS03,1,8,9
LAN201309100,2013,20130910,LAN,ARI,LOS03,3,5,8
LAN201309110,2013,20130911,LAN,ARI,LOS03,4,1,5
LAN201309120,2013,20130912,LAN,SFN,LOS03,2,3,5
LAN201309130,2013,20130913,LAN,SFN,LOS03,4,2,6
LAN201309140,2013,20130914,LAN,SFN,LOS03,19,3,22
LAN201309150,2013,20130915,LAN,SFN,LOS03,4,3,7
LAN201309270,2013,20130927,LAN,COL,LOS03,0,11,11
LAN201309280,2013,20130928,LAN,COL,LOS03,1,0,1
LAN201309290,2013,20130929,LAN,COL,LOS03,2,1,3
LAN201310060,2013,20131006,LAN,ATL,LOS03,6,13,19
LAN201310070,2013,20131007,LAN,ATL,LOS03,3,4,7
LAN201310140,2013,20131014,LAN,SLN,LOS03,0,3,3
LAN201310150,2013,20131015,LAN,SLN,LOS03,4,2,6
LAN201310160,2013,20131016,LAN,SLN,LOS03,4,6,10
MIA201204040,2012,120404,MIA,SLN,MIA02,4,1,5
MIA201204130,2012,120413,MIA,HOU,MIA02,4,5,9
MIA201204140,2012,120414,MIA,HOU,MIA02,5,4,9
MIA201204150,2012,120415,MIA,HOU,MIA02,4,5,9
MIA201204170,2012,120417,MIA,CHN,MIA02,2,5,7
MIA201204180,2012,120418,MIA,CHN,MIA02,1,9,10
MIA201204190,2012,120419,MIA,CHN,MIA02,3,5,8
MIA201204270,2012,120427,MIA,ARI,MIA02,5,0,5
MIA201204280,2012,120428,MIA,ARI,MIA02,2,3,5
MIA201204290,2012,120429,MIA,ARI,MIA02,8,4,12
MIA201204300,2012,120430,MIA,ARI,MIA02,9,5,14
MIA201205110,2012,120511,MIA,NYN,MIA02,5,6,11
MIA201205120,2012,120512,MIA,NYN,MIA02,9,3,12
MIA201205130,2012,120513,MIA,NYN,MIA02,4,8,12
MIA201205140,2012,120514,MIA,PIT,MIA02,3,2,5
MIA201205150,2012,120515,MIA,PIT,MIA02,2,6,8
MIA201205210,2012,120521,MIA,COL,MIA02,4,7,11
MIA201205220,2012,120522,MIA,COL,MIA02,6,7,13
MIA201205230,2012,120523,MIA,COL,MIA02,8,4,12
MIA201205240,2012,120524,MIA,SFN,MIA02,14,7,21
MIA201205250,2012,120525,MIA,SFN,MIA02,6,7,13
MIA201205260,2012,120526,MIA,SFN,MIA02,3,5,8
MIA201205270,2012,120527,MIA,SFN,MIA02,3,2,5
MIA201205280,2012,120528,MIA,WAS,MIA02,3,5,8
MIA201205290,2012,120529,MIA,WAS,MIA02,1,3,4
MIA201205300,2012,120530,MIA,WAS,MIA02,3,5,8
MIA201206050,2012,120605,MIA,ATL,MIA02,11,0,11
MIA201206060,2012,120606,MIA,ATL,MIA02,2,1,3
MIA201206070,2012,120607,MIA,ATL,MIA02,8,2,10
MIA201206080,2012,120608,MIA,TBA,MIA02,5,1,6
MIA201206090,2012,120609,MIA,TBA,MIA02,13,4,17
MIA201206100,2012,120610,MIA,TBA,MIA02,4,2,6
MIA201206110,2012,120611,MIA,BOS,MIA02,1,4,5
MIA201206120,2012,120612,MIA,BOS,MIA02,2,1,3
MIA201206130,2012,120613,MIA,BOS,MIA02,10,2,12
MIA201206220,2012,120622,MIA,TOR,MIA02,12,5,17
MIA201206230,2012,120623,MIA,TOR,MIA02,7,1,8
MIA201206240,2012,120624,MIA,TOR,MIA02,0,9,9
MIA201206250,2012,120625,MIA,SLN,MIA02,8,7,15
MIA201206260,2012,120626,MIA,SLN,MIA02,5,2,7
MIA201206270,2012,120627,MIA,SLN,MIA02,3,5,8
MIA201206290,2012,120629,MIA,PHI,MIA02,2,6,8
MIA201206300,2012,120630,MIA,PHI,MIA02,2,3,5
MIA201207010,2012,120701,MIA,PHI,MIA02,2,5,7
MIA201207130,2012,120713,MIA,WAS,MIA02,5,1,6
MIA201207140,2012,120714,MIA,WAS,MIA02,1,2,3
MIA201207150,2012,120715,MIA,WAS,MIA02,4,0,4
MIA201207160,2012,120716,MIA,WAS,MIA02,3,5,8
MIA201207230,2012,120723,MIA,ATL,MIA02,1,2,3
MIA201207240,2012,120724,MIA,ATL,MIA02,4,3,7
MIA201207250,2012,120725,MIA,ATL,MIA02,7,1,8
MIA201207270,2012,120727,MIA,SDN,MIA02,7,2,9
MIA201207280,2012,120728,MIA,SDN,MIA02,2,4,6
MIA201207290,2012,120729,MIA,SDN,MIA02,4,5,9
MIA201208100,2012,120810,MIA,LAN,MIA02,5,2,7
MIA201208110,2012,120811,MIA,LAN,MIA02,3,7,10
MIA201208120,2012,120812,MIA,LAN,MIA02,5,0,5
MIA201208130,2012,120813,MIA,PHI,MIA02,4,0,4
MIA201208140,2012,120814,MIA,PHI,MIA02,1,0,1
MIA201208150,2012,120815,MIA,PHI,MIA02,2,9,11
MIA201208280,2012,120828,MIA,WAS,MIA02,0,9,9
MIA201208290,2012,120829,MIA,WAS,MIA02,8,4,12
MIA201208310,2012,120831,MIA,NYN,MIA02,3,0,3
MIA201209010,2012,120901,MIA,NYN,MIA02,5,3,8
MIA201209020,2012,120902,MIA,NYN,MIA02,5,1,6
MIA201209030,2012,120903,MIA,MIL,MIA02,3,7,10
MIA201209040,2012,120904,MIA,MIL,MIA02,8,4,12
MIA201209050,2012,120905,MIA,MIL,MIA02,8,5,13
MIA201209060,2012,120906,MIA,MIL,MIA02,2,6,8
MIA201209140,2012,120914,MIA,CIN,MIA02,0,4,4
MIA201209150,2012,120915,MIA,CIN,MIA02,4,6,10
MIA201209160,2012,120916,MIA,CIN,MIA02,5,4,9
MIA201209170,2012,120917,MIA,ATL,MIA02,7,5,12
MIA201209180,2012,120918,MIA,ATL,MIA02,3,4,7
MIA201209190,2012,120919,MIA,ATL,MIA02,3,0,3
MIA201209280,2012,120928,MIA,PHI,MIA02,1,2,3
MIA201209290,2012,120929,MIA,PHI,MIA02,9,5,14
MIA201209300,2012,120930,MIA,PHI,MIA02,4,1,5
MIA201210010,2012,121001,MIA,NYN,MIA02,2,3,5
MIA201210020,2012,121002,MIA,NYN,MIA02,3,4,7
MIA201210030,2012,121003,MIA,NYN,MIA02,4,2,6
MIA201304080,2013,20130408,MIA,ATL,MIA02,2,0,2
MIA201304090,2013,20130409,MIA,ATL,MIA02,3,2,5
MIA201304100,2013,20130410,MIA,ATL,MIA02,8,0,8
MIA201304120,2013,20130412,MIA,PHI,MIA02,3,1,4
MIA201304130,2013,20130413,MIA,PHI,MIA02,1,2,3
MIA201304140,2013,20130414,MIA,PHI,MIA02,2,1,3
MIA201304150,2013,20130415,MIA,WAS,MIA02,10,3,13
MIA201304160,2013,20130416,MIA,WAS,MIA02,2,8,10
MIA201304170,2013,20130417,MIA,WAS,MIA02,6,1,7
MIA201304250,2013,20130425,MIA,CHN,MIA02,4,3,7
MIA201304260,2013,20130426,MIA,CHN,MIA02,4,2,6
MIA201304270,2013,20130427,MIA,CHN,MIA02,3,2,5
MIA201304280,2013,20130428,MIA,CHN,MIA02,4,6,10
MIA201304290,2013,20130429,MIA,NYN,MIA02,3,4,7
MIA201304300,2013,20130430,MIA,NYN,MIA02,1,2,3
MIA201305010,2013,20130501,MIA,NYN,MIA02,7,6,13
MIA201305140,2013,20130514,MIA,CIN,MIA02,6,2,8
MIA201305150,2013,20130515,MIA,CIN,MIA02,4,0,4
MIA201305160,2013,20130516,MIA,CIN,MIA02,5,3,8
MIA201305170,2013,20130517,MIA,ARI,MIA02,9,2,11
MIA201305180,2013,20130518,MIA,ARI,MIA02,1,0,1
MIA201305190,2013,20130519,MIA,ARI,MIA02,1,2,3
MIA201305200,2013,20130520,MIA,PHI,MIA02,1,5,6
MIA201305210,2013,20130521,MIA,PHI,MIA02,7,3,10
MIA201305220,2013,20130522,MIA,PHI,MIA02,3,0,3
MIA201305290,2013,20130529,MIA,TBA,MIA02,3,1,4
MIA201305300,2013,20130530,MIA,TBA,MIA02,5,2,7
MIA201305310,2013,20130531,MIA,NYN,MIA02,1,5,6
MIA201306010,2013,20130601,MIA,NYN,MIA02,1,8,9
MIA201306020,2013,20130602,MIA,NYN,MIA02,6,11,17
MIA201306100,2013,20130610,MIA,MIL,MIA02,6,1,7
MIA201306110,2013,20130611,MIA,MIL,MIA02,4,5,9
MIA201306120,2013,20130612,MIA,MIL,MIA02,10,1,11
MIA201306140,2013,20130614,MIA,SLN,MIA02,4,5,9
MIA201306150,2013,20130615,MIA,SLN,MIA02,13,7,20
MIA201306160,2013,20130616,MIA,SLN,MIA02,2,7,9
MIA201306250,2013,20130625,MIA,MIN,MIA02,2,4,6
MIA201306260,2013,20130626,MIA,MIN,MIA02,3,5,8
MIA201306280,2013,20130628,MIA,SDN,MIA02,9,2,11
MIA201306290,2013,20130629,MIA,SDN,MIA02,1,7,8
MIA201306300,2013,20130630,MIA,SDN,MIA02,2,6,8
MIA201307010,2013,20130701,MIA,SDN,MIA02,0,4,4
MIA201307080,2013,20130708,MIA,ATL,MIA02,7,1,8
MIA201307090,2013,20130709,MIA,ATL,MIA02,6,4,10
MIA201307100,2013,20130710,MIA,ATL,MIA02,2,6,8
MIA201307120,2013,20130712,MIA,WAS,MIA02,3,8,11
MIA201307130,2013,20130713,MIA,WAS,MIA02,1,2,3
MIA201307140,2013,20130714,MIA,WAS,MIA02,5,2,7
MIA201307260,2013,20130726,MIA,PIT,MIA02,0,2,2
MIA201307270,2013,20130727,MIA,PIT,MIA02,7,4,11
MIA201307280,2013,20130728,MIA,PIT,MIA02,2,3,5
MIA201307290,2013,20130729,MIA,NYN,MIA02,6,5,11
MIA201307300,2013,20130730,MIA,NYN,MIA02,4,2,6
MIA201307310,2013,20130731,MIA,NYN,MIA02,2,3,5
MIA201308010,2013,20130801,MIA,NYN,MIA02,0,3,3
MIA201308020,2013,20130802,MIA,CLE,MIA02,0,10,10
MIA201308030,2013,20130803,MIA,CLE,MIA02,4,3,7
MIA201308040,2013,20130804,MIA,CLE,MIA02,2,0,2
MIA201308160,2013,20130816,MIA,SFN,MIA02,14,10,24
MIA201308170,2013,20130817,MIA,SFN,MIA02,6,4,10
MIA201308180,2013,20130818,MIA,SFN,MIA02,5,6,11
MIA201308190,2013,20130819,MIA,LAN,MIA02,2,6,8
MIA201308200,2013,20130820,MIA,LAN,MIA02,6,4,10
MIA201308210,2013,20130821,MIA,LAN,MIA02,4,1,5
MIA201308220,2013,20130822,MIA,LAN,MIA02,6,0,6
MIA201308230,2013,20130823,MIA,COL,MIA02,3,2,5
MIA201308240,2013,20130824,MIA,COL,MIA02,0,3,3
MIA201308250,2013,20130825,MIA,COL,MIA02,4,3,7
MIA201309060,2013,20130906,MIA,WAS,MIA02,0,7,7
MIA201309070,2013,20130907,MIA,WAS,MIA02,9,2,11
MIA201309080,2013,20130908,MIA,WAS,MIA02,6,4,10
MIA201309090,2013,20130909,MIA,ATL,MIA02,5,2,7
MIA201309100,2013,20130910,MIA,ATL,MIA02,4,3,7
MIA201309110,2013,20130911,MIA,ATL,MIA02,2,5,7
MIA201309120,2013,20130912,MIA,ATL,MIA02,6,1,7
MIA201309230,2013,20130923,MIA,PHI,MIA02,0,4,4
MIA201309240,2013,20130924,MIA,PHI,MIA02,2,1,3
MIA201309250,2013,20130925,MIA,PHI,MIA02,2,3,5
MIA201309270,2013,20130927,MIA,DET,MIA02,2,3,5
MIA201309280,2013,20130928,MIA,DET,MIA02,1,2,3
MIA201309290,2013,20130929,MIA,DET,MIA02,0,1,1
MIL201004050,2010,100405,MIL,COL,MIL06,5,3,8
MIL201004060,2010,100406,MIL,COL,MIL06,5,7,12
MIL201004070,2010,100407,MIL,COL,MIL06,4,5,9
MIL201004090,2010,100409,MIL,SLN,MIL06,5,4,9
MIL201004100,2010,100410,MIL,SLN,MIL06,7,1,8
MIL201004110,2010,100411,MIL,SLN,MIL06,7,8,15
MIL201004230,2010,100423,MIL,CHN,MIL06,8,1,9
MIL201004240,2010,100424,MIL,CHN,MIL06,5,1,6
MIL201004250,2010,100425,MIL,CHN,MIL06,12,2,14
MIL201004260,2010,100426,MIL,PIT,MIL06,3,17,20
MIL201004270,2010,100427,MIL,PIT,MIL06,7,3,10
MIL201004280,2010,100428,MIL,PIT,MIL06,6,5,11
MIL201005100,2010,100510,MIL,ATL,MIL06,8,2,10
MIL201005110,2010,100511,MIL,ATL,MIL06,11,3,14
MIL201005120,2010,100512,MIL,ATL,MIL06,9,2,11
MIL201005140,2010,100514,MIL,PHI,MIL06,9,5,14
MIL201005150,2010,100515,MIL,PHI,MIL06,10,6,16
MIL201005160,2010,100516,MIL,PHI,MIL06,4,2,6
MIL201005250,2010,100525,MIL,HOU,MIL06,1,6,7
MIL201005260,2010,100526,MIL,HOU,MIL06,5,0,5
MIL201005270,2010,100527,MIL,HOU,MIL06,3,4,7
MIL201005280,2010,100528,MIL,NYN,MIL06,0,2,2
MIL201005290,2010,100529,MIL,NYN,MIL06,6,8,14
MIL201005300,2010,100530,MIL,NYN,MIL06,10,4,14
MIL201006080,2010,100608,MIL,CHN,MIL06,2,3,5
MIL201006090,2010,100609,MIL,CHN,MIL06,9,4,13
MIL201006100,2010,100610,MIL,CHN,MIL06,4,5,9
MIL201006110,2010,100611,MIL,TEX,MIL06,2,6,8
MIL201006120,2010,100612,MIL,TEX,MIL06,4,3,7
MIL201006130,2010,100613,MIL,TEX,MIL06,7,2,9
MIL201006220,2010,100622,MIL,MIN,MIL06,5,7,12
MIL201006230,2010,100623,MIL,MIN,MIL06,3,5,8
MIL201006240,2010,100624,MIL,MIN,MIL06,0,5,5
MIL201006250,2010,100625,MIL,SEA,MIL06,3,8,11
MIL201006260,2010,100626,MIL,SEA,MIL06,5,4,9
MIL201006270,2010,100627,MIL,SEA,MIL06,0,3,3
MIL201006280,2010,100628,MIL,HOU,MIL06,9,5,14
MIL201006290,2010,100629,MIL,HOU,MIL06,5,7,12
MIL201006300,2010,100630,MIL,HOU,MIL06,5,1,6
MIL201007050,2010,100705,MIL,SFN,MIL06,6,1,7
MIL201007060,2010,100706,MIL,SFN,MIL06,6,1,7
MIL201007070,2010,100707,MIL,SFN,MIL06,15,2,17
MIL201007080,2010,100708,MIL,SFN,MIL06,9,3,12
MIL201007090,2010,100709,MIL,PIT,MIL06,4,5,9
MIL201007100,2010,100710,MIL,PIT,MIL06,3,4,7
MIL201007110,2010,100711,MIL,PIT,MIL06,5,6,11
MIL201007230,2010,100723,MIL,WAS,MIL06,5,7,12
MIL201007240,2010,100724,MIL,WAS,MIL06,3,4,7
MIL201007250,2010,100725,MIL,WAS,MIL06,3,8,11
MIL201007260,2010,100726,MIL,CIN,MIL06,2,3,5
MIL201007270,2010,100727,MIL,CIN,MIL06,12,4,16
MIL201007280,2010,100728,MIL,CIN,MIL06,10,2,12
MIL201008060,2010,100806,MIL,HOU,MIL06,5,6,11
MIL201008070,2010,100807,MIL,HOU,MIL06,2,5,7
MIL201008080,2010,100808,MIL,HOU,MIL06,6,11,17
MIL201008090,2010,100809,MIL,ARI,MIL06,7,4,11
MIL201008100,2010,100810,MIL,ARI,MIL06,2,1,3
MIL201008110,2010,100811,MIL,ARI,MIL06,8,2,10
MIL201008120,2010,100812,MIL,ARI,MIL06,4,8,12
MIL201008200,2010,100820,MIL,SDN,MIL06,6,10,16
MIL201008210,2010,100821,MIL,SDN,MIL06,5,6,11
MIL201008220,2010,100822,MIL,SDN,MIL06,7,3,10
MIL201008240,2010,100824,MIL,LAN,MIL06,5,3,8
MIL201008250,2010,100825,MIL,LAN,MIL06,5,4,9
MIL201008260,2010,100826,MIL,LAN,MIL06,7,1,8
MIL201008270,2010,100827,MIL,PIT,MIL06,2,7,9
MIL201008280,2010,100828,MIL,PIT,MIL06,7,8,15
MIL201008290,2010,100829,MIL,PIT,MIL06,4,8,12
MIL201009060,2010,100906,MIL,SLN,MIL06,8,6,14
MIL201009070,2010,100907,MIL,SLN,MIL06,2,4,6
MIL201009080,2010,100908,MIL,SLN,MIL06,1,8,9
MIL201009100,2010,100910,MIL,CHN,MIL06,4,0,4
MIL201009110,2010,100911,MIL,CHN,MIL06,1,0,1
MIL201009120,2010,100912,MIL,CHN,MIL06,0,2,2
MIL201009200,2010,100920,MIL,CIN,MIL06,5,2,7
MIL201009210,2010,100921,MIL,CIN,MIL06,4,3,7
MIL201009220,2010,100922,MIL,CIN,MIL06,1,13,14
MIL201009230,2010,100923,MIL,FLO,MIL06,3,8,11
MIL201009240,2010,100924,MIL,FLO,MIL06,2,6,8
MIL201009250,2010,100925,MIL,FLO,MIL06,4,0,4
MIL201009260,2010,100926,MIL,FLO,MIL06,1,7,8
MIL201104040,2011,20110404,MIL,ATL,MIL06,2,1,3
MIL201104050,2011,20110405,MIL,ATL,MIL06,0,1,1
MIL201104060,2011,20110406,MIL,ATL,MIL06,4,5,9
MIL201104070,2011,20110407,MIL,ATL,MIL06,2,4,6
MIL201104080,2011,20110408,MIL,CHN,MIL06,7,4,11
MIL201104090,2011,20110409,MIL,CHN,MIL06,0,6,6
MIL201104100,2011,20110410,MIL,CHN,MIL06,5,6,11
MIL201104220,2011,20110422,MIL,HOU,MIL06,7,14,21
MIL201104230,2011,20110423,MIL,HOU,MIL06,9,6,15
MIL201104240,2011,20110424,MIL,HOU,MIL06,1,4,5
MIL201104250,2011,20110425,MIL,CIN,MIL06,9,5,14
MIL201104260,2011,20110426,MIL,CIN,MIL06,2,3,5
MIL201104270,2011,20110427,MIL,CIN,MIL06,7,6,13
MIL201105090,2011,20110509,MIL,SDN,MIL06,3,4,7
MIL201105100,2011,20110510,MIL,SDN,MIL06,6,8,14
MIL201105110,2011,20110511,MIL,SDN,MIL06,13,6,19
MIL201105130,2011,20110513,MIL,PIT,MIL06,2,5,7
MIL201105140,2011,20110514,MIL,PIT,MIL06,2,8,10
MIL201105150,2011,20110515,MIL,PIT,MIL06,6,9,15
MIL201105200,2011,20110520,MIL,COL,MIL06,6,7,13
MIL201105210,2011,20110521,MIL,COL,MIL06,2,3,5
MIL201105220,2011,20110522,MIL,COL,MIL06,1,3,4
MIL201105230,2011,20110523,MIL,WAS,MIL06,3,11,14
MIL201105240,2011,20110524,MIL,WAS,MIL06,6,7,13
MIL201105250,2011,20110525,MIL,WAS,MIL06,4,6,10
MIL201105270,2011,20110527,MIL,SFN,MIL06,5,4,9
MIL201105280,2011,20110528,MIL,SFN,MIL06,2,3,5
MIL201105290,2011,20110529,MIL,SFN,MIL06,0,6,6
MIL201106070,2011,20110607,MIL,NYN,MIL06,2,1,3
MIL201106080,2011,20110608,MIL,NYN,MIL06,6,7,13
MIL201106090,2011,20110609,MIL,NYN,MIL06,4,1,5
MIL201106100,2011,20110610,MIL,SLN,MIL06,0,8,8
MIL201106110,2011,20110611,MIL,SLN,MIL06,3,5,8
MIL201106120,2011,20110612,MIL,SLN,MIL06,3,4,7
MIL201106200,2011,20110620,MIL,TBA,MIL06,8,4,12
MIL201106210,2011,20110621,MIL,TBA,MIL06,1,5,6
MIL201106220,2011,20110622,MIL,TBA,MIL06,6,3,9
MIL201106240,2011,20110624,MIL,MIN,MIL06,3,4,7
MIL201106250,2011,20110625,MIL,MIN,MIL06,1,11,12
MIL201106260,2011,20110626,MIL,MIN,MIL06,2,6,8
MIL201107040,2011,20110704,MIL,ARI,MIL06,8,6,14
MIL201107050,2011,20110705,MIL,ARI,MIL06,7,3,10
MIL201107060,2011,20110706,MIL,ARI,MIL06,1,3,4
MIL201107070,2011,20110707,MIL,CIN,MIL06,4,5,9
MIL201107080,2011,20110708,MIL,CIN,MIL06,7,8,15
MIL201107090,2011,20110709,MIL,CIN,MIL06,8,4,12
MIL201107100,2011,20110710,MIL,CIN,MIL06,3,4,7
MIL201107260,2011,20110726,MIL,CHN,MIL06,2,3,5
MIL201107270,2011,20110727,MIL,CHN,MIL06,0,2,2
MIL201107280,2011,20110728,MIL,CHN,MIL06,2,4,6
MIL201107290,2011,20110729,MIL,HOU,MIL06,0,4,4
MIL201107300,2011,20110730,MIL,HOU,MIL06,2,6,8
MIL201107310,2011,20110731,MIL,HOU,MIL06,4,5,9
MIL201108010,2011,20110801,MIL,SLN,MIL06,2,6,8
MIL201108020,2011,20110802,MIL,SLN,MIL06,8,7,15
MIL201108030,2011,20110803,MIL,SLN,MIL06,5,10,15
MIL201108120,2011,20110812,MIL,PIT,MIL06,2,7,9
MIL201108130,2011,20110813,MIL,PIT,MIL06,0,1,1
MIL201108140,2011,20110814,MIL,PIT,MIL06,1,2,3
MIL201108150,2011,20110815,MIL,LAN,MIL06,0,3,3
MIL201108160,2011,20110816,MIL,LAN,MIL06,1,2,3
MIL201108170,2011,20110817,MIL,LAN,MIL06,1,3,4
MIL201108180,2011,20110818,MIL,LAN,MIL06,5,1,6
MIL201108260,2011,20110826,MIL,CHN,MIL06,2,5,7
MIL201108270,2011,20110827,MIL,CHN,MIL06,4,6,10
MIL201108280,2011,20110828,MIL,CHN,MIL06,2,3,5
MIL201108300,2011,20110830,MIL,SLN,MIL06,2,1,3
MIL201108310,2011,20110831,MIL,SLN,MIL06,8,3,11
MIL201109010,2011,20110901,MIL,SLN,MIL06,8,4,12
MIL201109080,2011,20110908,MIL,PHI,MIL06,7,2,9
MIL201109090,2011,20110909,MIL,PHI,MIL06,5,3,8
MIL201109100,2011,20110910,MIL,PHI,MIL06,3,2,5
MIL201109110,2011,20110911,MIL,PHI,MIL06,2,3,5
MIL201109130,2011,20110913,MIL,COL,MIL06,1,2,3
MIL201109140,2011,20110914,MIL,COL,MIL06,6,2,8
MIL201109230,2011,20110923,MIL,FLO,MIL06,1,4,5
MIL201109240,2011,20110924,MIL,FLO,MIL06,4,6,10
MIL201109250,2011,20110925,MIL,FLO,MIL06,5,9,14
MIL201109260,2011,20110926,MIL,PIT,MIL06,9,8,17
MIL201109270,2011,20110927,MIL,PIT,MIL06,4,6,10
MIL201109280,2011,20110928,MIL,PIT,MIL06,3,7,10
MIL201110010,2011,20111001,MIL,ARI,MIL06,1,4,5
MIL201110020,2011,20111002,MIL,ARI,MIL06,4,9,13
MIL201110070,2011,20111007,MIL,ARI,MIL06,2,3,5
MIL201110090,2011,20111009,MIL,SLN,MIL06,6,9,15
MIL201110100,2011,20111010,MIL,SLN,MIL06,12,3,15
MIL201110160,2011,20111016,MIL,SLN,MIL06,12,6,18
MIL201204060,2012,120406,MIL,SLN,MIL06,11,5,16
MIL201204070,2012,120407,MIL,SLN,MIL06,0,6,6
MIL201204080,2012,120408,MIL,SLN,MIL06,9,3,12
MIL201204170,2012,120417,MIL,LAN,MIL06,4,5,9
MIL201204180,2012,120418,MIL,LAN,MIL06,2,3,5
MIL201204190,2012,120419,MIL,LAN,MIL06,4,3,7
MIL201204200,2012,120420,MIL,COL,MIL06,4,3,7
MIL201204210,2012,120421,MIL,COL,MIL06,4,9,13
MIL201204220,2012,120422,MIL,COL,MIL06,4,1,5
MIL201204230,2012,120423,MIL,HOU,MIL06,5,6,11
MIL201204240,2012,120424,MIL,HOU,MIL06,6,9,15
MIL201204250,2012,120425,MIL,HOU,MIL06,7,5,12
MIL201205070,2012,120507,MIL,CIN,MIL06,6,1,7
MIL201205080,2012,120508,MIL,CIN,MIL06,3,8,11
MIL201205090,2012,120509,MIL,CIN,MIL06,2,1,3
MIL201205110,2012,120511,MIL,CHN,MIL06,7,8,15
MIL201205120,2012,120512,MIL,CHN,MIL06,2,8,10
MIL201205130,2012,120513,MIL,CHN,MIL06,8,2,10
MIL201205180,2012,120518,MIL,MIN,MIL06,11,3,14
MIL201205190,2012,120519,MIL,MIN,MIL06,5,4,9
MIL201205200,2012,120520,MIL,MIN,MIL06,4,16,20
MIL201205210,2012,120521,MIL,SFN,MIL06,4,3,7
MIL201205220,2012,120522,MIL,SFN,MIL06,6,4,10
MIL201205230,2012,120523,MIL,SFN,MIL06,5,8,13
MIL201206010,2012,120601,MIL,PIT,MIL06,8,2,10
MIL201206020,2012,120602,MIL,PIT,MIL06,1,5,6
MIL201206030,2012,120603,MIL,PIT,MIL06,6,5,11
MIL201206050,2012,120605,MIL,CHN,MIL06,10,0,10
MIL201206060,2012,120606,MIL,CHN,MIL06,0,8,8
MIL201206070,2012,120607,MIL,CHN,MIL06,3,4,7
MIL201206080,2012,120608,MIL,SDN,MIL06,5,9,14
MIL201206090,2012,120609,MIL,SDN,MIL06,5,2,7
MIL201206100,2012,120610,MIL,SDN,MIL06,5,6,11
MIL201206180,2012,120618,MIL,TOR,MIL06,6,7,13
MIL201206190,2012,120619,MIL,TOR,MIL06,10,9,19
MIL201206200,2012,120620,MIL,TOR,MIL06,3,8,11
MIL201206290,2012,120629,MIL,ARI,MIL06,9,3,12
MIL201206300,2012,120630,MIL,ARI,MIL06,2,10,12
MIL201207010,2012,120701,MIL,ARI,MIL06,1,2,3
MIL201207020,2012,120702,MIL,MIA,MIL06,5,6,11
MIL201207030,2012,120703,MIL,MIA,MIL06,12,13,25
MIL201207040,2012,120704,MIL,MIA,MIL06,7,6,13
MIL201207050,2012,120705,MIL,MIA,MIL06,4,0,4
MIL201207130,2012,120713,MIL,PIT,MIL06,7,10,17
MIL201207140,2012,120714,MIL,PIT,MIL06,6,4,10
MIL201207150,2012,120715,MIL,PIT,MIL06,1,4,5
MIL201207160,2012,120716,MIL,SLN,MIL06,3,2,5
MIL201207170,2012,120717,MIL,SLN,MIL06,2,3,5
MIL201207180,2012,120718,MIL,SLN,MIL06,3,4,7
MIL201207260,2012,120726,MIL,WAS,MIL06,8,2,10
MIL201207270,2012,120727,MIL,WAS,MIL06,0,6,6
MIL201207280,2012,120728,MIL,WAS,MIL06,4,1,5
MIL201207290,2012,120729,MIL,WAS,MIL06,11,10,21
MIL201207300,2012,120730,MIL,HOU,MIL06,7,8,15
MIL201207310,2012,120731,MIL,HOU,MIL06,1,10,11
MIL201208010,2012,120801,MIL,HOU,MIL06,4,13,17
MIL201208060,2012,120806,MIL,CIN,MIL06,3,6,9
MIL201208070,2012,120807,MIL,CIN,MIL06,1,3,4
MIL201208080,2012,120808,MIL,CIN,MIL06,2,3,5
MIL201208160,2012,120816,MIL,PHI,MIL06,4,7,11
MIL201208170,2012,120817,MIL,PHI,MIL06,2,6,8
MIL201208180,2012,120818,MIL,PHI,MIL06,4,3,7
MIL201208190,2012,120819,MIL,PHI,MIL06,8,0,8
MIL201208200,2012,120820,MIL,CHN,MIL06,5,9,14
MIL201208210,2012,120821,MIL,CHN,MIL06,2,5,7
MIL201208220,2012,120822,MIL,CHN,MIL06,2,3,5
MIL201208310,2012,120831,MIL,PIT,MIL06,3,9,12
MIL201209010,2012,120901,MIL,PIT,MIL06,2,3,5
MIL201209020,2012,120902,MIL,PIT,MIL06,8,12,20
MIL201209100,2012,120910,MIL,ATL,MIL06,1,4,5
MIL201209110,2012,120911,MIL,ATL,MIL06,0,5,5
MIL201209120,2012,120912,MIL,ATL,MIL06,2,8,10
MIL201209140,2012,120914,MIL,NYN,MIL06,7,3,10
MIL201209150,2012,120915,MIL,NYN,MIL06,6,9,15
MIL201209160,2012,120916,MIL,NYN,MIL06,0,3,3
MIL201209280,2012,120928,MIL,HOU,MIL06,7,6,13
MIL201209290,2012,120929,MIL,HOU,MIL06,5,9,14
MIL201209300,2012,120930,MIL,HOU,MIL06,7,0,7
MIL201210010,2012,121001,MIL,SDN,MIL06,3,5,8
MIL201210020,2012,121002,MIL,SDN,MIL06,3,4,7
MIL201210030,2012,121003,MIL,SDN,MIL06,7,6,13
MIL201304010,2013,20130401,MIL,COL,MIL06,4,5,9
MIL201304020,2013,20130402,MIL,COL,MIL06,8,4,12
MIL201304030,2013,20130403,MIL,COL,MIL06,7,3,10
MIL201304050,2013,20130405,MIL,ARI,MIL06,3,1,4
MIL201304060,2013,20130406,MIL,ARI,MIL06,9,2,11
MIL201304070,2013,20130407,MIL,ARI,MIL06,8,7,15
MIL201304160,2013,20130416,MIL,SFN,MIL06,8,10,18
MIL201304170,2013,20130417,MIL,SFN,MIL06,3,4,7
MIL201304180,2013,20130418,MIL,SFN,MIL06,2,7,9
MIL201304190,2013,20130419,MIL,CHN,MIL06,4,5,9
MIL201304200,2013,20130420,MIL,CHN,MIL06,1,5,6
MIL201304210,2013,20130421,MIL,CHN,MIL06,2,4,6
MIL201304290,2013,20130429,MIL,PIT,MIL06,4,10,14
MIL201304300,2013,20130430,MIL,PIT,MIL06,8,12,20
MIL201305010,2013,20130501,MIL,PIT,MIL06,6,4,10
MIL201305020,2013,20130502,MIL,SLN,MIL06,6,5,11
MIL201305030,2013,20130503,MIL,SLN,MIL06,6,1,7
MIL201305040,2013,20130504,MIL,SLN,MIL06,7,6,13
MIL201305050,2013,20130505,MIL,SLN,MIL06,10,1,11
MIL201305070,2013,20130507,MIL,TEX,MIL06,3,6,9
MIL201305080,2013,20130508,MIL,TEX,MIL06,4,1,5
MIL201305200,2013,20130520,MIL,LAN,MIL06,3,1,4
MIL201305210,2013,20130521,MIL,LAN,MIL06,2,5,7
MIL201305220,2013,20130522,MIL,LAN,MIL06,9,2,11
MIL201305240,2013,20130524,MIL,PIT,MIL06,1,2,3
MIL201305250,2013,20130525,MIL,PIT,MIL06,5,2,7
MIL201305260,2013,20130526,MIL,PIT,MIL06,5,4,9
MIL201305270,2013,20130527,MIL,MIN,MIL06,6,3,9
MIL201305280,2013,20130528,MIL,MIN,MIL06,6,5,11
MIL201306030,2013,20130603,MIL,OAK,MIL06,10,2,12
MIL201306040,2013,20130604,MIL,OAK,MIL06,3,4,7
MIL201306050,2013,20130605,MIL,OAK,MIL06,6,1,7
MIL201306060,2013,20130606,MIL,PHI,MIL06,5,1,6
MIL201306070,2013,20130607,MIL,PHI,MIL06,4,5,9
MIL201306080,2013,20130608,MIL,PHI,MIL06,3,4,7
MIL201306090,2013,20130609,MIL,PHI,MIL06,1,9,10
MIL201306210,2013,20130621,MIL,ATL,MIL06,0,2,2
MIL201306220,2013,20130622,MIL,ATL,MIL06,0,2,2
MIL201306230,2013,20130623,MIL,ATL,MIL06,7,4,11
MIL201306250,2013,20130625,MIL,CHN,MIL06,3,9,12
MIL201306260,2013,20130626,MIL,CHN,MIL06,5,4,9
MIL201306270,2013,20130627,MIL,CHN,MIL06,7,2,9
MIL201307050,2013,20130705,MIL,NYN,MIL06,12,5,17
MIL201307060,2013,20130706,MIL,NYN,MIL06,6,7,13
MIL201307070,2013,20130707,MIL,NYN,MIL06,2,1,3
MIL201307080,2013,20130708,MIL,CIN,MIL06,3,4,7
MIL201307090,2013,20130709,MIL,CIN,MIL06,0,2,2
MIL201307100,2013,20130710,MIL,CIN,MIL06,6,2,8
MIL201307190,2013,20130719,MIL,MIA,MIL06,0,2,2
MIL201307200,2013,20130720,MIL,MIA,MIL06,0,6,6
MIL201307210,2013,20130721,MIL,MIA,MIL06,0,1,1
MIL201307220,2013,20130722,MIL,SDN,MIL06,5,3,8
MIL201307230,2013,20130723,MIL,SDN,MIL06,6,2,8
MIL201307240,2013,20130724,MIL,SDN,MIL06,1,3,4
MIL201307250,2013,20130725,MIL,SDN,MIL06,10,8,18
MIL201308020,2013,20130802,MIL,WAS,MIL06,4,1,5
MIL201308030,2013,20130803,MIL,WAS,MIL06,3,0,3
MIL201308040,2013,20130804,MIL,WAS,MIL06,5,8,13
MIL201308150,2013,20130815,MIL,CIN,MIL06,2,1,3
MIL201308160,2013,20130816,MIL,CIN,MIL06,6,7,13
MIL201308170,2013,20130817,MIL,CIN,MIL06,0,2,2
MIL201308180,2013,20130818,MIL,CIN,MIL06,9,1,10
MIL201308190,2013,20130819,MIL,SLN,MIL06,8,5,13
MIL201308200,2013,20130820,MIL,SLN,MIL06,3,6,9
MIL201308210,2013,20130821,MIL,SLN,MIL06,8,6,14
MIL201308300,2013,20130830,MIL,ANA,MIL06,5,0,5
MIL201308310,2013,20130831,MIL,ANA,MIL06,6,5,11
MIL201309010,2013,20130901,MIL,ANA,MIL06,5,3,8
MIL201309020,2013,20130902,MIL,PIT,MIL06,5,2,7
MIL201309030,2013,20130903,MIL,PIT,MIL06,4,3,7
MIL201309040,2013,20130904,MIL,PIT,MIL06,3,9,12
MIL201309130,2013,20130913,MIL,CIN,MIL06,1,5,6
MIL201309140,2013,20130914,MIL,CIN,MIL06,7,3,10
MIL201309150,2013,20130915,MIL,CIN,MIL06,5,6,11
MIL201309160,2013,20130916,MIL,CHN,MIL06,1,6,7
MIL201309170,2013,20130917,MIL,CHN,MIL06,3,4,7
MIL201309180,2013,20130918,MIL,CHN,MIL06,0,7,7
MIL201309190,2013,20130919,MIL,CHN,MIL06,5,1,6
MIL201309200,2013,20130920,MIL,SLN,MIL06,7,6,13
MIL201309210,2013,20130921,MIL,SLN,MIL06,7,2,9
MIL201309220,2013,20130922,MIL,SLN,MIL06,4,6,10
MIN201004120,2010,100412,MIN,BOS,MIN04,2,5,7
MIN201004140,2010,100414,MIN,BOS,MIN04,6,3,9
MIN201004150,2010,100415,MIN,BOS,MIN04,0,8,8
MIN201004160,2010,100416,MIN,KCA,MIN04,3,10,13
MIN201004170,2010,100417,MIN,KCA,MIN04,5,6,11
MIN201004180,2010,100418,MIN,KCA,MIN04,10,5,15
MIN201004200,2010,100420,MIN,CLE,MIN04,1,5,6
MIN201004210,2010,100421,MIN,CLE,MIN04,0,6,6
MIN201004220,2010,100422,MIN,CLE,MIN04,8,1,9
MIN201005030,2010,100503,MIN,DET,MIN04,4,10,14
MIN201005040,2010,100504,MIN,DET,MIN04,3,4,7
MIN201005050,2010,100505,MIN,DET,MIN04,4,5,9
MIN201005060,2010,100506,MIN,BAL,MIN04,2,0,2
MIN201005081,2010,100508,MIN,BAL,MIN04,7,3,10
MIN201005082,2010,100508,MIN,BAL,MIN04,1,6,7
MIN201005090,2010,100509,MIN,BAL,MIN04,0,6,6
MIN201005110,2010,100511,MIN,CHA,MIN04,5,2,7
MIN201005120,2010,100512,MIN,CHA,MIN04,2,3,5
MIN201005210,2010,100521,MIN,MIL,MIN04,3,15,18
MIN201005220,2010,100522,MIN,MIL,MIN04,7,8,15
MIN201005230,2010,100523,MIN,MIL,MIN04,4,3,7
MIN201005250,2010,100525,MIN,NYA,MIN04,1,0,1
MIN201005260,2010,100526,MIN,NYA,MIN04,3,2,5
MIN201005270,2010,100527,MIN,NYA,MIN04,2,8,10
MIN201005280,2010,100528,MIN,TEX,MIN04,1,2,3
MIN201005290,2010,100529,MIN,TEX,MIN04,3,8,11
MIN201005300,2010,100530,MIN,TEX,MIN04,3,6,9
MIN201006080,2010,100608,MIN,KCA,MIN04,3,7,10
MIN201006090,2010,100609,MIN,KCA,MIN04,2,6,8
MIN201006100,2010,100610,MIN,KCA,MIN04,9,8,17
MIN201006110,2010,100611,MIN,ATL,MIN04,1,2,3
MIN201006120,2010,100612,MIN,ATL,MIN04,3,2,5
MIN201006130,2010,100613,MIN,ATL,MIN04,7,3,10
MIN201006150,2010,100615,MIN,COL,MIN04,3,9,12
MIN201006160,2010,100616,MIN,COL,MIN04,1,2,3
MIN201006170,2010,100617,MIN,COL,MIN04,5,1,6
MIN201006280,2010,100628,MIN,DET,MIN04,7,5,12
MIN201006290,2010,100629,MIN,DET,MIN04,4,11,15
MIN201006300,2010,100630,MIN,DET,MIN04,1,5,6
MIN201007010,2010,100701,MIN,TBA,MIN04,5,4,9
MIN201007020,2010,100702,MIN,TBA,MIN04,1,2,3
MIN201007030,2010,100703,MIN,TBA,MIN04,8,6,14
MIN201007040,2010,100704,MIN,TBA,MIN04,7,4,11
MIN201007150,2010,100715,MIN,CHA,MIN04,8,7,15
MIN201007160,2010,100716,MIN,CHA,MIN04,4,7,11
MIN201007170,2010,100717,MIN,CHA,MIN04,2,3,5
MIN201007180,2010,100718,MIN,CHA,MIN04,6,7,13
MIN201007190,2010,100719,MIN,CLE,MIN04,10,4,14
MIN201007200,2010,100720,MIN,CLE,MIN04,4,3,7
MIN201007210,2010,100721,MIN,CLE,MIN04,0,6,6
MIN201007300,2010,100730,MIN,SEA,MIN04,3,5,8
MIN201007310,2010,100731,MIN,SEA,MIN04,0,4,4
MIN201008010,2010,100801,MIN,SEA,MIN04,0,4,4
MIN201008130,2010,100813,MIN,OAK,MIN04,3,4,7
MIN201008140,2010,100814,MIN,OAK,MIN04,0,2,2
MIN201008150,2010,100815,MIN,OAK,MIN04,2,4,6
MIN201008170,2010,100817,MIN,CHA,MIN04,6,7,13
MIN201008180,2010,100818,MIN,CHA,MIN04,6,7,13
MIN201008190,2010,100819,MIN,CHA,MIN04,11,0,11
MIN201008200,2010,100820,MIN,ANA,MIN04,2,7,9
MIN201008210,2010,100821,MIN,ANA,MIN04,9,3,12
MIN201008220,2010,100822,MIN,ANA,MIN04,0,4,4
MIN201008310,2010,100831,MIN,DET,MIN04,3,4,7
MIN201009010,2010,100901,MIN,DET,MIN04,1,2,3
MIN201009020,2010,100902,MIN,DET,MIN04,10,9,19
MIN201009030,2010,100903,MIN,TEX,MIN04,3,4,7
MIN201009040,2010,100904,MIN,TEX,MIN04,4,12,16
MIN201009050,2010,100905,MIN,TEX,MIN04,5,6,11
MIN201009060,2010,100906,MIN,KCA,MIN04,4,5,9
MIN201009070,2010,100907,MIN,KCA,MIN04,3,10,13
MIN201009080,2010,100908,MIN,KCA,MIN04,3,4,7
MIN201009170,2010,100917,MIN,OAK,MIN04,3,1,4
MIN201009180,2010,100918,MIN,OAK,MIN04,2,4,6
MIN201009190,2010,100919,MIN,OAK,MIN04,6,2,8
MIN201009200,2010,100920,MIN,CLE,MIN04,3,9,12
MIN201009210,2010,100921,MIN,CLE,MIN04,4,6,10
MIN201009220,2010,100922,MIN,CLE,MIN04,1,5,6
MIN201009300,2010,100930,MIN,TOR,MIN04,13,2,15
MIN201010010,2010,101001,MIN,TOR,MIN04,6,3,9
MIN201010020,2010,101002,MIN,TOR,MIN04,4,5,9
MIN201010030,2010,101003,MIN,TOR,MIN04,2,1,3
MIN201010060,2010,101006,MIN,NYA,MIN04,6,4,10
MIN201010070,2010,101007,MIN,NYA,MIN04,5,2,7
MIN201104080,2011,20110408,MIN,OAK,MIN04,1,2,3
MIN201104090,2011,20110409,MIN,OAK,MIN04,1,0,1
MIN201104100,2011,20110410,MIN,OAK,MIN04,5,3,8
MIN201104120,2011,20110412,MIN,KCA,MIN04,3,4,7
MIN201104130,2011,20110413,MIN,KCA,MIN04,10,5,15
MIN201104230,2011,20110423,MIN,CLE,MIN04,3,10,13
MIN201104240,2011,20110424,MIN,CLE,MIN04,3,4,7
MIN201104270,2011,20110427,MIN,TBA,MIN04,8,2,10
MIN201104281,2011,20110428,MIN,TBA,MIN04,15,3,18
MIN201104282,2011,20110428,MIN,TBA,MIN04,6,1,7
MIN201105100,2011,20110510,MIN,DET,MIN04,10,2,12
MIN201105110,2011,20110511,MIN,DET,MIN04,9,7,16
MIN201105130,2011,20110513,MIN,TOR,MIN04,2,0,2
MIN201105140,2011,20110514,MIN,TOR,MIN04,9,3,12
MIN201105150,2011,20110515,MIN,TOR,MIN04,11,3,14
MIN201105230,2011,20110523,MIN,SEA,MIN04,8,7,15
MIN201105240,2011,20110524,MIN,SEA,MIN04,2,4,6
MIN201105250,2011,20110525,MIN,SEA,MIN04,3,0,3
MIN201105270,2011,20110527,MIN,ANA,MIN04,6,5,11
MIN201105280,2011,20110528,MIN,ANA,MIN04,0,1,1
MIN201105290,2011,20110529,MIN,ANA,MIN04,6,5,11
MIN201106090,2011,20110609,MIN,TEX,MIN04,4,5,9
MIN201106100,2011,20110610,MIN,TEX,MIN04,9,3,12
MIN201106110,2011,20110611,MIN,TEX,MIN04,1,8,9
MIN201106120,2011,20110612,MIN,TEX,MIN04,1,6,7
MIN201106150,2011,20110615,MIN,CHA,MIN04,1,4,5
MIN201106160,2011,20110616,MIN,CHA,MIN04,0,1,1
MIN201106170,2011,20110617,MIN,SDN,MIN04,5,6,11
MIN201106180,2011,20110618,MIN,SDN,MIN04,0,1,1
MIN201106190,2011,20110619,MIN,SDN,MIN04,4,5,9
MIN201106270,2011,20110627,MIN,LAN,MIN04,15,0,15
MIN201106280,2011,20110628,MIN,LAN,MIN04,4,6,10
MIN201106290,2011,20110629,MIN,LAN,MIN04,0,1,1
MIN201107010,2011,20110701,MIN,MIL,MIN04,2,6,8
MIN201107020,2011,20110702,MIN,MIL,MIN04,8,7,15
MIN201107030,2011,20110703,MIN,MIL,MIN04,7,9,16
MIN201107040,2011,20110704,MIN,TBA,MIN04,0,7,7
MIN201107050,2011,20110705,MIN,TBA,MIN04,2,3,5
MIN201107060,2011,20110706,MIN,TBA,MIN04,12,5,17
MIN201107140,2011,20110714,MIN,KCA,MIN04,4,8,12
MIN201107150,2011,20110715,MIN,KCA,MIN04,2,1,3
MIN201107160,2011,20110716,MIN,KCA,MIN04,3,4,7
MIN201107170,2011,20110717,MIN,KCA,MIN04,3,4,7
MIN201107181,2011,20110718,MIN,CLE,MIN04,5,2,7
MIN201107182,2011,20110718,MIN,CLE,MIN04,6,3,9
MIN201107190,2011,20110719,MIN,CLE,MIN04,1,2,3
MIN201107200,2011,20110720,MIN,CLE,MIN04,5,7,12
MIN201107210,2011,20110721,MIN,DET,MIN04,6,2,8
MIN201107220,2011,20110722,MIN,DET,MIN04,8,2,10
MIN201107230,2011,20110723,MIN,DET,MIN04,1,4,5
MIN201107240,2011,20110724,MIN,DET,MIN04,5,2,7
MIN201108050,2011,20110805,MIN,CHA,MIN04,5,3,8
MIN201108060,2011,20110806,MIN,CHA,MIN04,6,1,7
MIN201108070,2011,20110807,MIN,CHA,MIN04,7,0,7
MIN201108080,2011,20110808,MIN,BOS,MIN04,8,6,14
MIN201108090,2011,20110809,MIN,BOS,MIN04,4,3,7
MIN201108100,2011,20110810,MIN,BOS,MIN04,2,5,7
MIN201108180,2011,20110818,MIN,NYA,MIN04,8,4,12
MIN201108190,2011,20110819,MIN,NYA,MIN04,8,1,9
MIN201108200,2011,20110820,MIN,NYA,MIN04,4,9,13
MIN201108210,2011,20110821,MIN,NYA,MIN04,3,0,3
MIN201108220,2011,20110822,MIN,BAL,MIN04,4,1,5
MIN201108230,2011,20110823,MIN,BAL,MIN04,8,1,9
MIN201108240,2011,20110824,MIN,BAL,MIN04,6,1,7
MIN201108250,2011,20110825,MIN,BAL,MIN04,6,1,7
MIN201108260,2011,20110826,MIN,DET,MIN04,8,1,9
MIN201108270,2011,20110827,MIN,DET,MIN04,6,4,10
MIN201108280,2011,20110828,MIN,DET,MIN04,4,11,15
MIN201109051,2011,20110905,MIN,CHA,MIN04,2,1,3
MIN201109052,2011,20110905,MIN,CHA,MIN04,4,0,4
MIN201109060,2011,20110906,MIN,CHA,MIN04,3,0,3
MIN201109070,2011,20110907,MIN,CHA,MIN04,4,5,9
MIN201109160,2011,20110916,MIN,CLE,MIN04,7,6,13
MIN201109170,2011,20110917,MIN,CLE,MIN04,10,4,14
MIN201109180,2011,20110918,MIN,CLE,MIN04,6,5,11
MIN201109200,2011,20110920,MIN,SEA,MIN04,5,4,9
MIN201109210,2011,20110921,MIN,SEA,MIN04,5,4,9
MIN201109220,2011,20110922,MIN,SEA,MIN04,2,3,5
MIN201109260,2011,20110926,MIN,KCA,MIN04,7,3,10
MIN201109270,2011,20110927,MIN,KCA,MIN04,4,7,11
MIN201109280,2011,20110928,MIN,KCA,MIN04,0,1,1
MIN201204090,2012,120409,MIN,ANA,MIN04,5,1,6
MIN201204110,2012,120411,MIN,ANA,MIN04,5,6,11
MIN201204120,2012,120412,MIN,ANA,MIN04,9,10,19
MIN201204130,2012,120413,MIN,TEX,MIN04,4,1,5
MIN201204140,2012,120414,MIN,TEX,MIN04,6,2,8
MIN201204150,2012,120415,MIN,TEX,MIN04,4,3,7
MIN201204230,2012,120423,MIN,BOS,MIN04,6,5,11
MIN201204240,2012,120424,MIN,BOS,MIN04,11,2,13
MIN201204250,2012,120425,MIN,BOS,MIN04,7,6,13
MIN201204270,2012,120427,MIN,KCA,MIN04,7,6,13
MIN201204290,2012,120429,MIN,KCA,MIN04,4,7,11
MIN201205070,2012,120507,MIN,ANA,MIN04,8,3,11
MIN201205080,2012,120508,MIN,ANA,MIN04,0,5,5
MIN201205090,2012,120509,MIN,ANA,MIN04,6,2,8
MIN201205100,2012,120510,MIN,TOR,MIN04,6,2,8
MIN201205110,2012,120511,MIN,TOR,MIN04,6,7,13
MIN201205120,2012,120512,MIN,TOR,MIN04,2,1,3
MIN201205130,2012,120513,MIN,TOR,MIN04,3,4,7
MIN201205140,2012,120514,MIN,CLE,MIN04,5,4,9
MIN201205150,2012,120515,MIN,CLE,MIN04,5,0,5
MIN201205250,2012,120525,MIN,DET,MIN04,10,6,16
MIN201205260,2012,120526,MIN,DET,MIN04,6,3,9
MIN201205270,2012,120527,MIN,DET,MIN04,4,3,7
MIN201205280,2012,120528,MIN,OAK,MIN04,4,5,9
MIN201205290,2012,120529,MIN,OAK,MIN04,2,3,5
MIN201205300,2012,120530,MIN,OAK,MIN04,0,4,4
MIN201206080,2012,120608,MIN,CHN,MIN04,7,8,15
MIN201206090,2012,120609,MIN,CHN,MIN04,3,11,14
MIN201206100,2012,120610,MIN,CHN,MIN04,8,2,10
MIN201206120,2012,120612,MIN,PHI,MIN04,7,11,18
MIN201206130,2012,120613,MIN,PHI,MIN04,9,8,17
MIN201206140,2012,120614,MIN,PHI,MIN04,6,1,7
MIN201206150,2012,120615,MIN,MIL,MIN04,5,3,8
MIN201206160,2012,120616,MIN,MIL,MIN04,6,2,8
MIN201206170,2012,120617,MIN,MIL,MIN04,4,5,9
MIN201206250,2012,120625,MIN,CHA,MIN04,1,4,5
MIN201206260,2012,120626,MIN,CHA,MIN04,3,2,5
MIN201206270,2012,120627,MIN,CHA,MIN04,12,5,17
MIN201206290,2012,120629,MIN,KCA,MIN04,4,3,7
MIN201206301,2012,120630,MIN,KCA,MIN04,2,7,9
MIN201206302,2012,120630,MIN,KCA,MIN04,1,5,6
MIN201207010,2012,120701,MIN,KCA,MIN04,8,10,18
MIN201207130,2012,120713,MIN,OAK,MIN04,6,3,9
MIN201207140,2012,120714,MIN,OAK,MIN04,9,3,12
MIN201207150,2012,120715,MIN,OAK,MIN04,9,4,13
MIN201207160,2012,120716,MIN,BAL,MIN04,7,19,26
MIN201207170,2012,120717,MIN,BAL,MIN04,4,6,10
MIN201207180,2012,120718,MIN,BAL,MIN04,2,1,3
MIN201207190,2012,120719,MIN,BAL,MIN04,4,3,7
MIN201207270,2012,120727,MIN,CLE,MIN04,0,11,11
MIN201207280,2012,120728,MIN,CLE,MIN04,5,12,17
MIN201207290,2012,120729,MIN,CLE,MIN04,1,5,6
MIN201207300,2012,120730,MIN,CHA,MIN04,6,7,13
MIN201207310,2012,120731,MIN,CHA,MIN04,4,3,7
MIN201208010,2012,120801,MIN,CHA,MIN04,3,2,5
MIN201208100,2012,120810,MIN,TBA,MIN04,12,6,18
MIN201208110,2012,120811,MIN,TBA,MIN04,4,2,6
MIN201208120,2012,120812,MIN,TBA,MIN04,7,3,10
MIN201208130,2012,120813,MIN,DET,MIN04,3,9,12
MIN201208140,2012,120814,MIN,DET,MIN04,8,4,12
MIN201208150,2012,120815,MIN,DET,MIN04,5,1,6
MIN201208270,2012,120827,MIN,SEA,MIN04,1,0,1
MIN201208280,2012,120828,MIN,SEA,MIN04,5,2,7
MIN201208290,2012,120829,MIN,SEA,MIN04,0,10,10
MIN201208300,2012,120830,MIN,SEA,MIN04,5,4,9
MIN201209070,2012,120907,MIN,CLE,MIN04,7,6,13
MIN201209080,2012,120908,MIN,CLE,MIN04,0,3,3
MIN201209090,2012,120909,MIN,CLE,MIN04,7,8,15
MIN201209100,2012,120910,MIN,CLE,MIN04,2,7,9
MIN201209110,2012,120911,MIN,KCA,MIN04,9,1,10
MIN201209120,2012,120912,MIN,KCA,MIN04,10,5,15
MIN201209130,2012,120913,MIN,KCA,MIN04,3,4,7
MIN201209140,2012,120914,MIN,CHA,MIN04,6,0,6
MIN201209150,2012,120915,MIN,CHA,MIN04,5,3,8
MIN201209160,2012,120916,MIN,CHA,MIN04,9,2,11
MIN201209240,2012,120924,MIN,NYA,MIN04,6,3,9
MIN201209250,2012,120925,MIN,NYA,MIN04,4,5,9
MIN201209260,2012,120926,MIN,NYA,MIN04,8,2,10
MIN201209280,2012,120928,MIN,DET,MIN04,2,4,6
MIN201209290,2012,120929,MIN,DET,MIN04,6,4,10
MIN201209300,2012,120930,MIN,DET,MIN04,2,1,3
MIN201304010,2013,20130401,MIN,DET,MIN04,4,2,6
MIN201304030,2013,20130403,MIN,DET,MIN04,2,3,5
MIN201304040,2013,20130404,MIN,DET,MIN04,2,8,10
MIN201304120,2013,20130412,MIN,NYN,MIN04,16,5,21
MIN201304130,2013,20130413,MIN,NYN,MIN04,4,2,6
MIN201304150,2013,20130415,MIN,ANA,MIN04,2,8,10
MIN201304160,2013,20130416,MIN,ANA,MIN04,6,8,14
MIN201304231,2013,20130423,MIN,MIA,MIN04,3,4,7
MIN201304232,2013,20130423,MIN,MIA,MIN04,8,5,13
MIN201304250,2013,20130425,MIN,TEX,MIN04,2,1,3
MIN201304260,2013,20130426,MIN,TEX,MIN04,4,3,7
MIN201304270,2013,20130427,MIN,TEX,MIN04,2,7,9
MIN201304280,2013,20130428,MIN,TEX,MIN04,0,5,5
MIN201305100,2013,20130510,MIN,BAL,MIN04,9,6,15
MIN201305110,2013,20130511,MIN,BAL,MIN04,5,8,13
MIN201305120,2013,20130512,MIN,BAL,MIN04,6,0,6
MIN201305130,2013,20130513,MIN,CHA,MIN04,3,10,13
MIN201305140,2013,20130514,MIN,CHA,MIN04,4,2,6
MIN201305150,2013,20130515,MIN,CHA,MIN04,9,4,13
MIN201305170,2013,20130517,MIN,BOS,MIN04,3,2,5
MIN201305180,2013,20130518,MIN,BOS,MIN04,12,5,17
MIN201305190,2013,20130519,MIN,BOS,MIN04,5,1,6
MIN201305290,2013,20130529,MIN,MIL,MIN04,1,4,5
MIN201305300,2013,20130530,MIN,MIL,MIN04,6,8,14
MIN201305310,2013,20130531,MIN,SEA,MIN04,3,0,3
MIN201306010,2013,20130601,MIN,SEA,MIN04,4,5,9
MIN201306020,2013,20130602,MIN,SEA,MIN04,0,10,10
MIN201306110,2013,20130611,MIN,PHI,MIN04,2,3,5
MIN201306120,2013,20130612,MIN,PHI,MIN04,3,4,7
MIN201306130,2013,20130613,MIN,PHI,MIN04,3,2,5
MIN201306140,2013,20130614,MIN,DET,MIN04,4,0,4
MIN201306150,2013,20130615,MIN,DET,MIN04,3,6,9
MIN201306160,2013,20130616,MIN,DET,MIN04,5,2,7
MIN201306180,2013,20130618,MIN,CHA,MIN04,5,7,12
MIN201306190,2013,20130619,MIN,CHA,MIN04,4,7,11
MIN201306200,2013,20130620,MIN,CHA,MIN04,4,8,12
MIN201306270,2013,20130627,MIN,KCA,MIN04,1,3,4
MIN201306280,2013,20130628,MIN,KCA,MIN04,9,3,12
MIN201306290,2013,20130629,MIN,KCA,MIN04,2,6,8
MIN201306300,2013,20130630,MIN,KCA,MIN04,9,8,17
MIN201307010,2013,20130701,MIN,NYA,MIN04,10,4,14
MIN201307020,2013,20130702,MIN,NYA,MIN04,7,3,10
MIN201307030,2013,20130703,MIN,NYA,MIN04,3,2,5
MIN201307040,2013,20130704,MIN,NYA,MIN04,9,5,14
MIN201307190,2013,20130719,MIN,CLE,MIN04,2,3,5
MIN201307200,2013,20130720,MIN,CLE,MIN04,2,3,5
MIN201307210,2013,20130721,MIN,CLE,MIN04,7,1,8
MIN201307300,2013,20130730,MIN,KCA,MIN04,7,2,9
MIN201307310,2013,20130731,MIN,KCA,MIN04,4,3,7
MIN201308010,2013,20130801,MIN,KCA,MIN04,7,2,9
MIN201308020,2013,20130802,MIN,HOU,MIN04,3,4,7
MIN201308030,2013,20130803,MIN,HOU,MIN04,4,6,10
MIN201308040,2013,20130804,MIN,HOU,MIN04,2,3,5
MIN201308120,2013,20130812,MIN,CLE,MIN04,0,3,3
MIN201308130,2013,20130813,MIN,CLE,MIN04,5,2,7
MIN201308140,2013,20130814,MIN,CLE,MIN04,9,8,17
MIN201308150,2013,20130815,MIN,CHA,MIN04,3,4,7
MIN201308160,2013,20130816,MIN,CHA,MIN04,5,2,7
MIN201308170,2013,20130817,MIN,CHA,MIN04,8,5,13
MIN201308180,2013,20130818,MIN,CHA,MIN04,5,2,7
MIN201308190,2013,20130819,MIN,NYN,MIN04,6,1,7
MIN201308270,2013,20130827,MIN,KCA,MIN04,6,1,7
MIN201308280,2013,20130828,MIN,KCA,MIN04,8,1,9
MIN201308290,2013,20130829,MIN,KCA,MIN04,3,1,4
MIN201309060,2013,20130906,MIN,TOR,MIN04,6,5,11
MIN201309070,2013,20130907,MIN,TOR,MIN04,11,2,13
MIN201309080,2013,20130908,MIN,TOR,MIN04,2,0,2
MIN201309090,2013,20130909,MIN,ANA,MIN04,3,6,9
MIN201309100,2013,20130910,MIN,OAK,MIN04,3,4,7
MIN201309110,2013,20130911,MIN,OAK,MIN04,18,3,21
MIN201309120,2013,20130912,MIN,OAK,MIN04,8,2,10
MIN201309130,2013,20130913,MIN,TBA,MIN04,3,0,3
MIN201309140,2013,20130914,MIN,TBA,MIN04,7,0,7
MIN201309150,2013,20130915,MIN,TBA,MIN04,4,6,10
MIN201309230,2013,20130923,MIN,DET,MIN04,3,4,7
MIN201309240,2013,20130924,MIN,DET,MIN04,4,2,6
MIN201309250,2013,20130925,MIN,DET,MIN04,1,0,1
MIN201309260,2013,20130926,MIN,CLE,MIN04,6,5,11
MIN201309270,2013,20130927,MIN,CLE,MIN04,12,6,18
MIN201309280,2013,20130928,MIN,CLE,MIN04,5,1,6
MIN201309290,2013,20130929,MIN,CLE,MIN04,5,1,6
NYA201004130,2010,100413,NYA,ANA,NYC21,5,7,12
NYA201004140,2010,100414,NYA,ANA,NYC21,5,3,8
NYA201004150,2010,100415,NYA,ANA,NYC21,2,6,8
NYA201004160,2010,100416,NYA,TEX,NYC21,1,5,6
NYA201004170,2010,100417,NYA,TEX,NYC21,3,7,10
NYA201004180,2010,100418,NYA,TEX,NYC21,2,5,7
NYA201004300,2010,100430,NYA,CHA,NYC21,4,6,10
NYA201005010,2010,100501,NYA,CHA,NYC21,7,6,13
NYA201005020,2010,100502,NYA,CHA,NYC21,3,12,15
NYA201005030,2010,100503,NYA,BAL,NYC21,1,4,5
NYA201005040,2010,100504,NYA,BAL,NYC21,1,4,5
NYA201005050,2010,100505,NYA,BAL,NYC21,5,7,12
NYA201005140,2010,100514,NYA,MIN,NYC21,4,8,12
NYA201005150,2010,100515,NYA,MIN,NYC21,1,7,8
NYA201005160,2010,100516,NYA,MIN,NYC21,6,3,9
NYA201005170,2010,100517,NYA,BOS,NYC21,9,11,20
NYA201005180,2010,100518,NYA,BOS,NYC21,7,6,13
NYA201005190,2010,100519,NYA,TBA,NYC21,10,6,16
NYA201005200,2010,100520,NYA,TBA,NYC21,8,6,14
NYA201005280,2010,100528,NYA,CLE,NYC21,2,8,10
NYA201005290,2010,100529,NYA,CLE,NYC21,13,11,24
NYA201005300,2010,100530,NYA,CLE,NYC21,3,7,10
NYA201005310,2010,100531,NYA,CLE,NYC21,2,11,13
NYA201006010,2010,100601,NYA,BAL,NYC21,1,3,4
NYA201006020,2010,100602,NYA,BAL,NYC21,1,9,10
NYA201006030,2010,100603,NYA,BAL,NYC21,3,6,9
NYA201006110,2010,100611,NYA,HOU,NYC21,3,4,7
NYA201006120,2010,100612,NYA,HOU,NYC21,3,9,12
NYA201006130,2010,100613,NYA,HOU,NYC21,5,9,14
NYA201006150,2010,100615,NYA,PHI,NYC21,3,8,11
NYA201006160,2010,100616,NYA,PHI,NYC21,6,3,9
NYA201006170,2010,100617,NYA,PHI,NYC21,7,1,8
NYA201006180,2010,100618,NYA,NYN,NYC21,4,0,4
NYA201006190,2010,100619,NYA,NYN,NYC21,3,5,8
NYA201006200,2010,100620,NYA,NYN,NYC21,0,4,4
NYA201006290,2010,100629,NYA,SEA,NYC21,7,4,11
NYA201006300,2010,100630,NYA,SEA,NYC21,7,0,7
NYA201007010,2010,100701,NYA,SEA,NYC21,2,4,6
NYA201007020,2010,100702,NYA,TOR,NYC21,6,1,7
NYA201007030,2010,100703,NYA,TOR,NYC21,3,11,14
NYA201007040,2010,100704,NYA,TOR,NYC21,6,7,13
NYA201007160,2010,100716,NYA,TBA,NYC21,4,5,9
NYA201007170,2010,100717,NYA,TBA,NYC21,10,5,15
NYA201007180,2010,100718,NYA,TBA,NYC21,5,9,14
NYA201007200,2010,100720,NYA,ANA,NYC21,10,2,12
NYA201007210,2010,100721,NYA,ANA,NYC21,6,10,16
NYA201007220,2010,100722,NYA,KCA,NYC21,4,10,14
NYA201007230,2010,100723,NYA,KCA,NYC21,1,7,8
NYA201007240,2010,100724,NYA,KCA,NYC21,7,4,11
NYA201007250,2010,100725,NYA,KCA,NYC21,6,12,18
NYA201008020,2010,100802,NYA,TOR,NYC21,8,6,14
NYA201008030,2010,100803,NYA,TOR,NYC21,8,2,10
NYA201008040,2010,100804,NYA,TOR,NYC21,1,5,6
NYA201008060,2010,100806,NYA,BOS,NYC21,6,3,9
NYA201008070,2010,100807,NYA,BOS,NYC21,2,5,7
NYA201008080,2010,100808,NYA,BOS,NYC21,2,7,9
NYA201008090,2010,100809,NYA,BOS,NYC21,2,1,3
NYA201008160,2010,100816,NYA,DET,NYC21,3,1,4
NYA201008170,2010,100817,NYA,DET,NYC21,2,6,8
NYA201008180,2010,100818,NYA,DET,NYC21,5,9,14
NYA201008190,2010,100819,NYA,DET,NYC21,5,11,16
NYA201008200,2010,100820,NYA,SEA,NYC21,6,0,6
NYA201008210,2010,100821,NYA,SEA,NYC21,5,9,14
NYA201008220,2010,100822,NYA,SEA,NYC21,0,10,10
NYA201008300,2010,100830,NYA,OAK,NYC21,5,11,16
NYA201008310,2010,100831,NYA,OAK,NYC21,3,9,12
NYA201009010,2010,100901,NYA,OAK,NYC21,3,4,7
NYA201009020,2010,100902,NYA,OAK,NYC21,0,5,5
NYA201009030,2010,100903,NYA,TOR,NYC21,3,7,10
NYA201009040,2010,100904,NYA,TOR,NYC21,5,7,12
NYA201009050,2010,100905,NYA,TOR,NYC21,7,3,10
NYA201009060,2010,100906,NYA,BAL,NYC21,4,3,7
NYA201009070,2010,100907,NYA,BAL,NYC21,6,2,8
NYA201009080,2010,100908,NYA,BAL,NYC21,2,3,5
NYA201009200,2010,100920,NYA,TBA,NYC21,6,8,14
NYA201009210,2010,100921,NYA,TBA,NYC21,3,8,11
NYA201009220,2010,100922,NYA,TBA,NYC21,7,2,9
NYA201009230,2010,100923,NYA,TBA,NYC21,10,3,13
NYA201009240,2010,100924,NYA,BOS,NYC21,10,8,18
NYA201009250,2010,100925,NYA,BOS,NYC21,7,3,10
NYA201009260,2010,100926,NYA,BOS,NYC21,3,4,7
NYA201010090,2010,101009,NYA,MIN,NYC21,1,6,7
NYA201010180,2010,101018,NYA,TEX,NYC21,8,0,8
NYA201010190,2010,101019,NYA,TEX,NYC21,10,3,13
NYA201010200,2010,101020,NYA,TEX,NYC21,2,7,9
NYA201103310,2011,20110331,NYA,DET,NYC21,3,6,9
NYA201104020,2011,20110402,NYA,DET,NYC21,6,10,16
NYA201104030,2011,20110403,NYA,DET,NYC21,10,7,17
NYA201104040,2011,20110404,NYA,MIN,NYC21,3,4,7
NYA201104050,2011,20110405,NYA,MIN,NYC21,5,4,9
NYA201104070,2011,20110407,NYA,MIN,NYC21,3,4,7
NYA201104130,2011,20110413,NYA,BAL,NYC21,4,7,11
NYA201104140,2011,20110414,NYA,BAL,NYC21,5,6,11
NYA201104150,2011,20110415,NYA,TEX,NYC21,5,3,8
NYA201104160,2011,20110416,NYA,TEX,NYC21,2,5,7
NYA201104170,2011,20110417,NYA,TEX,NYC21,5,6,11
NYA201104250,2011,20110425,NYA,CHA,NYC21,2,0,2
NYA201104260,2011,20110426,NYA,CHA,NYC21,3,2,5
NYA201104270,2011,20110427,NYA,CHA,NYC21,1,3,4
NYA201104280,2011,20110428,NYA,CHA,NYC21,3,12,15
NYA201104290,2011,20110429,NYA,TOR,NYC21,5,3,8
NYA201104300,2011,20110430,NYA,TOR,NYC21,4,5,9
NYA201105010,2011,20110501,NYA,TOR,NYC21,2,5,7
NYA201105100,2011,20110510,NYA,KCA,NYC21,1,3,4
NYA201105110,2011,20110511,NYA,KCA,NYC21,4,3,7
NYA201105120,2011,20110512,NYA,KCA,NYC21,11,5,16
NYA201105130,2011,20110513,NYA,BOS,NYC21,5,4,9
NYA201105140,2011,20110514,NYA,BOS,NYC21,6,0,6
NYA201105150,2011,20110515,NYA,BOS,NYC21,7,5,12
NYA201105200,2011,20110520,NYA,NYN,NYC21,2,1,3
NYA201105210,2011,20110521,NYA,NYN,NYC21,3,7,10
NYA201105220,2011,20110522,NYA,NYN,NYC21,3,9,12
NYA201105230,2011,20110523,NYA,TOR,NYC21,7,3,10
NYA201105240,2011,20110524,NYA,TOR,NYC21,4,5,9
NYA201105250,2011,20110525,NYA,TOR,NYC21,3,7,10
NYA201106070,2011,20110607,NYA,BOS,NYC21,6,4,10
NYA201106080,2011,20110608,NYA,BOS,NYC21,11,6,17
NYA201106090,2011,20110609,NYA,BOS,NYC21,8,3,11
NYA201106100,2011,20110610,NYA,CLE,NYC21,7,11,18
NYA201106110,2011,20110611,NYA,CLE,NYC21,0,4,4
NYA201106120,2011,20110612,NYA,CLE,NYC21,1,9,10
NYA201106130,2011,20110613,NYA,CLE,NYC21,1,0,1
NYA201106140,2011,20110614,NYA,TEX,NYC21,4,12,16
NYA201106150,2011,20110615,NYA,TEX,NYC21,4,12,16
NYA201106160,2011,20110616,NYA,TEX,NYC21,2,3,5
NYA201106240,2011,20110624,NYA,COL,NYC21,4,2,6
NYA201106250,2011,20110625,NYA,COL,NYC21,3,8,11
NYA201106260,2011,20110626,NYA,COL,NYC21,4,6,10
NYA201106280,2011,20110628,NYA,MIL,NYC21,2,12,14
NYA201106290,2011,20110629,NYA,MIL,NYC21,2,5,7
NYA201106300,2011,20110630,NYA,MIL,NYC21,0,5,5
NYA201107070,2011,20110707,NYA,TBA,NYC21,5,1,6
NYA201107090,2011,20110709,NYA,TBA,NYC21,4,5,9
NYA201107100,2011,20110710,NYA,TBA,NYC21,0,1,1
NYA201107220,2011,20110722,NYA,OAK,NYC21,7,17,24
NYA201107230,2011,20110723,NYA,OAK,NYC21,4,3,7
NYA201107240,2011,20110724,NYA,OAK,NYC21,5,7,12
NYA201107250,2011,20110725,NYA,SEA,NYC21,3,10,13
NYA201107260,2011,20110726,NYA,SEA,NYC21,1,4,5
NYA201107270,2011,20110727,NYA,SEA,NYC21,9,2,11
NYA201107290,2011,20110729,NYA,BAL,NYC21,4,2,6
NYA201107301,2011,20110730,NYA,BAL,NYC21,3,8,11
NYA201107302,2011,20110730,NYA,BAL,NYC21,3,17,20
NYA201107310,2011,20110731,NYA,BAL,NYC21,2,4,6
NYA201108090,2011,20110809,NYA,ANA,NYC21,6,4,10
NYA201108100,2011,20110810,NYA,ANA,NYC21,3,9,12
NYA201108110,2011,20110811,NYA,ANA,NYC21,5,6,11
NYA201108120,2011,20110812,NYA,TBA,NYC21,5,1,6
NYA201108130,2011,20110813,NYA,TBA,NYC21,2,9,11
NYA201108230,2011,20110823,NYA,OAK,NYC21,6,5,11
NYA201108240,2011,20110824,NYA,OAK,NYC21,6,4,10
NYA201108250,2011,20110825,NYA,OAK,NYC21,9,22,31
NYA201109020,2011,20110902,NYA,TOR,NYC21,2,3,5
NYA201109030,2011,20110903,NYA,TOR,NYC21,4,6,10
NYA201109040,2011,20110904,NYA,TOR,NYC21,3,9,12
NYA201109050,2011,20110905,NYA,BAL,NYC21,10,11,21
NYA201109060,2011,20110906,NYA,BAL,NYC21,3,5,8
NYA201109070,2011,20110907,NYA,BAL,NYC21,5,4,9
NYA201109190,2011,20110919,NYA,MIN,NYC21,4,6,10
NYA201109200,2011,20110920,NYA,TBA,NYC21,0,5,5
NYA201109211,2011,20110921,NYA,TBA,NYC21,2,4,6
NYA201109212,2011,20110921,NYA,TBA,NYC21,2,4,6
NYA201109220,2011,20110922,NYA,TBA,NYC21,15,8,23
NYA201109240,2011,20110924,NYA,BOS,NYC21,1,9,10
NYA201109251,2011,20110925,NYA,BOS,NYC21,2,6,8
NYA201109252,2011,20110925,NYA,BOS,NYC21,7,4,11
NYA201109300,2011,20110930,NYA,DET,NYC21,3,9,12
NYA201110020,2011,20111002,NYA,DET,NYC21,5,3,8
NYA201110060,2011,20111006,NYA,DET,NYC21,3,2,5
NYA201204130,2012,120413,NYA,ANA,NYC21,0,5,5
NYA201204140,2012,120414,NYA,ANA,NYC21,7,1,8
NYA201204150,2012,120415,NYA,ANA,NYC21,5,11,16
NYA201204160,2012,120416,NYA,MIN,NYC21,7,3,10
NYA201204170,2012,120417,NYA,MIN,NYC21,3,8,11
NYA201204180,2012,120418,NYA,MIN,NYC21,6,5,11
NYA201204190,2012,120419,NYA,MIN,NYC21,6,7,13
NYA201204270,2012,120427,NYA,DET,NYC21,6,7,13
NYA201204280,2012,120428,NYA,DET,NYC21,7,5,12
NYA201204290,2012,120429,NYA,DET,NYC21,2,6,8
NYA201204300,2012,120430,NYA,BAL,NYC21,1,2,3
NYA201205010,2012,120501,NYA,BAL,NYC21,7,1,8
NYA201205020,2012,120502,NYA,BAL,NYC21,5,0,5
NYA201205080,2012,120508,NYA,TBA,NYC21,3,5,8
NYA201205090,2012,120509,NYA,TBA,NYC21,4,1,5
NYA201205100,2012,120510,NYA,TBA,NYC21,3,5,8
NYA201205110,2012,120511,NYA,SEA,NYC21,2,6,8
NYA201205120,2012,120512,NYA,SEA,NYC21,2,6,8
NYA201205130,2012,120513,NYA,SEA,NYC21,6,2,8
NYA201205180,2012,120518,NYA,CIN,NYC21,0,4,4
NYA201205190,2012,120519,NYA,CIN,NYC21,6,5,11
NYA201205200,2012,120520,NYA,CIN,NYC21,5,2,7
NYA201205210,2012,120521,NYA,KCA,NYC21,6,0,6
NYA201205220,2012,120522,NYA,KCA,NYC21,2,3,5
NYA201205230,2012,120523,NYA,KCA,NYC21,3,8,11
NYA201206050,2012,120605,NYA,TBA,NYC21,0,7,7
NYA201206060,2012,120606,NYA,TBA,NYC21,1,4,5
NYA201206070,2012,120607,NYA,TBA,NYC21,7,3,10
NYA201206080,2012,120608,NYA,NYN,NYC21,1,9,10
NYA201206090,2012,120609,NYA,NYN,NYC21,2,4,6
NYA201206100,2012,120610,NYA,NYN,NYC21,4,5,9
NYA201206180,2012,120618,NYA,ATL,NYC21,2,6,8
NYA201206190,2012,120619,NYA,ATL,NYC21,4,3,7
NYA201206200,2012,120620,NYA,ATL,NYC21,10,5,15
NYA201206250,2012,120625,NYA,CLE,NYC21,1,7,8
NYA201206260,2012,120626,NYA,CLE,NYC21,4,6,10
NYA201206270,2012,120627,NYA,CLE,NYC21,4,5,9
NYA201206280,2012,120628,NYA,CHA,NYC21,4,3,7
NYA201206290,2012,120629,NYA,CHA,NYC21,14,7,21
NYA201206300,2012,120630,NYA,CHA,NYC21,0,4,4
NYA201207010,2012,120701,NYA,CHA,NYC21,2,4,6
NYA201207130,2012,120713,NYA,ANA,NYC21,5,6,11
NYA201207140,2012,120714,NYA,ANA,NYC21,3,5,8
NYA201207150,2012,120715,NYA,ANA,NYC21,10,8,18
NYA201207160,2012,120716,NYA,TOR,NYC21,3,6,9
NYA201207170,2012,120717,NYA,TOR,NYC21,1,6,7
NYA201207180,2012,120718,NYA,TOR,NYC21,0,6,6
NYA201207270,2012,120727,NYA,BOS,NYC21,3,10,13
NYA201207280,2012,120728,NYA,BOS,NYC21,8,6,14
NYA201207290,2012,120729,NYA,BOS,NYC21,3,2,5
NYA201207300,2012,120730,NYA,BAL,NYC21,5,4,9
NYA201207310,2012,120731,NYA,BAL,NYC21,11,5,16
NYA201208010,2012,120801,NYA,BAL,NYC21,3,12,15
NYA201208030,2012,120803,NYA,SEA,NYC21,3,6,9
NYA201208040,2012,120804,NYA,SEA,NYC21,1,0,1
NYA201208050,2012,120805,NYA,SEA,NYC21,2,6,8
NYA201208130,2012,120813,NYA,TEX,NYC21,2,8,10
NYA201208140,2012,120814,NYA,TEX,NYC21,0,3,3
NYA201208150,2012,120815,NYA,TEX,NYC21,2,3,5
NYA201208160,2012,120816,NYA,TEX,NYC21,10,6,16
NYA201208170,2012,120817,NYA,BOS,NYC21,4,6,10
NYA201208180,2012,120818,NYA,BOS,NYC21,4,1,5
NYA201208190,2012,120819,NYA,BOS,NYC21,1,4,5
NYA201208270,2012,120827,NYA,TOR,NYC21,8,7,15
NYA201208280,2012,120828,NYA,TOR,NYC21,1,2,3
NYA201208290,2012,120829,NYA,TOR,NYC21,8,5,13
NYA201208310,2012,120831,NYA,BAL,NYC21,6,1,7
NYA201209010,2012,120901,NYA,BAL,NYC21,3,4,7
NYA201209020,2012,120902,NYA,BAL,NYC21,8,3,11
NYA201209140,2012,120914,NYA,TBA,NYC21,6,4,10
NYA201209150,2012,120915,NYA,TBA,NYC21,3,5,8
NYA201209160,2012,120916,NYA,TBA,NYC21,4,6,10
NYA201209191,2012,120919,NYA,TOR,NYC21,2,4,6
NYA201209192,2012,120919,NYA,TOR,NYC21,1,2,3
NYA201209200,2012,120920,NYA,TOR,NYC21,7,10,17
NYA201209210,2012,120921,NYA,OAK,NYC21,1,2,3
NYA201209220,2012,120922,NYA,OAK,NYC21,9,10,19
NYA201209230,2012,120923,NYA,OAK,NYC21,5,4,9
NYA201210010,2012,121001,NYA,BOS,NYC21,2,10,12
NYA201210020,2012,121002,NYA,BOS,NYC21,3,4,7
NYA201210030,2012,121003,NYA,BOS,NYC21,2,14,16
NYA201210100,2012,121010,NYA,BAL,NYC21,2,3,5
NYA201210110,2012,121011,NYA,BAL,NYC21,2,1,3
NYA201210120,2012,121012,NYA,BAL,NYC21,1,3,4
NYA201210130,2012,121013,NYA,DET,NYC21,6,4,10
NYA201210140,2012,121014,NYA,DET,NYC21,3,0,3
NYA201304010,2013,20130401,NYA,BOS,NYC21,8,2,10
NYA201304030,2013,20130403,NYA,BOS,NYC21,7,4,11
NYA201304040,2013,20130404,NYA,BOS,NYC21,2,4,6
NYA201304120,2013,20130412,NYA,BAL,NYC21,2,5,7
NYA201304130,2013,20130413,NYA,BAL,NYC21,5,3,8
NYA201304140,2013,20130414,NYA,BAL,NYC21,0,3,3
NYA201304160,2013,20130416,NYA,ARI,NYC21,2,4,6
NYA201304170,2013,20130417,NYA,ARI,NYC21,3,4,7
NYA201304180,2013,20130418,NYA,ARI,NYC21,6,2,8
NYA201304250,2013,20130425,NYA,TOR,NYC21,3,5,8
NYA201304260,2013,20130426,NYA,TOR,NYC21,4,6,10
NYA201304270,2013,20130427,NYA,TOR,NYC21,4,5,9
NYA201304280,2013,20130428,NYA,TOR,NYC21,2,3,5
NYA201304290,2013,20130429,NYA,HOU,NYC21,9,1,10
NYA201304300,2013,20130430,NYA,HOU,NYC21,4,7,11
NYA201305010,2013,20130501,NYA,HOU,NYC21,4,5,9
NYA201305030,2013,20130503,NYA,OAK,NYC21,2,0,2
NYA201305040,2013,20130504,NYA,OAK,NYC21,2,4,6
NYA201305050,2013,20130505,NYA,OAK,NYC21,5,4,9
NYA201305140,2013,20130514,NYA,SEA,NYC21,3,4,7
NYA201305150,2013,20130515,NYA,SEA,NYC21,12,2,14
NYA201305160,2013,20130516,NYA,SEA,NYC21,3,2,5
NYA201305170,2013,20130517,NYA,TOR,NYC21,0,5,5
NYA201305180,2013,20130518,NYA,TOR,NYC21,2,7,9
NYA201305290,2013,20130529,NYA,NYN,NYC21,9,4,13
NYA201305300,2013,20130530,NYA,NYN,NYC21,3,1,4
NYA201305310,2013,20130531,NYA,BOS,NYC21,1,4,5
NYA201306010,2013,20130601,NYA,BOS,NYC21,11,1,12
NYA201306020,2013,20130602,NYA,BOS,NYC21,3,0,3
NYA201306030,2013,20130603,NYA,CLE,NYC21,4,7,11
NYA201306040,2013,20130604,NYA,CLE,NYC21,3,4,7
NYA201306050,2013,20130605,NYA,CLE,NYC21,4,6,10
NYA201306191,2013,20130619,NYA,LAN,NYC21,4,6,10
NYA201306192,2013,20130619,NYA,LAN,NYC21,6,0,6
NYA201306200,2013,20130620,NYA,TBA,NYC21,8,3,11
NYA201306210,2013,20130621,NYA,TBA,NYC21,2,6,8
NYA201306220,2013,20130622,NYA,TBA,NYC21,5,7,12
NYA201306230,2013,20130623,NYA,TBA,NYC21,3,1,4
NYA201306250,2013,20130625,NYA,TEX,NYC21,3,4,7
NYA201306260,2013,20130626,NYA,TEX,NYC21,8,5,13
NYA201306270,2013,20130627,NYA,TEX,NYC21,2,0,2
NYA201307050,2013,20130705,NYA,BAL,NYC21,2,3,5
NYA201307060,2013,20130706,NYA,BAL,NYC21,4,5,9
NYA201307070,2013,20130707,NYA,BAL,NYC21,2,1,3
NYA201307080,2013,20130708,NYA,KCA,NYC21,5,1,6
NYA201307090,2013,20130709,NYA,KCA,NYC21,3,1,4
NYA201307100,2013,20130710,NYA,KCA,NYC21,1,8,9
NYA201307110,2013,20130711,NYA,KCA,NYC21,4,8,12
NYA201307120,2013,20130712,NYA,MIN,NYC21,0,2,2
NYA201307130,2013,20130713,NYA,MIN,NYC21,4,1,5
NYA201307140,2013,20130714,NYA,MIN,NYC21,10,4,14
NYA201307260,2013,20130726,NYA,TBA,NYC21,10,6,16
NYA201307270,2013,20130727,NYA,TBA,NYC21,1,0,1
NYA201307280,2013,20130728,NYA,TBA,NYC21,5,6,11
NYA201308090,2013,20130809,NYA,DET,NYC21,3,4,7
NYA201308100,2013,20130810,NYA,DET,NYC21,9,3,12
NYA201308110,2013,20130811,NYA,DET,NYC21,4,5,9
NYA201308120,2013,20130812,NYA,ANA,NYC21,1,2,3
NYA201308130,2013,20130813,NYA,ANA,NYC21,7,14,21
NYA201308140,2013,20130814,NYA,ANA,NYC21,3,11,14
NYA201308150,2013,20130815,NYA,ANA,NYC21,8,4,12
NYA201308201,2013,20130820,NYA,TOR,NYC21,4,8,12
NYA201308202,2013,20130820,NYA,TOR,NYC21,2,3,5
NYA201308210,2013,20130821,NYA,TOR,NYC21,2,4,6
NYA201308220,2013,20130822,NYA,TOR,NYC21,3,5,8
NYA201308300,2013,20130830,NYA,BAL,NYC21,5,8,13
NYA201308310,2013,20130831,NYA,BAL,NYC21,0,2,2
NYA201309010,2013,20130901,NYA,BAL,NYC21,7,3,10
NYA201309020,2013,20130902,NYA,CHA,NYC21,1,9,10
NYA201309030,2013,20130903,NYA,CHA,NYC21,4,6,10
NYA201309040,2013,20130904,NYA,CHA,NYC21,5,6,11
NYA201309050,2013,20130905,NYA,BOS,NYC21,9,8,17
NYA201309060,2013,20130906,NYA,BOS,NYC21,12,8,20
NYA201309070,2013,20130907,NYA,BOS,NYC21,13,9,22
NYA201309080,2013,20130908,NYA,BOS,NYC21,3,4,7
NYA201309200,2013,20130920,NYA,SFN,NYC21,1,5,6
NYA201309210,2013,20130921,NYA,SFN,NYC21,0,6,6
NYA201309220,2013,20130922,NYA,SFN,NYC21,2,1,3
NYA201309240,2013,20130924,NYA,TBA,NYC21,7,0,7
NYA201309250,2013,20130925,NYA,TBA,NYC21,8,3,11
NYA201309260,2013,20130926,NYA,TBA,NYC21,4,0,4
NYN201004050,2010,100405,NYN,FLO,NYC20,1,7,8
NYN201004070,2010,100407,NYN,FLO,NYC20,7,6,13
NYN201004080,2010,100408,NYN,FLO,NYC20,3,1,4
NYN201004090,2010,100409,NYN,WAS,NYC20,2,8,10
NYN201004100,2010,100410,NYN,WAS,NYC20,4,3,7
NYN201004110,2010,100411,NYN,WAS,NYC20,5,2,7
NYN201004190,2010,100419,NYN,CHN,NYC20,1,6,7
NYN201004200,2010,100420,NYN,CHN,NYC20,0,4,4
NYN201004210,2010,100421,NYN,CHN,NYC20,9,3,12
NYN201004220,2010,100422,NYN,CHN,NYC20,2,5,7
NYN201004230,2010,100423,NYN,ATL,NYC20,2,5,7
NYN201004240,2010,100424,NYN,ATL,NYC20,1,3,4
NYN201004250,2010,100425,NYN,ATL,NYC20,0,1,1
NYN201004271,2010,100427,NYN,LAN,NYC20,0,4,4
NYN201004272,2010,100427,NYN,LAN,NYC20,5,10,15
NYN201004280,2010,100428,NYN,LAN,NYC20,3,7,10
NYN201005070,2010,100507,NYN,SFN,NYC20,4,6,10
NYN201005080,2010,100508,NYN,SFN,NYC20,4,5,9
NYN201005090,2010,100509,NYN,SFN,NYC20,6,5,11
NYN201005100,2010,100510,NYN,WAS,NYC20,3,2,5
NYN201005110,2010,100511,NYN,WAS,NYC20,6,8,14
NYN201005120,2010,100512,NYN,WAS,NYC20,6,4,10
NYN201005210,2010,100521,NYN,NYA,NYC20,2,1,3
NYN201005220,2010,100522,NYN,NYA,NYC20,3,5,8
NYN201005230,2010,100523,NYN,NYA,NYC20,4,6,10
NYN201005250,2010,100525,NYN,PHI,NYC20,0,8,8
NYN201005260,2010,100526,NYN,PHI,NYC20,0,5,5
NYN201005270,2010,100527,NYN,PHI,NYC20,0,3,3
NYN201006040,2010,100604,NYN,FLO,NYC20,3,4,7
NYN201006050,2010,100605,NYN,FLO,NYC20,1,6,7
NYN201006060,2010,100606,NYN,FLO,NYC20,6,7,13
NYN201006080,2010,100608,NYN,SDN,NYC20,1,2,3
NYN201006101,2010,100610,NYN,SDN,NYC20,4,2,6
NYN201006102,2010,100610,NYN,SDN,NYC20,0,3,3
NYN201006220,2010,100622,NYN,DET,NYC20,6,14,20
NYN201006230,2010,100623,NYN,DET,NYC20,0,5,5
NYN201006240,2010,100624,NYN,DET,NYC20,6,5,11
NYN201006250,2010,100625,NYN,MIN,NYC20,2,5,7
NYN201006260,2010,100626,NYN,MIN,NYC20,6,0,6
NYN201006270,2010,100627,NYN,MIN,NYC20,0,6,6
NYN201007050,2010,100705,NYN,CIN,NYC20,8,6,14
NYN201007060,2010,100706,NYN,CIN,NYC20,0,3,3
NYN201007070,2010,100707,NYN,CIN,NYC20,3,1,4
NYN201007090,2010,100709,NYN,ATL,NYC20,4,2,6
NYN201007100,2010,100710,NYN,ATL,NYC20,4,0,4
NYN201007110,2010,100711,NYN,ATL,NYC20,0,3,3
NYN201007270,2010,100727,NYN,SLN,NYC20,2,8,10
NYN201007280,2010,100728,NYN,SLN,NYC20,8,7,15
NYN201007290,2010,100729,NYN,SLN,NYC20,0,4,4
NYN201007300,2010,100730,NYN,ARI,NYC20,9,6,15
NYN201007310,2010,100731,NYN,ARI,NYC20,4,5,9
NYN201008010,2010,100801,NYN,ARI,NYC20,14,1,15
NYN201008100,2010,100810,NYN,COL,NYC20,0,1,1
NYN201008110,2010,100811,NYN,COL,NYC20,6,2,8
NYN201008120,2010,100812,NYN,COL,NYC20,0,4,4
NYN201008130,2010,100813,NYN,PHI,NYC20,0,1,1
NYN201008140,2010,100814,NYN,PHI,NYC20,4,0,4
NYN201008150,2010,100815,NYN,PHI,NYC20,3,1,4
NYN201008240,2010,100824,NYN,FLO,NYC20,5,6,11
NYN201008250,2010,100825,NYN,FLO,NYC20,5,4,9
NYN201008260,2010,100826,NYN,FLO,NYC20,11,4,15
NYN201008270,2010,100827,NYN,HOU,NYC20,1,2,3
NYN201008280,2010,100828,NYN,HOU,NYC20,4,1,5
NYN201008290,2010,100829,NYN,HOU,NYC20,1,5,6
NYN201009100,2010,100910,NYN,PHI,NYC20,8,4,12
NYN201009110,2010,100911,NYN,PHI,NYC20,3,4,7
NYN201009120,2010,100912,NYN,PHI,NYC20,3,0,3
NYN201009130,2010,100913,NYN,PIT,NYC20,0,1,1
NYN201009140,2010,100914,NYN,PIT,NYC20,1,9,10
NYN201009150,2010,100915,NYN,PIT,NYC20,7,8,15
NYN201009160,2010,100916,NYN,PIT,NYC20,2,6,8
NYN201009170,2010,100917,NYN,ATL,NYC20,6,4,10
NYN201009180,2010,100918,NYN,ATL,NYC20,4,2,6
NYN201009190,2010,100919,NYN,ATL,NYC20,6,3,9
NYN201009280,2010,100928,NYN,MIL,NYC20,3,4,7
NYN201009291,2010,100929,NYN,MIL,NYC20,8,7,15
NYN201009292,2010,100929,NYN,MIL,NYC20,3,1,4
NYN201009300,2010,100930,NYN,MIL,NYC20,9,2,11
NYN201010010,2010,101001,NYN,WAS,NYC20,1,2,3
NYN201010020,2010,101002,NYN,WAS,NYC20,2,7,9
NYN201010030,2010,101003,NYN,WAS,NYC20,2,1,3
NYN201104080,2011,20110408,NYN,WAS,NYC20,6,2,8
NYN201104090,2011,20110409,NYN,WAS,NYC20,4,8,12
NYN201104100,2011,20110410,NYN,WAS,NYC20,7,3,10
NYN201104110,2011,20110411,NYN,COL,NYC20,7,6,13
NYN201104130,2011,20110413,NYN,COL,NYC20,5,4,9
NYN201104141,2011,20110414,NYN,COL,NYC20,6,5,11
NYN201104142,2011,20110414,NYN,COL,NYC20,9,4,13
NYN201104190,2011,20110419,NYN,HOU,NYC20,6,1,7
NYN201104200,2011,20110420,NYN,HOU,NYC20,4,3,7
NYN201104210,2011,20110421,NYN,HOU,NYC20,1,9,10
NYN201104220,2011,20110422,NYN,ARI,NYC20,1,4,5
NYN201104230,2011,20110423,NYN,ARI,NYC20,4,6,10
NYN201104240,2011,20110424,NYN,ARI,NYC20,4,8,12
NYN201105030,2011,20110503,NYN,SFN,NYC20,7,6,13
NYN201105040,2011,20110504,NYN,SFN,NYC20,2,0,2
NYN201105050,2011,20110505,NYN,SFN,NYC20,2,5,7
NYN201105060,2011,20110506,NYN,LAN,NYC20,3,6,9
NYN201105070,2011,20110507,NYN,LAN,NYC20,2,4,6
NYN201105080,2011,20110508,NYN,LAN,NYC20,4,2,6
NYN201105160,2011,20110516,NYN,FLO,NYC20,2,1,3
NYN201105180,2011,20110518,NYN,WAS,NYC20,0,3,3
NYN201105190,2011,20110519,NYN,WAS,NYC20,0,1,1
NYN201105270,2011,20110527,NYN,PHI,NYC20,6,4,10
NYN201105280,2011,20110528,NYN,PHI,NYC20,5,2,7
NYN201105290,2011,20110529,NYN,PHI,NYC20,5,9,14
NYN201105300,2011,20110530,NYN,PIT,NYC20,3,7,10
NYN201105310,2011,20110531,NYN,PIT,NYC20,5,1,6
NYN201106010,2011,20110601,NYN,PIT,NYC20,9,3,12
NYN201106020,2011,20110602,NYN,PIT,NYC20,8,9,17
NYN201106030,2011,20110603,NYN,ATL,NYC20,6,3,9
NYN201106040,2011,20110604,NYN,ATL,NYC20,0,5,5
NYN201106050,2011,20110605,NYN,ATL,NYC20,4,6,10
NYN201106170,2011,20110617,NYN,ANA,NYC20,4,3,7
NYN201106180,2011,20110618,NYN,ANA,NYC20,1,6,7
NYN201106190,2011,20110619,NYN,ANA,NYC20,7,3,10
NYN201106210,2011,20110621,NYN,OAK,NYC20,7,3,10
NYN201106220,2011,20110622,NYN,OAK,NYC20,2,3,5
NYN201106230,2011,20110623,NYN,OAK,NYC20,1,4,5
NYN201107010,2011,20110701,NYN,NYA,NYC20,5,1,6
NYN201107020,2011,20110702,NYN,NYA,NYC20,5,2,7
NYN201107030,2011,20110703,NYN,NYA,NYC20,2,3,5
NYN201107150,2011,20110715,NYN,PHI,NYC20,7,2,9
NYN201107160,2011,20110716,NYN,PHI,NYC20,2,11,13
NYN201107170,2011,20110717,NYN,PHI,NYC20,8,5,13
NYN201107180,2011,20110718,NYN,FLO,NYC20,4,1,5
NYN201107190,2011,20110719,NYN,SLN,NYC20,2,4,6
NYN201107200,2011,20110720,NYN,SLN,NYC20,5,6,11
NYN201107210,2011,20110721,NYN,SLN,NYC20,6,2,8
NYN201108010,2011,20110801,NYN,FLO,NYC20,7,3,10
NYN201108020,2011,20110802,NYN,FLO,NYC20,4,3,7
NYN201108050,2011,20110805,NYN,ATL,NYC20,4,1,5
NYN201108060,2011,20110806,NYN,ATL,NYC20,7,11,18
NYN201108070,2011,20110807,NYN,ATL,NYC20,6,5,11
NYN201108080,2011,20110808,NYN,SDN,NYC20,8,9,17
NYN201108090,2011,20110809,NYN,SDN,NYC20,4,5,9
NYN201108100,2011,20110810,NYN,SDN,NYC20,9,5,14
NYN201108110,2011,20110811,NYN,SDN,NYC20,3,2,5
NYN201108190,2011,20110819,NYN,MIL,NYC20,6,1,7
NYN201108200,2011,20110820,NYN,MIL,NYC20,11,9,20
NYN201108210,2011,20110821,NYN,MIL,NYC20,6,2,8
NYN201108260,2011,20110826,NYN,ATL,NYC20,0,6,6
NYN201108291,2011,20110829,NYN,FLO,NYC20,1,2,3
NYN201108292,2011,20110829,NYN,FLO,NYC20,1,5,6
NYN201108300,2011,20110830,NYN,FLO,NYC20,6,0,6
NYN201108310,2011,20110831,NYN,FLO,NYC20,2,3,5
NYN201109010,2011,20110901,NYN,FLO,NYC20,5,7,12
NYN201109081,2011,20110908,NYN,ATL,NYC20,6,5,11
NYN201109082,2011,20110908,NYN,ATL,NYC20,5,1,6
NYN201109090,2011,20110909,NYN,CHN,NYC20,4,5,9
NYN201109100,2011,20110910,NYN,CHN,NYC20,5,4,9
NYN201109110,2011,20110911,NYN,CHN,NYC20,10,6,16
NYN201109120,2011,20110912,NYN,WAS,NYC20,3,2,5
NYN201109130,2011,20110913,NYN,WAS,NYC20,3,2,5
NYN201109140,2011,20110914,NYN,WAS,NYC20,2,0,2
NYN201109150,2011,20110915,NYN,WAS,NYC20,10,1,11
NYN201109241,2011,20110924,NYN,PHI,NYC20,1,2,3
NYN201109242,2011,20110924,NYN,PHI,NYC20,3,6,9
NYN201109250,2011,20110925,NYN,PHI,NYC20,9,4,13
NYN201109260,2011,20110926,NYN,CIN,NYC20,6,5,11
NYN201109270,2011,20110927,NYN,CIN,NYC20,5,4,9
NYN201109280,2011,20110928,NYN,CIN,NYC20,0,3,3
NYN201204050,2012,120405,NYN,ATL,NYC20,0,1,1
NYN201204070,2012,120407,NYN,ATL,NYC20,2,4,6
NYN201204080,2012,120408,NYN,ATL,NYC20,5,7,12
NYN201204090,2012,120409,NYN,WAS,NYC20,3,4,7
NYN201204100,2012,120410,NYN,WAS,NYC20,6,2,8
NYN201204110,2012,120411,NYN,WAS,NYC20,4,0,4
NYN201204200,2012,120420,NYN,SFN,NYC20,4,3,7
NYN201204210,2012,120421,NYN,SFN,NYC20,4,5,9
NYN201204231,2012,120423,NYN,SFN,NYC20,6,1,7
NYN201204232,2012,120423,NYN,SFN,NYC20,7,2,9
NYN201204240,2012,120424,NYN,MIA,NYC20,1,2,3
NYN201204250,2012,120425,NYN,MIA,NYC20,1,5,6
NYN201204260,2012,120426,NYN,MIA,NYC20,2,3,5
NYN201205040,2012,120504,NYN,ARI,NYC20,5,4,9
NYN201205050,2012,120505,NYN,ARI,NYC20,3,4,7
NYN201205060,2012,120506,NYN,ARI,NYC20,1,3,4
NYN201205140,2012,120514,NYN,MIL,NYC20,1,3,4
NYN201205150,2012,120515,NYN,MIL,NYC20,8,0,8
NYN201205160,2012,120516,NYN,CIN,NYC20,6,3,9
NYN201205170,2012,120517,NYN,CIN,NYC20,4,9,13
NYN201205240,2012,120524,NYN,SDN,NYC20,11,5,16
NYN201205250,2012,120525,NYN,SDN,NYC20,1,6,7
NYN201205260,2012,120526,NYN,SDN,NYC20,0,9,9
NYN201205270,2012,120527,NYN,SDN,NYC20,0,2,2
NYN201205280,2012,120528,NYN,PHI,NYC20,8,4,12
NYN201205290,2012,120529,NYN,PHI,NYC20,3,6,9
NYN201205300,2012,120530,NYN,PHI,NYC20,10,6,16
NYN201206010,2012,120601,NYN,SLN,NYC20,0,8,8
NYN201206020,2012,120602,NYN,SLN,NYC20,0,5,5
NYN201206030,2012,120603,NYN,SLN,NYC20,1,6,7
NYN201206040,2012,120604,NYN,SLN,NYC20,5,4,9
NYN201206150,2012,120615,NYN,CIN,NYC20,7,3,10
NYN201206160,2012,120616,NYN,CIN,NYC20,4,1,5
NYN201206170,2012,120617,NYN,CIN,NYC20,3,1,4
NYN201206180,2012,120618,NYN,BAL,NYC20,0,5,5
NYN201206190,2012,120619,NYN,BAL,NYC20,0,5,5
NYN201206200,2012,120620,NYN,BAL,NYC20,3,4,7
NYN201206220,2012,120622,NYN,NYA,NYC20,4,6,10
NYN201206230,2012,120623,NYN,NYA,NYC20,4,3,7
NYN201206240,2012,120624,NYN,NYA,NYC20,6,5,11
NYN201207030,2012,120703,NYN,PHI,NYC20,1,11,12
NYN201207040,2012,120704,NYN,PHI,NYC20,9,2,11
NYN201207050,2012,120705,NYN,PHI,NYC20,5,6,11
NYN201207060,2012,120706,NYN,CHN,NYC20,8,7,15
NYN201207070,2012,120707,NYN,CHN,NYC20,1,3,4
NYN201207080,2012,120708,NYN,CHN,NYC20,7,0,7
NYN201207200,2012,120720,NYN,LAN,NYC20,7,6,13
NYN201207210,2012,120721,NYN,LAN,NYC20,8,5,13
NYN201207220,2012,120722,NYN,LAN,NYC20,8,3,11
NYN201207230,2012,120723,NYN,WAS,NYC20,8,2,10
NYN201207240,2012,120724,NYN,WAS,NYC20,5,2,7
NYN201207250,2012,120725,NYN,WAS,NYC20,5,2,7
NYN201208070,2012,120807,NYN,MIA,NYC20,4,2,6
NYN201208080,2012,120808,NYN,MIA,NYC20,13,0,13
NYN201208090,2012,120809,NYN,MIA,NYC20,1,6,7
NYN201208100,2012,120810,NYN,ATL,NYC20,4,0,4
NYN201208110,2012,120811,NYN,ATL,NYC20,9,3,12
NYN201208120,2012,120812,NYN,ATL,NYC20,5,6,11
NYN201208200,2012,120820,NYN,COL,NYC20,3,1,4
NYN201208210,2012,120821,NYN,COL,NYC20,6,2,8
NYN201208220,2012,120822,NYN,COL,NYC20,5,2,7
NYN201208230,2012,120823,NYN,COL,NYC20,1,0,1
NYN201208240,2012,120824,NYN,HOU,NYC20,3,1,4
NYN201208250,2012,120825,NYN,HOU,NYC20,1,3,4
NYN201208260,2012,120826,NYN,HOU,NYC20,1,2,3
NYN201209070,2012,120907,NYN,ATL,NYC20,3,0,3
NYN201209080,2012,120908,NYN,ATL,NYC20,11,3,14
NYN201209090,2012,120909,NYN,ATL,NYC20,3,2,5
NYN201209100,2012,120910,NYN,WAS,NYC20,5,1,6
NYN201209110,2012,120911,NYN,WAS,NYC20,5,3,8
NYN201209120,2012,120912,NYN,WAS,NYC20,2,0,2
NYN201209170,2012,120917,NYN,PHI,NYC20,3,1,4
NYN201209190,2012,120919,NYN,PHI,NYC20,3,2,5
NYN201209200,2012,120920,NYN,PHI,NYC20,16,1,17
NYN201209210,2012,120921,NYN,MIA,NYC20,3,7,10
NYN201209220,2012,120922,NYN,MIA,NYC20,3,4,7
NYN201209230,2012,120923,NYN,MIA,NYC20,2,3,5
NYN201209240,2012,120924,NYN,PIT,NYC20,2,6,8
NYN201209250,2012,120925,NYN,PIT,NYC20,10,6,16
NYN201209260,2012,120926,NYN,PIT,NYC20,0,6,6
NYN201209270,2012,120927,NYN,PIT,NYC20,5,6,11
NYN201304010,2013,20130401,NYN,SDN,NYC20,2,11,13
NYN201304030,2013,20130403,NYN,SDN,NYC20,4,8,12
NYN201304040,2013,20130404,NYN,SDN,NYC20,2,1,3
NYN201304050,2013,20130405,NYN,MIA,NYC20,7,5,12
NYN201304060,2013,20130406,NYN,MIA,NYC20,3,7,10
NYN201304070,2013,20130407,NYN,MIA,NYC20,3,4,7
NYN201304190,2013,20130419,NYN,WAS,NYC20,1,7,8
NYN201304200,2013,20130420,NYN,WAS,NYC20,7,6,13
NYN201304210,2013,20130421,NYN,WAS,NYC20,0,2,2
NYN201304230,2013,20130423,NYN,LAN,NYC20,7,2,9
NYN201304240,2013,20130424,NYN,LAN,NYC20,3,7,10
NYN201304250,2013,20130425,NYN,LAN,NYC20,3,2,5
NYN201304260,2013,20130426,NYN,PHI,NYC20,4,0,4
NYN201304270,2013,20130427,NYN,PHI,NYC20,9,4,13
NYN201304280,2013,20130428,NYN,PHI,NYC20,5,1,6
NYN201305070,2013,20130507,NYN,CHA,NYC20,0,1,1
NYN201305080,2013,20130508,NYN,CHA,NYC20,6,3,9
NYN201305090,2013,20130509,NYN,PIT,NYC20,2,3,5
NYN201305100,2013,20130510,NYN,PIT,NYC20,7,3,10
NYN201305110,2013,20130511,NYN,PIT,NYC20,11,2,13
NYN201305120,2013,20130512,NYN,PIT,NYC20,3,2,5
NYN201305200,2013,20130520,NYN,CIN,NYC20,4,3,7
NYN201305210,2013,20130521,NYN,CIN,NYC20,4,0,4
NYN201305220,2013,20130522,NYN,CIN,NYC20,7,4,11
NYN201305240,2013,20130524,NYN,ATL,NYC20,7,5,12
NYN201305250,2013,20130525,NYN,ATL,NYC20,6,0,6
NYN201305260,2013,20130526,NYN,ATL,NYC20,2,4,6
NYN201305270,2013,20130527,NYN,NYA,NYC20,1,2,3
NYN201305280,2013,20130528,NYN,NYA,NYC20,1,2,3
NYN201306080,2013,20130608,NYN,MIA,NYC20,2,1,3
NYN201306090,2013,20130609,NYN,MIA,NYC20,8,4,12
NYN201306110,2013,20130611,NYN,SLN,NYC20,9,2,11
NYN201306120,2013,20130612,NYN,SLN,NYC20,1,5,6
NYN201306130,2013,20130613,NYN,SLN,NYC20,2,1,3
NYN201306140,2013,20130614,NYN,CHN,NYC20,6,3,9
NYN201306150,2013,20130615,NYN,CHN,NYC20,5,2,7
NYN201306160,2013,20130616,NYN,CHN,NYC20,3,4,7
NYN201306280,2013,20130628,NYN,WAS,NYC20,6,4,10
NYN201306290,2013,20130629,NYN,WAS,NYC20,1,5,6
NYN201306300,2013,20130630,NYN,WAS,NYC20,13,2,15
NYN201307010,2013,20130701,NYN,ARI,NYC20,4,5,9
NYN201307020,2013,20130702,NYN,ARI,NYC20,1,9,10
NYN201307030,2013,20130703,NYN,ARI,NYC20,5,3,8
NYN201307040,2013,20130704,NYN,ARI,NYC20,5,4,9
NYN201307190,2013,20130719,NYN,PHI,NYC20,13,8,21
NYN201307200,2013,20130720,NYN,PHI,NYC20,4,5,9
NYN201307210,2013,20130721,NYN,PHI,NYC20,0,5,5
NYN201307220,2013,20130722,NYN,ATL,NYC20,2,1,3
NYN201307230,2013,20130723,NYN,ATL,NYC20,1,4,5
NYN201307240,2013,20130724,NYN,ATL,NYC20,8,2,10
NYN201307250,2013,20130725,NYN,ATL,NYC20,4,7,11
NYN201308020,2013,20130802,NYN,KCA,NYC20,2,4,6
NYN201308030,2013,20130803,NYN,KCA,NYC20,4,3,7
NYN201308040,2013,20130804,NYN,KCA,NYC20,6,2,8
NYN201308060,2013,20130806,NYN,COL,NYC20,2,3,5
NYN201308070,2013,20130807,NYN,COL,NYC20,0,5,5
NYN201308080,2013,20130808,NYN,COL,NYC20,1,2,3
NYN201308200,2013,20130820,NYN,ATL,NYC20,3,5,8
NYN201308210,2013,20130821,NYN,ATL,NYC20,4,1,5
NYN201308230,2013,20130823,NYN,DET,NYC20,6,1,7
NYN201308240,2013,20130824,NYN,DET,NYC20,3,0,3
NYN201308250,2013,20130825,NYN,DET,NYC20,11,3,14
NYN201308260,2013,20130826,NYN,PHI,NYC20,2,1,3
NYN201308270,2013,20130827,NYN,PHI,NYC20,0,5,5
NYN201308280,2013,20130828,NYN,PHI,NYC20,6,2,8
NYN201308290,2013,20130829,NYN,PHI,NYC20,3,11,14
NYN201309090,2013,20130909,NYN,WAS,NYC20,9,0,9
NYN201309100,2013,20130910,NYN,WAS,NYC20,6,3,9
NYN201309110,2013,20130911,NYN,WAS,NYC20,3,0,3
NYN201309120,2013,20130912,NYN,WAS,NYC20,7,2,9
NYN201309130,2013,20130913,NYN,MIA,NYC20,3,4,7
NYN201309141,2013,20130914,NYN,MIA,NYC20,3,0,3
NYN201309142,2013,20130914,NYN,MIA,NYC20,1,3,4
NYN201309150,2013,20130915,NYN,MIA,NYC20,0,1,1
NYN201309170,2013,20130917,NYN,SFN,NYC20,8,5,13
NYN201309180,2013,20130918,NYN,SFN,NYC20,4,5,9
NYN201309190,2013,20130919,NYN,SFN,NYC20,2,1,3
NYN201309260,2013,20130926,NYN,MIL,NYC20,4,2,6
NYN201309270,2013,20130927,NYN,MIL,NYC20,4,2,6
NYN201309280,2013,20130928,NYN,MIL,NYC20,4,2,6
NYN201309290,2013,20130929,NYN,MIL,NYC20,2,3,5
OAK201004050,2010,100405,OAK,SEA,OAK01,5,3,8
OAK201004060,2010,100406,OAK,SEA,OAK01,1,2,3
OAK201004070,2010,100407,OAK,SEA,OAK01,5,6,11
OAK201004080,2010,100408,OAK,SEA,OAK01,2,6,8
OAK201004150,2010,100415,OAK,BAL,OAK01,2,6,8
OAK201004160,2010,100416,OAK,BAL,OAK01,2,4,6
OAK201004170,2010,100417,OAK,BAL,OAK01,3,4,7
OAK201004180,2010,100418,OAK,BAL,OAK01,8,3,11
OAK201004200,2010,100420,OAK,NYA,OAK01,7,3,10
OAK201004210,2010,100421,OAK,NYA,OAK01,3,1,4
OAK201004220,2010,100422,OAK,NYA,OAK01,2,4,6
OAK201004230,2010,100423,OAK,CLE,OAK01,0,10,10
OAK201004240,2010,100424,OAK,CLE,OAK01,6,1,7
OAK201004250,2010,100425,OAK,CLE,OAK01,0,11,11
OAK201005030,2010,100503,OAK,TEX,OAK01,4,2,6
OAK201005040,2010,100504,OAK,TEX,OAK01,6,7,13
OAK201005050,2010,100505,OAK,TEX,OAK01,1,4,5
OAK201005070,2010,100507,OAK,TBA,OAK01,4,1,5
OAK201005080,2010,100508,OAK,TBA,OAK01,2,4,6
OAK201005090,2010,100509,OAK,TBA,OAK01,0,4,4
OAK201005170,2010,100517,OAK,SEA,OAK01,4,8,12
OAK201005180,2010,100518,OAK,SEA,OAK01,5,6,11
OAK201005190,2010,100519,OAK,DET,OAK01,5,1,6
OAK201005200,2010,100520,OAK,DET,OAK01,5,2,7
OAK201005210,2010,100521,OAK,SFN,OAK01,1,6,7
OAK201005220,2010,100522,OAK,SFN,OAK01,0,1,1
OAK201005230,2010,100523,OAK,SFN,OAK01,0,3,3
OAK201006040,2010,100604,OAK,MIN,OAK01,5,4,9
OAK201006050,2010,100605,OAK,MIN,OAK01,4,3,7
OAK201006060,2010,100606,OAK,MIN,OAK01,4,5,9
OAK201006070,2010,100607,OAK,ANA,OAK01,4,2,6
OAK201006080,2010,100608,OAK,ANA,OAK01,1,10,11
OAK201006090,2010,100609,OAK,ANA,OAK01,7,1,8
OAK201006100,2010,100610,OAK,ANA,OAK01,1,6,7
OAK201006210,2010,100621,OAK,CIN,OAK01,6,4,10
OAK201006220,2010,100622,OAK,CIN,OAK01,4,2,6
OAK201006230,2010,100623,OAK,CIN,OAK01,3,0,3
OAK201006250,2010,100625,OAK,PIT,OAK01,4,14,18
OAK201006260,2010,100626,OAK,PIT,OAK01,0,5,5
OAK201006270,2010,100627,OAK,PIT,OAK01,2,3,5
OAK201007050,2010,100705,OAK,NYA,OAK01,3,1,4
OAK201007060,2010,100706,OAK,NYA,OAK01,6,1,7
OAK201007070,2010,100707,OAK,NYA,OAK01,6,2,8
OAK201007090,2010,100709,OAK,ANA,OAK01,6,5,11
OAK201007100,2010,100710,OAK,ANA,OAK01,1,15,16
OAK201007110,2010,100711,OAK,ANA,OAK01,2,5,7
OAK201007190,2010,100719,OAK,BOS,OAK01,2,1,3
OAK201007200,2010,100720,OAK,BOS,OAK01,4,5,9
OAK201007210,2010,100721,OAK,BOS,OAK01,4,6,10
OAK201007230,2010,100723,OAK,CHA,OAK01,5,1,6
OAK201007240,2010,100724,OAK,CHA,OAK01,2,10,12
OAK201007250,2010,100725,OAK,CHA,OAK01,4,6,10
OAK201008020,2010,100802,OAK,KCA,OAK01,0,6,6
OAK201008030,2010,100803,OAK,KCA,OAK01,3,2,5
OAK201008040,2010,100804,OAK,KCA,OAK01,3,4,7
OAK201008060,2010,100806,OAK,TEX,OAK01,5,1,6
OAK201008070,2010,100807,OAK,TEX,OAK01,2,6,8
OAK201008080,2010,100808,OAK,TEX,OAK01,2,3,5
OAK201008160,2010,100816,OAK,TOR,OAK01,3,1,4
OAK201008170,2010,100817,OAK,TOR,OAK01,2,6,8
OAK201008180,2010,100818,OAK,TOR,OAK01,4,5,9
OAK201008190,2010,100819,OAK,TBA,OAK01,3,4,7
OAK201008200,2010,100820,OAK,TBA,OAK01,4,5,9
OAK201008210,2010,100821,OAK,TBA,OAK01,5,4,9
OAK201008220,2010,100822,OAK,TBA,OAK01,3,2,5
OAK201009030,2010,100903,OAK,ANA,OAK01,0,8,8
OAK201009040,2010,100904,OAK,ANA,OAK01,1,3,4
OAK201009050,2010,100905,OAK,ANA,OAK01,7,4,11
OAK201009060,2010,100906,OAK,SEA,OAK01,2,6,8
OAK201009070,2010,100907,OAK,SEA,OAK01,7,5,12
OAK201009080,2010,100908,OAK,SEA,OAK01,3,4,7
OAK201009100,2010,100910,OAK,BOS,OAK01,0,5,5
OAK201009110,2010,100911,OAK,BOS,OAK01,3,4,7
OAK201009120,2010,100912,OAK,BOS,OAK01,5,3,8
OAK201009200,2010,100920,OAK,CHA,OAK01,0,3,3
OAK201009210,2010,100921,OAK,CHA,OAK01,2,7,9
OAK201009220,2010,100922,OAK,CHA,OAK01,4,3,7
OAK201009230,2010,100923,OAK,TEX,OAK01,0,5,5
OAK201009240,2010,100924,OAK,TEX,OAK01,10,3,13
OAK201009250,2010,100925,OAK,TEX,OAK01,4,3,7
OAK201009260,2010,100926,OAK,TEX,OAK01,16,9,25
OAK201104010,2011,20110401,OAK,SEA,OAK01,6,2,8
OAK201104020,2011,20110402,OAK,SEA,OAK01,5,2,7
OAK201104030,2011,20110403,OAK,SEA,OAK01,1,7,8
OAK201104140,2011,20110414,OAK,DET,OAK01,3,0,3
OAK201104150,2011,20110415,OAK,DET,OAK01,8,4,12
OAK201104160,2011,20110416,OAK,DET,OAK01,2,6,8
OAK201104170,2011,20110417,OAK,DET,OAK01,1,5,6
OAK201104190,2011,20110419,OAK,BOS,OAK01,0,5,5
OAK201104200,2011,20110420,OAK,BOS,OAK01,5,3,8
OAK201104290,2011,20110429,OAK,TEX,OAK01,1,3,4
OAK201104300,2011,20110430,OAK,TEX,OAK01,11,2,13
OAK201105010,2011,20110501,OAK,TEX,OAK01,2,7,9
OAK201105020,2011,20110502,OAK,TEX,OAK01,4,5,9
OAK201105030,2011,20110503,OAK,CLE,OAK01,4,1,5
OAK201105040,2011,20110504,OAK,CLE,OAK01,1,3,4
OAK201105050,2011,20110505,OAK,CLE,OAK01,4,3,7
OAK201105130,2011,20110513,OAK,CHA,OAK01,4,3,7
OAK201105140,2011,20110514,OAK,CHA,OAK01,2,6,8
OAK201105150,2011,20110515,OAK,CHA,OAK01,4,3,7
OAK201105160,2011,20110516,OAK,ANA,OAK01,4,5,9
OAK201105170,2011,20110517,OAK,ANA,OAK01,0,14,14
OAK201105180,2011,20110518,OAK,MIN,OAK01,4,3,7
OAK201105190,2011,20110519,OAK,MIN,OAK01,11,1,12
OAK201105270,2011,20110527,OAK,BAL,OAK01,2,6,8
OAK201105280,2011,20110528,OAK,BAL,OAK01,2,4,6
OAK201105290,2011,20110529,OAK,BAL,OAK01,4,6,10
OAK201105300,2011,20110530,OAK,NYA,OAK01,5,0,5
OAK201105310,2011,20110531,OAK,NYA,OAK01,10,3,13
OAK201106010,2011,20110601,OAK,NYA,OAK01,4,2,6
OAK201106140,2011,20110614,OAK,KCA,OAK01,7,4,11
OAK201106150,2011,20110615,OAK,KCA,OAK01,1,2,3
OAK201106160,2011,20110616,OAK,KCA,OAK01,4,8,12
OAK201106170,2011,20110617,OAK,SFN,OAK01,2,5,7
OAK201106180,2011,20110618,OAK,SFN,OAK01,2,4,6
OAK201106190,2011,20110619,OAK,SFN,OAK01,1,2,3
OAK201106280,2011,20110628,OAK,FLO,OAK01,0,1,1
OAK201106290,2011,20110629,OAK,FLO,OAK01,3,0,3
OAK201106300,2011,20110630,OAK,FLO,OAK01,5,4,9
OAK201107010,2011,20110701,OAK,ARI,OAK01,4,5,9
OAK201107020,2011,20110702,OAK,ARI,OAK01,4,2,6
OAK201107030,2011,20110703,OAK,ARI,OAK01,2,7,9
OAK201107040,2011,20110704,OAK,SEA,OAK01,2,1,3
OAK201107050,2011,20110705,OAK,SEA,OAK01,4,2,6
OAK201107060,2011,20110706,OAK,SEA,OAK01,0,2,2
OAK201107150,2011,20110715,OAK,ANA,OAK01,3,5,8
OAK201107161,2011,20110716,OAK,ANA,OAK01,4,2,6
OAK201107162,2011,20110716,OAK,ANA,OAK01,3,4,7
OAK201107170,2011,20110717,OAK,ANA,OAK01,1,9,10
OAK201107250,2011,20110725,OAK,TBA,OAK01,5,7,12
OAK201107260,2011,20110726,OAK,TBA,OAK01,1,6,7
OAK201107270,2011,20110727,OAK,TBA,OAK01,4,13,17
OAK201107280,2011,20110728,OAK,TBA,OAK01,10,8,18
OAK201107290,2011,20110729,OAK,MIN,OAK01,9,5,14
OAK201107300,2011,20110730,OAK,MIN,OAK01,3,8,11
OAK201107310,2011,20110731,OAK,MIN,OAK01,3,7,10
OAK201108120,2011,20110812,OAK,TEX,OAK01,9,1,10
OAK201108130,2011,20110813,OAK,TEX,OAK01,7,1,8
OAK201108140,2011,20110814,OAK,TEX,OAK01,7,6,13
OAK201108150,2011,20110815,OAK,BAL,OAK01,6,2,8
OAK201108160,2011,20110816,OAK,BAL,OAK01,4,8,12
OAK201108170,2011,20110817,OAK,BAL,OAK01,5,6,11
OAK201108180,2011,20110818,OAK,TOR,OAK01,7,0,7
OAK201108190,2011,20110819,OAK,TOR,OAK01,0,2,2
OAK201108200,2011,20110820,OAK,TOR,OAK01,1,5,6
OAK201108210,2011,20110821,OAK,TOR,OAK01,1,0,1
OAK201109020,2011,20110902,OAK,SEA,OAK01,2,9,11
OAK201109030,2011,20110903,OAK,SEA,OAK01,0,3,3
OAK201109040,2011,20110904,OAK,SEA,OAK01,5,8,13
OAK201109050,2011,20110905,OAK,KCA,OAK01,11,6,17
OAK201109060,2011,20110906,OAK,KCA,OAK01,7,4,11
OAK201109070,2011,20110907,OAK,KCA,OAK01,0,7,7
OAK201109120,2011,20110912,OAK,ANA,OAK01,3,6,9
OAK201109130,2011,20110913,OAK,ANA,OAK01,6,3,9
OAK201109140,2011,20110914,OAK,ANA,OAK01,4,1,5
OAK201109150,2011,20110915,OAK,DET,OAK01,1,6,7
OAK201109160,2011,20110916,OAK,DET,OAK01,3,1,4
OAK201109170,2011,20110917,OAK,DET,OAK01,3,5,8
OAK201109180,2011,20110918,OAK,DET,OAK01,3,0,3
OAK201109200,2011,20110920,OAK,TEX,OAK01,7,2,9
OAK201109210,2011,20110921,OAK,TEX,OAK01,3,2,5
OAK201109220,2011,20110922,OAK,TEX,OAK01,3,4,7
OAK201203280,2012,120328,OAK,SEA,TOK01,3,1,4
OAK201203290,2012,120329,OAK,SEA,TOK01,1,4,5
OAK201204060,2012,120406,OAK,SEA,OAK01,7,3,10
OAK201204070,2012,120407,OAK,SEA,OAK01,8,7,15
OAK201204090,2012,120409,OAK,KCA,OAK01,0,1,1
OAK201204100,2012,120410,OAK,KCA,OAK01,3,0,3
OAK201204110,2012,120411,OAK,KCA,OAK01,4,5,9
OAK201204200,2012,120420,OAK,CLE,OAK01,4,3,7
OAK201204210,2012,120421,OAK,CLE,OAK01,5,1,6
OAK201204220,2012,120422,OAK,CLE,OAK01,1,5,6
OAK201204230,2012,120423,OAK,CHA,OAK01,4,0,4
OAK201204240,2012,120424,OAK,CHA,OAK01,0,2,2
OAK201204250,2012,120425,OAK,CHA,OAK01,4,5,9
OAK201205080,2012,120508,OAK,TOR,OAK01,3,7,10
OAK201205090,2012,120509,OAK,TOR,OAK01,5,2,7
OAK201205100,2012,120510,OAK,DET,OAK01,10,6,16
OAK201205110,2012,120511,OAK,DET,OAK01,4,11,15
OAK201205120,2012,120512,OAK,DET,OAK01,1,3,4
OAK201205130,2012,120513,OAK,DET,OAK01,3,1,4
OAK201205210,2012,120521,OAK,ANA,OAK01,1,2,3
OAK201205220,2012,120522,OAK,ANA,OAK01,5,0,5
OAK201205230,2012,120523,OAK,ANA,OAK01,3,1,4
OAK201205250,2012,120525,OAK,NYA,OAK01,6,3,9
OAK201205260,2012,120526,OAK,NYA,OAK01,9,2,11
OAK201205270,2012,120527,OAK,NYA,OAK01,2,0,2
OAK201206040,2012,120604,OAK,TEX,OAK01,1,12,13
OAK201206050,2012,120605,OAK,TEX,OAK01,6,3,9
OAK201206060,2012,120606,OAK,TEX,OAK01,0,2,2
OAK201206070,2012,120607,OAK,TEX,OAK01,1,7,8
OAK201206150,2012,120615,OAK,SDN,OAK01,2,10,12
OAK201206160,2012,120616,OAK,SDN,OAK01,4,6,10
OAK201206170,2012,120617,OAK,SDN,OAK01,2,1,3
OAK201206190,2012,120619,OAK,LAN,OAK01,0,3,3
OAK201206200,2012,120620,OAK,LAN,OAK01,1,4,5
OAK201206210,2012,120621,OAK,LAN,OAK01,1,4,5
OAK201206220,2012,120622,OAK,SFN,OAK01,5,4,9
OAK201206230,2012,120623,OAK,SFN,OAK01,9,8,17
OAK201206240,2012,120624,OAK,SFN,OAK01,2,4,6
OAK201207020,2012,120702,OAK,BOS,OAK01,1,6,7
OAK201207030,2012,120703,OAK,BOS,OAK01,2,3,5
OAK201207040,2012,120704,OAK,BOS,OAK01,2,3,5
OAK201207060,2012,120706,OAK,SEA,OAK01,1,4,5
OAK201207070,2012,120707,OAK,SEA,OAK01,7,1,8
OAK201207080,2012,120708,OAK,SEA,OAK01,1,2,3
OAK201207170,2012,120717,OAK,TEX,OAK01,6,1,7
OAK201207180,2012,120718,OAK,TEX,OAK01,3,4,7
OAK201207190,2012,120719,OAK,NYA,OAK01,3,4,7
OAK201207200,2012,120720,OAK,NYA,OAK01,2,3,5
OAK201207210,2012,120721,OAK,NYA,OAK01,1,2,3
OAK201207220,2012,120722,OAK,NYA,OAK01,4,5,9
OAK201207300,2012,120730,OAK,TBA,OAK01,3,4,7
OAK201207310,2012,120731,OAK,TBA,OAK01,8,0,8
OAK201208010,2012,120801,OAK,TBA,OAK01,4,1,5
OAK201208020,2012,120802,OAK,TOR,OAK01,1,4,5
OAK201208030,2012,120803,OAK,TOR,OAK01,4,5,9
OAK201208040,2012,120804,OAK,TOR,OAK01,3,1,4
OAK201208050,2012,120805,OAK,TOR,OAK01,6,5,11
OAK201208060,2012,120806,OAK,ANA,OAK01,4,0,4
OAK201208070,2012,120807,OAK,ANA,OAK01,4,10,14
OAK201208080,2012,120808,OAK,ANA,OAK01,8,9,17
OAK201208170,2012,120817,OAK,CLE,OAK01,4,6,10
OAK201208180,2012,120818,OAK,CLE,OAK01,5,8,13
OAK201208190,2012,120819,OAK,CLE,OAK01,0,7,7
OAK201208200,2012,120820,OAK,MIN,OAK01,7,2,9
OAK201208210,2012,120821,OAK,MIN,OAK01,1,4,5
OAK201208220,2012,120822,OAK,MIN,OAK01,1,5,6
OAK201208310,2012,120831,OAK,BOS,OAK01,2,20,22
OAK201209010,2012,120901,OAK,BOS,OAK01,1,7,8
OAK201209020,2012,120902,OAK,BOS,OAK01,2,6,8
OAK201209030,2012,120903,OAK,ANA,OAK01,8,3,11
OAK201209040,2012,120904,OAK,ANA,OAK01,6,1,7
OAK201209050,2012,120905,OAK,ANA,OAK01,7,1,8
OAK201209140,2012,120914,OAK,BAL,OAK01,2,3,5
OAK201209150,2012,120915,OAK,BAL,OAK01,2,5,7
OAK201209160,2012,120916,OAK,BAL,OAK01,9,5,14
OAK201209280,2012,120928,OAK,SEA,OAK01,2,8,10
OAK201209290,2012,120929,OAK,SEA,OAK01,4,7,11
OAK201209300,2012,120930,OAK,SEA,OAK01,2,5,7
OAK201210010,2012,121001,OAK,TEX,OAK01,3,4,7
OAK201210020,2012,121002,OAK,TEX,OAK01,1,3,4
OAK201210030,2012,121003,OAK,TEX,OAK01,5,12,17
OAK201210090,2012,121009,OAK,DET,OAK01,0,2,2
OAK201210100,2012,121010,OAK,DET,OAK01,3,4,7
OAK201210110,2012,121011,OAK,DET,OAK01,6,0,6
OAK201304010,2013,20130401,OAK,SEA,OAK01,2,0,2
OAK201304020,2013,20130402,OAK,SEA,OAK01,7,1,8
OAK201304030,2013,20130403,OAK,SEA,OAK01,2,6,8
OAK201304040,2013,20130404,OAK,SEA,OAK01,2,8,10
OAK201304120,2013,20130412,OAK,DET,OAK01,3,4,7
OAK201304130,2013,20130413,OAK,DET,OAK01,7,3,10
OAK201304140,2013,20130414,OAK,DET,OAK01,10,1,11
OAK201304150,2013,20130415,OAK,HOU,OAK01,2,11,13
OAK201304160,2013,20130416,OAK,HOU,OAK01,3,4,7
OAK201304170,2013,20130417,OAK,HOU,OAK01,5,7,12
OAK201304250,2013,20130425,OAK,BAL,OAK01,10,2,12
OAK201304260,2013,20130426,OAK,BAL,OAK01,3,0,3
OAK201304270,2013,20130427,OAK,BAL,OAK01,7,3,10
OAK201304280,2013,20130428,OAK,BAL,OAK01,8,9,17
OAK201304290,2013,20130429,OAK,ANA,OAK01,8,10,18
OAK201304300,2013,20130430,OAK,ANA,OAK01,6,10,16
OAK201305010,2013,20130501,OAK,ANA,OAK01,5,4,9
OAK201305130,2013,20130513,OAK,TEX,OAK01,1,5,6
OAK201305140,2013,20130514,OAK,TEX,OAK01,6,5,11
OAK201305150,2013,20130515,OAK,TEX,OAK01,6,2,8
OAK201305170,2013,20130517,OAK,KCA,OAK01,1,2,3
OAK201305180,2013,20130518,OAK,KCA,OAK01,1,2,3
OAK201305190,2013,20130519,OAK,KCA,OAK01,3,4,7
OAK201305270,2013,20130527,OAK,SFN,OAK01,1,4,5
OAK201305280,2013,20130528,OAK,SFN,OAK01,3,6,9
OAK201305310,2013,20130531,OAK,CHA,OAK01,0,3,3
OAK201306010,2013,20130601,OAK,CHA,OAK01,3,4,7
OAK201306020,2013,20130602,OAK,CHA,OAK01,0,2,2
OAK201306110,2013,20130611,OAK,NYA,OAK01,4,6,10
OAK201306120,2013,20130612,OAK,NYA,OAK01,2,5,7
OAK201306130,2013,20130613,OAK,NYA,OAK01,2,3,5
OAK201306140,2013,20130614,OAK,SEA,OAK01,3,2,5
OAK201306150,2013,20130615,OAK,SEA,OAK01,4,0,4
OAK201306160,2013,20130616,OAK,SEA,OAK01,2,10,12
OAK201306250,2013,20130625,OAK,CIN,OAK01,3,7,10
OAK201306260,2013,20130626,OAK,CIN,OAK01,0,5,5
OAK201306280,2013,20130628,OAK,SLN,OAK01,1,6,7
OAK201306290,2013,20130629,OAK,SLN,OAK01,7,1,8
OAK201306300,2013,20130630,OAK,SLN,OAK01,5,7,12
OAK201307020,2013,20130702,OAK,CHN,OAK01,7,8,15
OAK201307030,2013,20130703,OAK,CHN,OAK01,3,1,4
OAK201307040,2013,20130704,OAK,CHN,OAK01,0,1,1
OAK201307120,2013,20130712,OAK,BOS,OAK01,4,2,6
OAK201307130,2013,20130713,OAK,BOS,OAK01,0,3,3
OAK201307140,2013,20130714,OAK,BOS,OAK01,2,3,5
OAK201307250,2013,20130725,OAK,ANA,OAK01,8,3,11
OAK201307260,2013,20130726,OAK,ANA,OAK01,4,6,10
OAK201307270,2013,20130727,OAK,ANA,OAK01,1,3,4
OAK201307280,2013,20130728,OAK,ANA,OAK01,6,10,16
OAK201307290,2013,20130729,OAK,TOR,OAK01,4,9,13
OAK201307300,2013,20130730,OAK,TOR,OAK01,5,0,5
OAK201307310,2013,20130731,OAK,TOR,OAK01,5,2,7
OAK201308020,2013,20130802,OAK,TEX,OAK01,8,3,11
OAK201308030,2013,20130803,OAK,TEX,OAK01,2,4,6
OAK201308040,2013,20130804,OAK,TEX,OAK01,4,0,4
OAK201308130,2013,20130813,OAK,HOU,OAK01,5,4,9
OAK201308140,2013,20130814,OAK,HOU,OAK01,2,1,3
OAK201308150,2013,20130815,OAK,HOU,OAK01,0,5,5
OAK201308160,2013,20130816,OAK,CLE,OAK01,2,3,5
OAK201308170,2013,20130817,OAK,CLE,OAK01,7,1,8
OAK201308180,2013,20130818,OAK,CLE,OAK01,3,7,10
OAK201308190,2013,20130819,OAK,SEA,OAK01,1,2,3
OAK201308200,2013,20130820,OAK,SEA,OAK01,7,4,11
OAK201308210,2013,20130821,OAK,SEA,OAK01,5,3,8
OAK201308300,2013,20130830,OAK,TBA,OAK01,3,4,7
OAK201308310,2013,20130831,OAK,TBA,OAK01,1,2,3
OAK201309010,2013,20130901,OAK,TBA,OAK01,1,5,6
OAK201309020,2013,20130902,OAK,TEX,OAK01,2,4,6
OAK201309030,2013,20130903,OAK,TEX,OAK01,5,1,6
OAK201309040,2013,20130904,OAK,TEX,OAK01,4,11,15
OAK201309050,2013,20130905,OAK,HOU,OAK01,3,2,5
OAK201309060,2013,20130906,OAK,HOU,OAK01,5,7,12
OAK201309070,2013,20130907,OAK,HOU,OAK01,1,2,3
OAK201309080,2013,20130908,OAK,HOU,OAK01,2,7,9
OAK201309160,2013,20130916,OAK,ANA,OAK01,12,1,13
OAK201309170,2013,20130917,OAK,ANA,OAK01,1,2,3
OAK201309180,2013,20130918,OAK,ANA,OAK01,5,4,9
OAK201309190,2013,20130919,OAK,MIN,OAK01,6,8,14
OAK201309200,2013,20130920,OAK,MIN,OAK01,0,11,11
OAK201309210,2013,20130921,OAK,MIN,OAK01,1,9,10
OAK201309220,2013,20130922,OAK,MIN,OAK01,7,11,18
OAK201310040,2013,20131004,OAK,DET,OAK01,3,2,5
OAK201310050,2013,20131005,OAK,DET,OAK01,0,1,1
OAK201310100,2013,20131010,OAK,DET,OAK01,3,0,3
PHI201004120,2010,100412,PHI,WAS,PHI13,4,7,11
PHI201004140,2010,100414,PHI,WAS,PHI13,7,14,21
PHI201004150,2010,100415,PHI,WAS,PHI13,7,5,12
PHI201004160,2010,100416,PHI,FLO,PHI13,6,8,14
PHI201004170,2010,100417,PHI,FLO,PHI13,5,1,6
PHI201004180,2010,100418,PHI,FLO,PHI13,2,0,2
PHI201004300,2010,100430,PHI,NYN,PHI13,9,1,10
PHI201005010,2010,100501,PHI,NYN,PHI13,0,10,10
PHI201005020,2010,100502,PHI,NYN,PHI13,5,11,16
PHI201005030,2010,100503,PHI,SLN,PHI13,6,3,9
PHI201005040,2010,100504,PHI,SLN,PHI13,1,2,3
PHI201005050,2010,100505,PHI,SLN,PHI13,0,4,4
PHI201005060,2010,100506,PHI,SLN,PHI13,2,7,9
PHI201005070,2010,100507,PHI,ATL,PHI13,0,7,7
PHI201005080,2010,100508,PHI,ATL,PHI13,4,1,5
PHI201005090,2010,100509,PHI,ATL,PHI13,3,5,8
PHI201005170,2010,100517,PHI,PIT,PHI13,2,12,14
PHI201005180,2010,100518,PHI,PIT,PHI13,2,1,3
PHI201005190,2010,100519,PHI,CHN,PHI13,4,1,5
PHI201005200,2010,100520,PHI,CHN,PHI13,4,5,9
PHI201005210,2010,100521,PHI,BOS,PHI13,1,5,6
PHI201005220,2010,100522,PHI,BOS,PHI13,5,0,5
PHI201005230,2010,100523,PHI,BOS,PHI13,8,3,11
PHI201006040,2010,100604,PHI,SDN,PHI13,2,3,5
PHI201006050,2010,100605,PHI,SDN,PHI13,2,6,8
PHI201006060,2010,100606,PHI,SDN,PHI13,6,5,11
PHI201006070,2010,100607,PHI,SDN,PHI13,3,1,4
PHI201006080,2010,100608,PHI,FLO,PHI13,8,10,18
PHI201006100,2010,100610,PHI,FLO,PHI13,2,0,2
PHI201006180,2010,100618,PHI,MIN,PHI13,5,9,14
PHI201006190,2010,100619,PHI,MIN,PHI13,13,10,23
PHI201006200,2010,100620,PHI,MIN,PHI13,4,1,5
PHI201006220,2010,100622,PHI,CLE,PHI13,1,2,3
PHI201006230,2010,100623,PHI,CLE,PHI13,6,7,13
PHI201006240,2010,100624,PHI,CLE,PHI13,3,12,15
PHI201007050,2010,100705,PHI,ATL,PHI13,1,3,4
PHI201007060,2010,100706,PHI,ATL,PHI13,6,3,9
PHI201007070,2010,100707,PHI,ATL,PHI13,7,5,12
PHI201007080,2010,100708,PHI,CIN,PHI13,3,4,7
PHI201007090,2010,100709,PHI,CIN,PHI13,7,9,16
PHI201007100,2010,100710,PHI,CIN,PHI13,0,1,1
PHI201007110,2010,100711,PHI,CIN,PHI13,0,1,1
PHI201007230,2010,100723,PHI,COL,PHI13,0,6,6
PHI201007240,2010,100724,PHI,COL,PHI13,2,10,12
PHI201007250,2010,100725,PHI,COL,PHI13,3,4,7
PHI201007260,2010,100726,PHI,COL,PHI13,4,5,9
PHI201007270,2010,100727,PHI,ARI,PHI13,5,9,14
PHI201007280,2010,100728,PHI,ARI,PHI13,1,7,8
PHI201007290,2010,100729,PHI,ARI,PHI13,2,3,5
PHI201008060,2010,100806,PHI,NYN,PHI13,5,7,12
PHI201008070,2010,100807,PHI,NYN,PHI13,1,0,1
PHI201008080,2010,100808,PHI,NYN,PHI13,5,6,11
PHI201008100,2010,100810,PHI,LAN,PHI13,15,9,24
PHI201008110,2010,100811,PHI,LAN,PHI13,0,2,2
PHI201008120,2010,100812,PHI,LAN,PHI13,9,10,19
PHI201008170,2010,100817,PHI,SFN,PHI13,3,9,12
PHI201008180,2010,100818,PHI,SFN,PHI13,2,8,10
PHI201008190,2010,100819,PHI,SFN,PHI13,5,2,7
PHI201008200,2010,100820,PHI,WAS,PHI13,0,1,1
PHI201008210,2010,100821,PHI,WAS,PHI13,8,1,9
PHI201008220,2010,100822,PHI,WAS,PHI13,0,6,6
PHI201008230,2010,100823,PHI,HOU,PHI13,3,2,5
PHI201008240,2010,100824,PHI,HOU,PHI13,4,2,6
PHI201008250,2010,100825,PHI,HOU,PHI13,3,2,5
PHI201008260,2010,100826,PHI,HOU,PHI13,5,1,6
PHI201009030,2010,100903,PHI,MIL,PHI13,0,1,1
PHI201009040,2010,100904,PHI,MIL,PHI13,4,5,9
PHI201009050,2010,100905,PHI,MIL,PHI13,6,2,8
PHI201009061,2010,100906,PHI,FLO,PHI13,7,1,8
PHI201009062,2010,100906,PHI,FLO,PHI13,4,7,11
PHI201009070,2010,100907,PHI,FLO,PHI13,7,8,15
PHI201009080,2010,100908,PHI,FLO,PHI13,6,10,16
PHI201009170,2010,100917,PHI,WAS,PHI13,1,9,10
PHI201009180,2010,100918,PHI,WAS,PHI13,2,5,7
PHI201009190,2010,100919,PHI,WAS,PHI13,6,7,13
PHI201009200,2010,100920,PHI,ATL,PHI13,1,3,4
PHI201009210,2010,100921,PHI,ATL,PHI13,3,5,8
PHI201009220,2010,100922,PHI,ATL,PHI13,0,1,1
PHI201009240,2010,100924,PHI,NYN,PHI13,2,3,5
PHI201009250,2010,100925,PHI,NYN,PHI13,5,2,7
PHI201009260,2010,100926,PHI,NYN,PHI13,7,3,10
PHI201010060,2010,101006,PHI,CIN,PHI13,0,4,4
PHI201010080,2010,101008,PHI,CIN,PHI13,4,7,11
PHI201010160,2010,101016,PHI,SFN,PHI13,4,3,7
PHI201010170,2010,101017,PHI,SFN,PHI13,1,6,7
PHI201010230,2010,101023,PHI,SFN,PHI13,3,2,5
PHI201104010,2011,20110401,PHI,HOU,PHI13,4,5,9
PHI201104020,2011,20110402,PHI,HOU,PHI13,4,9,13
PHI201104030,2011,20110403,PHI,HOU,PHI13,3,7,10
PHI201104050,2011,20110405,PHI,NYN,PHI13,7,1,8
PHI201104060,2011,20110406,PHI,NYN,PHI13,7,10,17
PHI201104070,2011,20110407,PHI,NYN,PHI13,0,11,11
PHI201104150,2011,20110415,PHI,FLO,PHI13,4,3,7
PHI201104170,2011,20110417,PHI,FLO,PHI13,2,3,5
PHI201104180,2011,20110418,PHI,MIL,PHI13,6,3,9
PHI201104190,2011,20110419,PHI,MIL,PHI13,9,0,9
PHI201104200,2011,20110420,PHI,MIL,PHI13,3,4,7
PHI201104290,2011,20110429,PHI,NYN,PHI13,3,10,13
PHI201104300,2011,20110430,PHI,NYN,PHI13,1,2,3
PHI201105010,2011,20110501,PHI,NYN,PHI13,2,1,3
PHI201105030,2011,20110503,PHI,WAS,PHI13,1,4,5
PHI201105040,2011,20110504,PHI,WAS,PHI13,4,7,11
PHI201105050,2011,20110505,PHI,WAS,PHI13,3,7,10
PHI201105060,2011,20110506,PHI,ATL,PHI13,5,0,5
PHI201105070,2011,20110507,PHI,ATL,PHI13,0,3,3
PHI201105080,2011,20110508,PHI,ATL,PHI13,5,2,7
PHI201105180,2011,20110518,PHI,COL,PHI13,1,2,3
PHI201105190,2011,20110519,PHI,COL,PHI13,7,1,8
PHI201105200,2011,20110520,PHI,TEX,PHI13,2,3,5
PHI201105210,2011,20110521,PHI,TEX,PHI13,0,2,2
PHI201105220,2011,20110522,PHI,TEX,PHI13,2,0,2
PHI201105230,2011,20110523,PHI,CIN,PHI13,3,10,13
PHI201105240,2011,20110524,PHI,CIN,PHI13,6,3,9
PHI201105250,2011,20110525,PHI,CIN,PHI13,4,5,9
PHI201105260,2011,20110526,PHI,CIN,PHI13,4,10,14
PHI201106060,2011,20110606,PHI,LAN,PHI13,1,3,4
PHI201106070,2011,20110607,PHI,LAN,PHI13,6,2,8
PHI201106080,2011,20110608,PHI,LAN,PHI13,0,2,2
PHI201106090,2011,20110609,PHI,CHN,PHI13,4,3,7
PHI201106100,2011,20110610,PHI,CHN,PHI13,5,7,12
PHI201106110,2011,20110611,PHI,CHN,PHI13,1,7,8
PHI201106120,2011,20110612,PHI,CHN,PHI13,3,4,7
PHI201106140,2011,20110614,PHI,FLO,PHI13,1,9,10
PHI201106151,2011,20110615,PHI,FLO,PHI13,1,8,9
PHI201106152,2011,20110615,PHI,FLO,PHI13,4,5,9
PHI201106160,2011,20110616,PHI,FLO,PHI13,0,3,3
PHI201106240,2011,20110624,PHI,OAK,PHI13,0,1,1
PHI201106250,2011,20110625,PHI,OAK,PHI13,4,1,5
PHI201106260,2011,20110626,PHI,OAK,PHI13,1,3,4
PHI201106280,2011,20110628,PHI,BOS,PHI13,0,5,5
PHI201106290,2011,20110629,PHI,BOS,PHI13,1,2,3
PHI201106300,2011,20110630,PHI,BOS,PHI13,5,2,7
PHI201107080,2011,20110708,PHI,ATL,PHI13,2,3,5
PHI201107090,2011,20110709,PHI,ATL,PHI13,4,1,5
PHI201107100,2011,20110710,PHI,ATL,PHI13,1,14,15
PHI201107220,2011,20110722,PHI,SDN,PHI13,1,3,4
PHI201107230,2011,20110723,PHI,SDN,PHI13,6,8,14
PHI201107240,2011,20110724,PHI,SDN,PHI13,3,5,8
PHI201107250,2011,20110725,PHI,SDN,PHI13,5,4,9
PHI201107260,2011,20110726,PHI,SFN,PHI13,2,7,9
PHI201107270,2011,20110727,PHI,SFN,PHI13,2,1,3
PHI201107280,2011,20110728,PHI,SFN,PHI13,4,1,5
PHI201107290,2011,20110729,PHI,PIT,PHI13,3,10,13
PHI201107300,2011,20110730,PHI,PIT,PHI13,4,7,11
PHI201107310,2011,20110731,PHI,PIT,PHI13,5,6,11
PHI201108120,2011,20110812,PHI,WAS,PHI13,4,2,6
PHI201108130,2011,20110813,PHI,WAS,PHI13,3,11,14
PHI201108160,2011,20110816,PHI,ARI,PHI13,3,2,5
PHI201108170,2011,20110817,PHI,ARI,PHI13,2,9,11
PHI201108180,2011,20110818,PHI,ARI,PHI13,1,4,5
PHI201108220,2011,20110822,PHI,NYN,PHI13,0,10,10
PHI201108230,2011,20110823,PHI,NYN,PHI13,4,9,13
PHI201108240,2011,20110824,PHI,NYN,PHI13,7,4,11
PHI201108260,2011,20110826,PHI,FLO,PHI13,6,5,11
PHI201109050,2011,20110905,PHI,ATL,PHI13,0,9,9
PHI201109060,2011,20110906,PHI,ATL,PHI13,3,6,9
PHI201109070,2011,20110907,PHI,ATL,PHI13,2,3,5
PHI201109151,2011,20110915,PHI,FLO,PHI13,1,3,4
PHI201109152,2011,20110915,PHI,FLO,PHI13,1,2,3
PHI201109160,2011,20110916,PHI,SLN,PHI13,4,2,6
PHI201109170,2011,20110917,PHI,SLN,PHI13,2,9,11
PHI201109180,2011,20110918,PHI,SLN,PHI13,5,0,5
PHI201109190,2011,20110919,PHI,SLN,PHI13,4,3,7
PHI201109201,2011,20110920,PHI,WAS,PHI13,4,3,7
PHI201109202,2011,20110920,PHI,WAS,PHI13,3,0,3
PHI201109210,2011,20110921,PHI,WAS,PHI13,7,5,12
PHI201109220,2011,20110922,PHI,WAS,PHI13,6,1,7
PHI201110010,2011,20111001,PHI,SLN,PHI13,6,11,17
PHI201110020,2011,20111002,PHI,SLN,PHI13,5,4,9
PHI201110070,2011,20111007,PHI,SLN,PHI13,1,0,1
PHI201204090,2012,120409,PHI,MIA,PHI13,6,2,8
PHI201204110,2012,120411,PHI,MIA,PHI13,1,7,8
PHI201204120,2012,120412,PHI,MIA,PHI13,1,3,4
PHI201204130,2012,120413,PHI,NYN,PHI13,5,2,7
PHI201204140,2012,120414,PHI,NYN,PHI13,5,0,5
PHI201204150,2012,120415,PHI,NYN,PHI13,2,8,10
PHI201204270,2012,120427,PHI,CHN,PHI13,5,1,6
PHI201204280,2012,120428,PHI,CHN,PHI13,2,5,7
PHI201204290,2012,120429,PHI,CHN,PHI13,5,1,6
PHI201204300,2012,120430,PHI,CHN,PHI13,4,6,10
PHI201205070,2012,120507,PHI,NYN,PHI13,5,2,7
PHI201205080,2012,120508,PHI,NYN,PHI13,7,4,11
PHI201205090,2012,120509,PHI,NYN,PHI13,10,6,16
PHI201205110,2012,120511,PHI,SDN,PHI13,3,7,10
PHI201205120,2012,120512,PHI,SDN,PHI13,2,1,3
PHI201205130,2012,120513,PHI,SDN,PHI13,2,3,5
PHI201205140,2012,120514,PHI,HOU,PHI13,1,5,6
PHI201205150,2012,120515,PHI,HOU,PHI13,3,4,7
PHI201205180,2012,120518,PHI,BOS,PHI13,4,6,10
PHI201205190,2012,120519,PHI,BOS,PHI13,7,5,12
PHI201205200,2012,120520,PHI,BOS,PHI13,5,1,6
PHI201205210,2012,120521,PHI,WAS,PHI13,2,1,3
PHI201205220,2012,120522,PHI,WAS,PHI13,5,2,7
PHI201205230,2012,120523,PHI,WAS,PHI13,1,4,5
PHI201206010,2012,120601,PHI,MIA,PHI13,4,6,10
PHI201206020,2012,120602,PHI,MIA,PHI13,5,4,9
PHI201206030,2012,120603,PHI,MIA,PHI13,5,1,6
PHI201206040,2012,120604,PHI,LAN,PHI13,4,3,7
PHI201206050,2012,120605,PHI,LAN,PHI13,2,1,3
PHI201206060,2012,120606,PHI,LAN,PHI13,6,5,11
PHI201206070,2012,120607,PHI,LAN,PHI13,8,3,11
PHI201206190,2012,120619,PHI,COL,PHI13,2,7,9
PHI201206200,2012,120620,PHI,COL,PHI13,6,7,13
PHI201206210,2012,120621,PHI,COL,PHI13,4,1,5
PHI201206230,2012,120623,PHI,TBA,PHI13,6,7,13
PHI201206241,2012,120624,PHI,TBA,PHI13,3,2,5
PHI201206242,2012,120624,PHI,TBA,PHI13,7,3,10
PHI201206250,2012,120625,PHI,PIT,PHI13,3,8,11
PHI201206260,2012,120626,PHI,PIT,PHI13,4,5,9
PHI201206270,2012,120627,PHI,PIT,PHI13,11,7,18
PHI201206280,2012,120628,PHI,PIT,PHI13,5,4,9
PHI201207060,2012,120706,PHI,ATL,PHI13,5,0,5
PHI201207070,2012,120707,PHI,ATL,PHI13,6,3,9
PHI201207080,2012,120708,PHI,ATL,PHI13,4,3,7
PHI201207200,2012,120720,PHI,SFN,PHI13,7,2,9
PHI201207210,2012,120721,PHI,SFN,PHI13,6,5,11
PHI201207220,2012,120722,PHI,SFN,PHI13,3,4,7
PHI201207230,2012,120723,PHI,MIL,PHI13,6,7,13
PHI201207240,2012,120724,PHI,MIL,PHI13,6,7,13
PHI201207250,2012,120725,PHI,MIL,PHI13,6,7,13
PHI201208030,2012,120803,PHI,ARI,PHI13,4,2,6
PHI201208040,2012,120804,PHI,ARI,PHI13,0,3,3
PHI201208050,2012,120805,PHI,ARI,PHI13,4,5,9
PHI201208060,2012,120806,PHI,ATL,PHI13,6,1,7
PHI201208070,2012,120807,PHI,ATL,PHI13,0,3,3
PHI201208080,2012,120808,PHI,ATL,PHI13,12,6,18
PHI201208100,2012,120810,PHI,SLN,PHI13,1,3,4
PHI201208110,2012,120811,PHI,SLN,PHI13,4,1,5
PHI201208120,2012,120812,PHI,SLN,PHI13,7,8,15
PHI201208200,2012,120820,PHI,CIN,PHI13,5,12,17
PHI201208210,2012,120821,PHI,CIN,PHI13,5,4,9
PHI201208220,2012,120822,PHI,CIN,PHI13,3,2,5
PHI201208230,2012,120823,PHI,CIN,PHI13,3,4,7
PHI201208240,2012,120824,PHI,WAS,PHI13,2,4,6
PHI201208250,2012,120825,PHI,WAS,PHI13,2,4,6
PHI201208260,2012,120826,PHI,WAS,PHI13,1,4,5
PHI201208280,2012,120828,PHI,NYN,PHI13,9,5,14
PHI201208290,2012,120829,PHI,NYN,PHI13,3,2,5
PHI201208300,2012,120830,PHI,NYN,PHI13,2,3,5
PHI201209070,2012,120907,PHI,COL,PHI13,2,3,5
PHI201209091,2012,120909,PHI,COL,PHI13,2,3,5
PHI201209092,2012,120909,PHI,COL,PHI13,4,7,11
PHI201209100,2012,120910,PHI,MIA,PHI13,1,3,4
PHI201209110,2012,120911,PHI,MIA,PHI13,7,9,16
PHI201209120,2012,120912,PHI,MIA,PHI13,1,3,4
PHI201209210,2012,120921,PHI,ATL,PHI13,2,6,8
PHI201209220,2012,120922,PHI,ATL,PHI13,8,2,10
PHI201209230,2012,120923,PHI,ATL,PHI13,2,1,3
PHI201209250,2012,120925,PHI,WAS,PHI13,3,6,9
PHI201209260,2012,120926,PHI,WAS,PHI13,8,4,12
PHI201209270,2012,120927,PHI,WAS,PHI13,7,3,10
PHI201304050,2013,20130405,PHI,KCA,PHI13,13,4,17
PHI201304060,2013,20130406,PHI,KCA,PHI13,3,4,7
PHI201304070,2013,20130407,PHI,KCA,PHI13,9,8,17
PHI201304080,2013,20130408,PHI,NYN,PHI13,7,2,9
PHI201304090,2013,20130409,PHI,NYN,PHI13,3,8,11
PHI201304100,2013,20130410,PHI,NYN,PHI13,3,7,10
PHI201304180,2013,20130418,PHI,SLN,PHI13,4,3,7
PHI201304190,2013,20130419,PHI,SLN,PHI13,2,8,10
PHI201304200,2013,20130420,PHI,SLN,PHI13,5,0,5
PHI201304210,2013,20130421,PHI,SLN,PHI13,3,7,10
PHI201304220,2013,20130422,PHI,PIT,PHI13,2,3,5
PHI201304230,2013,20130423,PHI,PIT,PHI13,2,0,2
PHI201304240,2013,20130424,PHI,PIT,PHI13,5,3,8
PHI201304250,2013,20130425,PHI,PIT,PHI13,6,4,10
PHI201305020,2013,20130502,PHI,MIA,PHI13,2,7,9
PHI201305030,2013,20130503,PHI,MIA,PHI13,1,4,5
PHI201305040,2013,20130504,PHI,MIA,PHI13,2,0,2
PHI201305050,2013,20130505,PHI,MIA,PHI13,14,2,16
PHI201305140,2013,20130514,PHI,CLE,PHI13,2,6,8
PHI201305150,2013,20130515,PHI,CLE,PHI13,10,4,14
PHI201305170,2013,20130517,PHI,CIN,PHI13,3,5,8
PHI201305180,2013,20130518,PHI,CIN,PHI13,10,0,10
PHI201305190,2013,20130519,PHI,CIN,PHI13,2,3,5
PHI201305290,2013,20130529,PHI,BOS,PHI13,3,4,7
PHI201305300,2013,20130530,PHI,BOS,PHI13,9,2,11
PHI201305310,2013,20130531,PHI,MIL,PHI13,8,5,13
PHI201306010,2013,20130601,PHI,MIL,PHI13,4,3,7
PHI201306020,2013,20130602,PHI,MIL,PHI13,5,7,12
PHI201306030,2013,20130603,PHI,MIA,PHI13,2,7,9
PHI201306040,2013,20130604,PHI,MIA,PHI13,3,7,10
PHI201306050,2013,20130605,PHI,MIA,PHI13,1,6,7
PHI201306170,2013,20130617,PHI,WAS,PHI13,4,5,9
PHI201306180,2013,20130618,PHI,WAS,PHI13,2,4,6
PHI201306190,2013,20130619,PHI,WAS,PHI13,6,2,8
PHI201306210,2013,20130621,PHI,NYN,PHI13,4,3,7
PHI201306220,2013,20130622,PHI,NYN,PHI13,7,8,15
PHI201306230,2013,20130623,PHI,NYN,PHI13,8,0,8
PHI201307050,2013,20130705,PHI,ATL,PHI13,4,5,9
PHI201307060,2013,20130706,PHI,ATL,PHI13,13,4,17
PHI201307070,2013,20130707,PHI,ATL,PHI13,3,7,10
PHI201307080,2013,20130708,PHI,WAS,PHI13,2,3,5
PHI201307090,2013,20130709,PHI,WAS,PHI13,2,4,6
PHI201307100,2013,20130710,PHI,WAS,PHI13,5,1,6
PHI201307110,2013,20130711,PHI,WAS,PHI13,1,3,4
PHI201307131,2013,20130713,PHI,CHA,PHI13,5,4,9
PHI201307132,2013,20130713,PHI,CHA,PHI13,1,2,3
PHI201307140,2013,20130714,PHI,CHA,PHI13,3,4,7
PHI201307300,2013,20130730,PHI,SFN,PHI13,3,7,10
PHI201307310,2013,20130731,PHI,SFN,PHI13,9,2,11
PHI201308010,2013,20130801,PHI,SFN,PHI13,2,1,3
PHI201308020,2013,20130802,PHI,ATL,PHI13,6,4,10
PHI201308030,2013,20130803,PHI,ATL,PHI13,5,4,9
PHI201308040,2013,20130804,PHI,ATL,PHI13,4,1,5
PHI201308060,2013,20130806,PHI,CHN,PHI13,8,9,17
PHI201308070,2013,20130807,PHI,CHN,PHI13,5,2,7
PHI201308080,2013,20130808,PHI,CHN,PHI13,1,12,13
PHI201308160,2013,20130816,PHI,LAN,PHI13,4,0,4
PHI201308170,2013,20130817,PHI,LAN,PHI13,5,0,5
PHI201308180,2013,20130818,PHI,LAN,PHI13,2,3,5
PHI201308190,2013,20130819,PHI,COL,PHI13,4,5,9
PHI201308200,2013,20130820,PHI,COL,PHI13,5,3,8
PHI201308210,2013,20130821,PHI,COL,PHI13,3,4,7
PHI201308220,2013,20130822,PHI,COL,PHI13,4,5,9
PHI201308230,2013,20130823,PHI,ARI,PHI13,3,4,7
PHI201308240,2013,20130824,PHI,ARI,PHI13,12,7,19
PHI201308250,2013,20130825,PHI,ARI,PHI13,5,9,14
PHI201309020,2013,20130902,PHI,WAS,PHI13,2,3,5
PHI201309030,2013,20130903,PHI,WAS,PHI13,9,6,15
PHI201309040,2013,20130904,PHI,WAS,PHI13,3,2,5
PHI201309060,2013,20130906,PHI,ATL,PHI13,1,2,3
PHI201309070,2013,20130907,PHI,ATL,PHI13,5,6,11
PHI201309080,2013,20130908,PHI,ATL,PHI13,2,3,5
PHI201309100,2013,20130910,PHI,SDN,PHI13,8,2,10
PHI201309110,2013,20130911,PHI,SDN,PHI13,2,4,6
PHI201309120,2013,20130912,PHI,SDN,PHI13,5,10,15
PHI201309160,2013,20130916,PHI,MIA,PHI13,2,12,14
PHI201309170,2013,20130917,PHI,MIA,PHI13,4,6,10
PHI201309180,2013,20130918,PHI,MIA,PHI13,4,3,7
PHI201309200,2013,20130920,PHI,NYN,PHI13,6,4,10
PHI201309210,2013,20130921,PHI,NYN,PHI13,5,4,9
PHI201309220,2013,20130922,PHI,NYN,PHI13,4,3,7
PIT201004050,2010,100405,PIT,LAN,PIT08,5,11,16
PIT201004070,2010,100407,PIT,LAN,PIT08,3,4,7
PIT201004080,2010,100408,PIT,LAN,PIT08,10,2,12
PIT201004160,2010,100416,PIT,CIN,PIT08,3,4,7
PIT201004170,2010,100417,PIT,CIN,PIT08,4,5,9
PIT201004180,2010,100418,PIT,CIN,PIT08,3,5,8
PIT201004200,2010,100420,PIT,MIL,PIT08,8,1,9
PIT201004210,2010,100421,PIT,MIL,PIT08,8,0,8
PIT201004220,2010,100422,PIT,MIL,PIT08,20,0,20
PIT201005040,2010,100504,PIT,CHN,PIT08,2,3,5
PIT201005050,2010,100505,PIT,CHN,PIT08,2,4,6
PIT201005060,2010,100506,PIT,CHN,PIT08,1,11,12
PIT201005070,2010,100507,PIT,SLN,PIT08,4,3,7
PIT201005080,2010,100508,PIT,SLN,PIT08,0,2,2
PIT201005090,2010,100509,PIT,SLN,PIT08,11,4,15
PIT201005100,2010,100510,PIT,CIN,PIT08,2,1,3
PIT201005110,2010,100511,PIT,CIN,PIT08,9,0,9
PIT201005120,2010,100512,PIT,CIN,PIT08,5,0,5
PIT201005190,2010,100519,PIT,MIL,PIT08,4,6,10
PIT201005200,2010,100520,PIT,MIL,PIT08,4,3,7
PIT201005210,2010,100521,PIT,ATL,PIT08,7,0,7
PIT201005220,2010,100522,PIT,ATL,PIT08,4,2,6
PIT201005230,2010,100523,PIT,ATL,PIT08,2,3,5
PIT201005310,2010,100531,PIT,CHN,PIT08,1,2,3
PIT201006010,2010,100601,PIT,CHN,PIT08,2,3,5
PIT201006040,2010,100604,PIT,SFN,PIT08,6,4,10
PIT201006050,2010,100605,PIT,SFN,PIT08,3,6,9
PIT201006060,2010,100606,PIT,SFN,PIT08,6,5,11
PIT201006070,2010,100607,PIT,CHN,PIT08,6,1,7
PIT201006150,2010,100615,PIT,CHA,PIT08,6,4,10
PIT201006160,2010,100616,PIT,CHA,PIT08,7,2,9
PIT201006170,2010,100617,PIT,CHA,PIT08,5,4,9
PIT201006180,2010,100618,PIT,CLE,PIT08,4,3,7
PIT201006190,2010,100619,PIT,CLE,PIT08,4,6,10
PIT201006200,2010,100620,PIT,CLE,PIT08,3,5,8
PIT201007010,2010,100701,PIT,PHI,PIT08,2,3,5
PIT201007020,2010,100702,PIT,PHI,PIT08,0,2,2
PIT201007030,2010,100703,PIT,PHI,PIT08,12,4,16
PIT201007040,2010,100704,PIT,PHI,PIT08,5,8,13
PIT201007160,2010,100716,PIT,HOU,PIT08,5,2,7
PIT201007170,2010,100717,PIT,HOU,PIT08,6,12,18
PIT201007180,2010,100718,PIT,HOU,PIT08,0,9,9
PIT201007190,2010,100719,PIT,MIL,PIT08,3,1,4
PIT201007200,2010,100720,PIT,MIL,PIT08,9,11,20
PIT201007210,2010,100721,PIT,MIL,PIT08,3,15,18
PIT201007220,2010,100722,PIT,MIL,PIT08,3,2,5
PIT201007230,2010,100723,PIT,SDN,PIT08,5,3,8
PIT201007240,2010,100724,PIT,SDN,PIT08,9,2,11
PIT201007250,2010,100725,PIT,SDN,PIT08,6,3,9
PIT201008020,2010,100802,PIT,CIN,PIT08,4,0,4
PIT201008030,2010,100803,PIT,CIN,PIT08,6,7,13
PIT201008040,2010,100804,PIT,CIN,PIT08,9,4,13
PIT201008050,2010,100805,PIT,COL,PIT08,1,5,6
PIT201008060,2010,100806,PIT,COL,PIT08,6,3,9
PIT201008070,2010,100807,PIT,COL,PIT08,7,8,15
PIT201008080,2010,100808,PIT,COL,PIT08,8,4,12
PIT201008160,2010,100816,PIT,FLO,PIT08,1,7,8
PIT201008170,2010,100817,PIT,FLO,PIT08,6,0,6
PIT201008180,2010,100818,PIT,FLO,PIT08,3,2,5
PIT201008190,2010,100819,PIT,FLO,PIT08,4,2,6
PIT201008200,2010,100820,PIT,NYN,PIT08,7,2,9
PIT201008210,2010,100821,PIT,NYN,PIT08,5,1,6
PIT201008220,2010,100822,PIT,NYN,PIT08,1,2,3
PIT201008230,2010,100823,PIT,SLN,PIT08,10,2,12
PIT201008240,2010,100824,PIT,SLN,PIT08,3,4,7
PIT201008250,2010,100825,PIT,SLN,PIT08,2,5,7
PIT201009030,2010,100903,PIT,WAS,PIT08,5,8,13
PIT201009040,2010,100904,PIT,WAS,PIT08,9,2,11
PIT201009050,2010,100905,PIT,WAS,PIT08,8,1,9
PIT201009060,2010,100906,PIT,ATL,PIT08,1,3,4
PIT201009070,2010,100907,PIT,ATL,PIT08,0,5,5
PIT201009080,2010,100908,PIT,ATL,PIT08,9,3,12
PIT201009170,2010,100917,PIT,ARI,PIT08,3,4,7
PIT201009180,2010,100918,PIT,ARI,PIT08,6,9,15
PIT201009190,2010,100919,PIT,ARI,PIT08,3,4,7
PIT201009210,2010,100921,PIT,SLN,PIT08,2,5,7
PIT201009220,2010,100922,PIT,SLN,PIT08,6,11,17
PIT201009230,2010,100923,PIT,SLN,PIT08,9,2,11
PIT201009240,2010,100924,PIT,HOU,PIT08,10,7,17
PIT201009250,2010,100925,PIT,HOU,PIT08,4,6,10
PIT201009260,2010,100926,PIT,HOU,PIT08,3,9,12
PIT201104070,2011,20110407,PIT,COL,PIT08,7,1,8
PIT201104080,2011,20110408,PIT,COL,PIT08,3,4,7
PIT201104090,2011,20110409,PIT,COL,PIT08,6,4,10
PIT201104100,2011,20110410,PIT,COL,PIT08,6,5,11
PIT201104130,2011,20110413,PIT,MIL,PIT08,6,0,6
PIT201104140,2011,20110414,PIT,MIL,PIT08,4,1,5
PIT201104230,2011,20110423,PIT,WAS,PIT08,2,7,9
PIT201104240,2011,20110424,PIT,WAS,PIT08,6,3,9
PIT201104250,2011,20110425,PIT,WAS,PIT08,2,4,6
PIT201104260,2011,20110426,PIT,SFN,PIT08,3,2,5
PIT201104270,2011,20110427,PIT,SFN,PIT08,0,2,2
PIT201104280,2011,20110428,PIT,SFN,PIT08,5,2,7
PIT201105060,2011,20110506,PIT,HOU,PIT08,3,2,5
PIT201105070,2011,20110507,PIT,HOU,PIT08,1,6,7
PIT201105080,2011,20110508,PIT,HOU,PIT08,4,5,9
PIT201105090,2011,20110509,PIT,LAN,PIT08,1,4,5
PIT201105100,2011,20110510,PIT,LAN,PIT08,10,3,13
PIT201105110,2011,20110511,PIT,LAN,PIT08,2,0,2
PIT201105200,2011,20110520,PIT,DET,PIT08,1,10,11
PIT201105210,2011,20110521,PIT,DET,PIT08,2,6,8
PIT201105220,2011,20110522,PIT,DET,PIT08,2,0,2
PIT201105240,2011,20110524,PIT,ATL,PIT08,2,0,2
PIT201105250,2011,20110525,PIT,ATL,PIT08,4,2,6
PIT201106030,2011,20110603,PIT,PHI,PIT08,1,2,3
PIT201106040,2011,20110604,PIT,PHI,PIT08,3,6,9
PIT201106050,2011,20110605,PIT,PHI,PIT08,7,3,10
PIT201106070,2011,20110607,PIT,ARI,PIT08,5,8,13
PIT201106080,2011,20110608,PIT,ARI,PIT08,2,3,5
PIT201106090,2011,20110609,PIT,ARI,PIT08,2,0,2
PIT201106100,2011,20110610,PIT,NYN,PIT08,8,1,9
PIT201106110,2011,20110611,PIT,NYN,PIT08,2,3,5
PIT201106120,2011,20110612,PIT,NYN,PIT08,7,0,7
PIT201106130,2011,20110613,PIT,NYN,PIT08,1,3,4
PIT201106200,2011,20110620,PIT,BAL,PIT08,8,3,11
PIT201106210,2011,20110621,PIT,BAL,PIT08,3,9,12
PIT201106220,2011,20110622,PIT,BAL,PIT08,4,5,9
PIT201106240,2011,20110624,PIT,BOS,PIT08,1,3,4
PIT201106250,2011,20110625,PIT,BOS,PIT08,4,6,10
PIT201106260,2011,20110626,PIT,BOS,PIT08,4,2,6
PIT201107040,2011,20110704,PIT,HOU,PIT08,3,5,8
PIT201107050,2011,20110705,PIT,HOU,PIT08,1,5,6
PIT201107060,2011,20110706,PIT,HOU,PIT08,8,2,10
PIT201107080,2011,20110708,PIT,CHN,PIT08,4,7,11
PIT201107090,2011,20110709,PIT,CHN,PIT08,6,3,9
PIT201107100,2011,20110710,PIT,CHN,PIT08,1,9,10
PIT201107180,2011,20110718,PIT,CIN,PIT08,0,2,2
PIT201107190,2011,20110719,PIT,CIN,PIT08,0,1,1
PIT201107200,2011,20110720,PIT,CIN,PIT08,3,1,4
PIT201107220,2011,20110722,PIT,SLN,PIT08,6,4,10
PIT201107230,2011,20110723,PIT,SLN,PIT08,9,1,10
PIT201107240,2011,20110724,PIT,SLN,PIT08,3,4,7
PIT201108010,2011,20110801,PIT,CHN,PIT08,5,3,8
PIT201108020,2011,20110802,PIT,CHN,PIT08,11,6,17
PIT201108030,2011,20110803,PIT,CHN,PIT08,1,0,1
PIT201108040,2011,20110804,PIT,CHN,PIT08,7,6,13
PIT201108050,2011,20110805,PIT,SDN,PIT08,15,5,20
PIT201108060,2011,20110806,PIT,SDN,PIT08,13,2,15
PIT201108070,2011,20110807,PIT,SDN,PIT08,7,3,10
PIT201108150,2011,20110815,PIT,SLN,PIT08,2,6,8
PIT201108160,2011,20110816,PIT,SLN,PIT08,4,5,9
PIT201108170,2011,20110817,PIT,SLN,PIT08,7,2,9
PIT201108190,2011,20110819,PIT,CIN,PIT08,11,8,19
PIT201108200,2011,20110820,PIT,CIN,PIT08,3,5,8
PIT201108210,2011,20110821,PIT,CIN,PIT08,5,4,9
PIT201108221,2011,20110822,PIT,MIL,PIT08,8,1,9
PIT201108222,2011,20110822,PIT,MIL,PIT08,2,9,11
PIT201108230,2011,20110823,PIT,MIL,PIT08,11,4,15
PIT201108240,2011,20110824,PIT,MIL,PIT08,0,2,2
PIT201109010,2011,20110901,PIT,LAN,PIT08,6,4,10
PIT201109050,2011,20110905,PIT,HOU,PIT08,1,3,4
PIT201109060,2011,20110906,PIT,HOU,PIT08,4,1,5
PIT201109070,2011,20110907,PIT,HOU,PIT08,4,5,9
PIT201109090,2011,20110909,PIT,FLO,PIT08,13,4,17
PIT201109100,2011,20110910,PIT,FLO,PIT08,3,0,3
PIT201109110,2011,20110911,PIT,FLO,PIT08,4,1,5
PIT201109120,2011,20110912,PIT,SLN,PIT08,5,6,11
PIT201109130,2011,20110913,PIT,SLN,PIT08,6,4,10
PIT201109140,2011,20110914,PIT,SLN,PIT08,3,2,5
PIT201109230,2011,20110923,PIT,CIN,PIT08,3,4,7
PIT201109240,2011,20110924,PIT,CIN,PIT08,3,4,7
PIT201109250,2011,20110925,PIT,CIN,PIT08,5,4,9
PIT201204050,2012,120405,PIT,PHI,PIT08,1,0,1
PIT201204070,2012,120407,PIT,PHI,PIT08,1,2,3
PIT201204080,2012,120408,PIT,PHI,PIT08,4,5,9
PIT201204200,2012,120420,PIT,SLN,PIT08,4,1,5
PIT201204210,2012,120421,PIT,SLN,PIT08,0,2,2
PIT201204220,2012,120422,PIT,SLN,PIT08,5,1,6
PIT201204240,2012,120424,PIT,COL,PIT08,4,5,9
PIT201204251,2012,120425,PIT,COL,PIT08,2,1,3
PIT201204252,2012,120425,PIT,COL,PIT08,1,5,6
PIT201205040,2012,120504,PIT,CIN,PIT08,6,1,7
PIT201205050,2012,120505,PIT,CIN,PIT08,2,3,5
PIT201205060,2012,120506,PIT,CIN,PIT08,5,0,5
PIT201205080,2012,120508,PIT,WAS,PIT08,4,5,9
PIT201205090,2012,120509,PIT,WAS,PIT08,2,4,6
PIT201205100,2012,120510,PIT,WAS,PIT08,4,2,6
PIT201205110,2012,120511,PIT,HOU,PIT08,1,0,1
PIT201205120,2012,120512,PIT,HOU,PIT08,2,5,7
PIT201205130,2012,120513,PIT,HOU,PIT08,2,3,5
PIT201205210,2012,120521,PIT,NYN,PIT08,4,5,9
PIT201205220,2012,120522,PIT,NYN,PIT08,3,2,5
PIT201205230,2012,120523,PIT,NYN,PIT08,3,1,4
PIT201205250,2012,120525,PIT,CHN,PIT08,0,1,1
PIT201205260,2012,120526,PIT,CHN,PIT08,2,3,5
PIT201205270,2012,120527,PIT,CHN,PIT08,4,10,14
PIT201205280,2012,120528,PIT,CIN,PIT08,1,4,5
PIT201205290,2012,120529,PIT,CIN,PIT08,8,1,9
PIT201205300,2012,120530,PIT,CIN,PIT08,1,2,3
PIT201206080,2012,120608,PIT,KCA,PIT08,2,4,6
PIT201206090,2012,120609,PIT,KCA,PIT08,3,5,8
PIT201206100,2012,120610,PIT,KCA,PIT08,2,3,5
PIT201206190,2012,120619,PIT,MIN,PIT08,2,7,9
PIT201206200,2012,120620,PIT,MIN,PIT08,2,1,3
PIT201206210,2012,120621,PIT,MIN,PIT08,1,9,10
PIT201206220,2012,120622,PIT,DET,PIT08,1,4,5
PIT201206230,2012,120623,PIT,DET,PIT08,1,4,5
PIT201206240,2012,120624,PIT,DET,PIT08,3,2,5
PIT201207020,2012,120702,PIT,HOU,PIT08,2,11,13
PIT201207030,2012,120703,PIT,HOU,PIT08,7,8,15
PIT201207040,2012,120704,PIT,HOU,PIT08,4,6,10
PIT201207050,2012,120705,PIT,HOU,PIT08,0,2,2
PIT201207060,2012,120706,PIT,SFN,PIT08,6,5,11
PIT201207070,2012,120707,PIT,SFN,PIT08,1,3,4
PIT201207080,2012,120708,PIT,SFN,PIT08,2,13,15
PIT201207200,2012,120720,PIT,MIA,PIT08,3,4,7
PIT201207210,2012,120721,PIT,MIA,PIT08,1,5,6
PIT201207220,2012,120722,PIT,MIA,PIT08,0,3,3
PIT201207230,2012,120723,PIT,CHN,PIT08,2,0,2
PIT201207240,2012,120724,PIT,CHN,PIT08,5,1,6
PIT201207250,2012,120725,PIT,CHN,PIT08,2,3,5
PIT201208060,2012,120806,PIT,ARI,PIT08,0,4,4
PIT201208070,2012,120807,PIT,ARI,PIT08,10,4,14
PIT201208080,2012,120808,PIT,ARI,PIT08,6,7,13
PIT201208090,2012,120809,PIT,ARI,PIT08,6,3,9
PIT201208100,2012,120810,PIT,SDN,PIT08,9,8,17
PIT201208110,2012,120811,PIT,SDN,PIT08,5,0,5
PIT201208120,2012,120812,PIT,SDN,PIT08,5,11,16
PIT201208130,2012,120813,PIT,LAN,PIT08,5,4,9
PIT201208140,2012,120814,PIT,LAN,PIT08,11,0,11
PIT201208150,2012,120815,PIT,LAN,PIT08,9,3,12
PIT201208160,2012,120816,PIT,LAN,PIT08,6,10,16
PIT201208240,2012,120824,PIT,MIL,PIT08,6,5,11
PIT201208250,2012,120825,PIT,MIL,PIT08,0,4,4
PIT201208260,2012,120826,PIT,MIL,PIT08,7,0,7
PIT201208270,2012,120827,PIT,SLN,PIT08,4,3,7
PIT201208280,2012,120828,PIT,SLN,PIT08,0,9,9
PIT201208290,2012,120829,PIT,SLN,PIT08,0,5,5
PIT201209030,2012,120903,PIT,HOU,PIT08,5,1,6
PIT201209040,2012,120904,PIT,HOU,PIT08,2,6,8
PIT201209050,2012,120905,PIT,HOU,PIT08,3,6,9
PIT201209070,2012,120907,PIT,CHN,PIT08,12,2,14
PIT201209080,2012,120908,PIT,CHN,PIT08,4,3,7
PIT201209090,2012,120909,PIT,CHN,PIT08,4,2,6
PIT201209180,2012,120918,PIT,MIL,PIT08,6,0,6
PIT201209190,2012,120919,PIT,MIL,PIT08,3,1,4
PIT201209200,2012,120920,PIT,MIL,PIT08,9,7,16
PIT201209280,2012,120928,PIT,CIN,PIT08,1,0,1
PIT201209290,2012,120929,PIT,CIN,PIT08,1,2,3
PIT201209300,2012,120930,PIT,CIN,PIT08,4,3,7
PIT201210010,2012,121001,PIT,ATL,PIT08,1,2,3
PIT201210020,2012,121002,PIT,ATL,PIT08,1,5,6
PIT201210030,2012,121003,PIT,ATL,PIT08,4,0,4
PIT201304010,2013,20130401,PIT,CHN,PIT08,3,1,4
PIT201304030,2013,20130403,PIT,CHN,PIT08,0,3,3
PIT201304040,2013,20130404,PIT,CHN,PIT08,3,2,5
PIT201304120,2013,20130412,PIT,CIN,PIT08,5,6,11
PIT201304130,2013,20130413,PIT,CIN,PIT08,1,3,4
PIT201304140,2013,20130414,PIT,CIN,PIT08,7,10,17
PIT201304150,2013,20130415,PIT,SLN,PIT08,10,6,16
PIT201304170,2013,20130417,PIT,SLN,PIT08,0,5,5
PIT201304180,2013,20130418,PIT,ATL,PIT08,6,4,10
PIT201304190,2013,20130419,PIT,ATL,PIT08,0,6,6
PIT201304200,2013,20130420,PIT,ATL,PIT08,1,3,4
PIT201304210,2013,20130421,PIT,ATL,PIT08,2,4,6
PIT201305030,2013,20130503,PIT,WAS,PIT08,1,3,4
PIT201305040,2013,20130504,PIT,WAS,PIT08,5,4,9
PIT201305050,2013,20130505,PIT,WAS,PIT08,6,2,8
PIT201305070,2013,20130507,PIT,SEA,PIT08,1,4,5
PIT201305080,2013,20130508,PIT,SEA,PIT08,2,1,3
PIT201305130,2013,20130513,PIT,MIL,PIT08,5,1,6
PIT201305140,2013,20130514,PIT,MIL,PIT08,3,4,7
PIT201305150,2013,20130515,PIT,MIL,PIT08,1,3,4
PIT201305160,2013,20130516,PIT,MIL,PIT08,1,7,8
PIT201305170,2013,20130517,PIT,HOU,PIT08,4,5,9
PIT201305180,2013,20130518,PIT,HOU,PIT08,4,2,6
PIT201305190,2013,20130519,PIT,HOU,PIT08,0,1,1
PIT201305210,2013,20130521,PIT,CHN,PIT08,4,5,9
PIT201305220,2013,20130522,PIT,CHN,PIT08,0,1,1
PIT201305230,2013,20130523,PIT,CHN,PIT08,2,4,6
PIT201305290,2013,20130529,PIT,DET,PIT08,3,5,8
PIT201305300,2013,20130530,PIT,DET,PIT08,0,1,1
PIT201305310,2013,20130531,PIT,CIN,PIT08,6,0,6
PIT201306010,2013,20130601,PIT,CIN,PIT08,2,0,2
PIT201306020,2013,20130602,PIT,CIN,PIT08,4,5,9
PIT201306110,2013,20130611,PIT,SFN,PIT08,2,8,10
PIT201306120,2013,20130612,PIT,SFN,PIT08,8,12,20
PIT201306130,2013,20130613,PIT,SFN,PIT08,10,0,10
PIT201306140,2013,20130614,PIT,LAN,PIT08,0,3,3
PIT201306150,2013,20130615,PIT,LAN,PIT08,5,3,8
PIT201306160,2013,20130616,PIT,LAN,PIT08,3,6,9
PIT201306280,2013,20130628,PIT,MIL,PIT08,3,10,13
PIT201306290,2013,20130629,PIT,MIL,PIT08,1,2,3
PIT201306300,2013,20130630,PIT,MIL,PIT08,1,2,3
PIT201307020,2013,20130702,PIT,PHI,PIT08,3,1,4
PIT201307030,2013,20130703,PIT,PHI,PIT08,5,6,11
PIT201307040,2013,20130704,PIT,PHI,PIT08,6,4,10
PIT201307080,2013,20130708,PIT,OAK,PIT08,2,1,3
PIT201307090,2013,20130709,PIT,OAK,PIT08,2,1,3
PIT201307100,2013,20130710,PIT,OAK,PIT08,0,5,5
PIT201307120,2013,20130712,PIT,NYN,PIT08,2,3,5
PIT201307130,2013,20130713,PIT,NYN,PIT08,2,4,6
PIT201307140,2013,20130714,PIT,NYN,PIT08,4,2,6
PIT201307290,2013,20130729,PIT,SLN,PIT08,2,9,11
PIT201307301,2013,20130730,PIT,SLN,PIT08,1,2,3
PIT201307302,2013,20130730,PIT,SLN,PIT08,0,6,6
PIT201307310,2013,20130731,PIT,SLN,PIT08,4,5,9
PIT201308010,2013,20130801,PIT,SLN,PIT08,13,0,13
PIT201308020,2013,20130802,PIT,COL,PIT08,4,2,6
PIT201308030,2013,20130803,PIT,COL,PIT08,2,5,7
PIT201308040,2013,20130804,PIT,COL,PIT08,1,5,6
PIT201308060,2013,20130806,PIT,MIA,PIT08,3,4,7
PIT201308070,2013,20130807,PIT,MIA,PIT08,2,4,6
PIT201308080,2013,20130808,PIT,MIA,PIT08,4,5,9
PIT201308160,2013,20130816,PIT,ARI,PIT08,2,6,8
PIT201308170,2013,20130817,PIT,ARI,PIT08,15,5,20
PIT201308180,2013,20130818,PIT,ARI,PIT08,4,2,6
PIT201308270,2013,20130827,PIT,MIL,PIT08,7,6,13
PIT201308280,2013,20130828,PIT,MIL,PIT08,1,7,8
PIT201308290,2013,20130829,PIT,MIL,PIT08,4,0,4
PIT201308300,2013,20130830,PIT,SLN,PIT08,0,5,5
PIT201308310,2013,20130831,PIT,SLN,PIT08,1,7,8
PIT201309010,2013,20130901,PIT,SLN,PIT08,7,2,9
PIT201309120,2013,20130912,PIT,CHN,PIT08,1,3,4
PIT201309130,2013,20130913,PIT,CHN,PIT08,5,4,9
PIT201309140,2013,20130914,PIT,CHN,PIT08,1,2,3
PIT201309150,2013,20130915,PIT,CHN,PIT08,2,3,5
PIT201309160,2013,20130916,PIT,SDN,PIT08,2,0,2
PIT201309170,2013,20130917,PIT,SDN,PIT08,5,2,7
PIT201309180,2013,20130918,PIT,SDN,PIT08,3,2,5
PIT201309190,2013,20130919,PIT,SDN,PIT08,1,10,11
PIT201309200,2013,20130920,PIT,CIN,PIT08,6,5,11
PIT201309210,2013,20130921,PIT,CIN,PIT08,2,4,6
PIT201309220,2013,20130922,PIT,CIN,PIT08,11,3,14
PIT201310010,2013,20131001,PIT,CIN,PIT08,2,6,8
PIT201310060,2013,20131006,PIT,SLN,PIT08,3,5,8
PIT201310070,2013,20131007,PIT,SLN,PIT08,2,1,3
SDN201004120,2010,100412,SDN,ATL,SAN02,2,17,19
SDN201004140,2010,100414,SDN,ATL,SAN02,6,1,7
SDN201004150,2010,100415,SDN,ATL,SAN02,6,2,8
SDN201004160,2010,100416,SDN,ARI,SAN02,3,6,9
SDN201004170,2010,100417,SDN,ARI,SAN02,0,5,5
SDN201004180,2010,100418,SDN,ARI,SAN02,3,5,8
SDN201004190,2010,100419,SDN,SFN,SAN02,2,3,5
SDN201004200,2010,100420,SDN,SFN,SAN02,0,1,1
SDN201004210,2010,100421,SDN,SFN,SAN02,2,5,7
SDN201004290,2010,100429,SDN,MIL,SAN02,0,9,9
SDN201004300,2010,100430,SDN,MIL,SAN02,0,3,3
SDN201005010,2010,100501,SDN,MIL,SAN02,2,1,3
SDN201005020,2010,100502,SDN,MIL,SAN02,0,8,8
SDN201005030,2010,100503,SDN,COL,SAN02,5,2,7
SDN201005040,2010,100504,SDN,COL,SAN02,2,3,5
SDN201005050,2010,100505,SDN,COL,SAN02,6,5,11
SDN201005140,2010,100514,SDN,LAN,SAN02,4,3,7
SDN201005150,2010,100515,SDN,LAN,SAN02,4,1,5
SDN201005160,2010,100516,SDN,LAN,SAN02,1,0,1
SDN201005170,2010,100517,SDN,SFN,SAN02,1,3,4
SDN201005180,2010,100518,SDN,SFN,SAN02,7,6,13
SDN201005250,2010,100525,SDN,SLN,SAN02,0,1,1
SDN201005260,2010,100526,SDN,SLN,SAN02,1,2,3
SDN201005270,2010,100527,SDN,SLN,SAN02,8,3,11
SDN201005280,2010,100528,SDN,WAS,SAN02,5,3,8
SDN201005290,2010,100529,SDN,WAS,SAN02,2,4,6
SDN201005300,2010,100530,SDN,WAS,SAN02,2,3,5
SDN201005310,2010,100531,SDN,NYN,SAN02,6,18,24
SDN201006010,2010,100601,SDN,NYN,SAN02,4,2,6
SDN201006020,2010,100602,SDN,NYN,SAN02,1,5,6
SDN201006110,2010,100611,SDN,SEA,SAN02,3,4,7
SDN201006120,2010,100612,SDN,SEA,SAN02,1,7,8
SDN201006130,2010,100613,SDN,SEA,SAN02,4,2,6
SDN201006140,2010,100614,SDN,TOR,SAN02,6,3,9
SDN201006150,2010,100615,SDN,TOR,SAN02,2,8,10
SDN201006160,2010,100616,SDN,TOR,SAN02,7,1,8
SDN201006180,2010,100618,SDN,BAL,SAN02,2,3,5
SDN201006190,2010,100619,SDN,BAL,SAN02,5,4,9
SDN201006200,2010,100620,SDN,BAL,SAN02,4,9,13
SDN201006280,2010,100628,SDN,COL,SAN02,10,6,16
SDN201006290,2010,100629,SDN,COL,SAN02,6,3,9
SDN201006300,2010,100630,SDN,COL,SAN02,3,13,16
SDN201007010,2010,100701,SDN,HOU,SAN02,6,3,9
SDN201007020,2010,100702,SDN,HOU,SAN02,0,3,3
SDN201007030,2010,100703,SDN,HOU,SAN02,0,1,1
SDN201007040,2010,100704,SDN,HOU,SAN02,2,3,5
SDN201007160,2010,100716,SDN,ARI,SAN02,1,12,13
SDN201007170,2010,100717,SDN,ARI,SAN02,5,8,13
SDN201007180,2010,100718,SDN,ARI,SAN02,4,6,10
SDN201007270,2010,100727,SDN,LAN,SAN02,2,0,2
SDN201007280,2010,100728,SDN,LAN,SAN02,1,6,7
SDN201007290,2010,100729,SDN,LAN,SAN02,2,3,5
SDN201007300,2010,100730,SDN,FLO,SAN02,4,2,6
SDN201007310,2010,100731,SDN,FLO,SAN02,6,3,9
SDN201008010,2010,100801,SDN,FLO,SAN02,4,5,9
SDN201008100,2010,100810,SDN,PIT,SAN02,1,4,5
SDN201008110,2010,100811,SDN,PIT,SAN02,5,8,13
SDN201008120,2010,100812,SDN,PIT,SAN02,0,3,3
SDN201008240,2010,100824,SDN,ARI,SAN02,0,5,5
SDN201008250,2010,100825,SDN,ARI,SAN02,3,9,12
SDN201008260,2010,100826,SDN,ARI,SAN02,11,5,16
SDN201008270,2010,100827,SDN,PHI,SAN02,3,2,5
SDN201008280,2010,100828,SDN,PHI,SAN02,3,1,4
SDN201008290,2010,100829,SDN,PHI,SAN02,5,0,5
SDN201009030,2010,100903,SDN,COL,SAN02,4,3,7
SDN201009040,2010,100904,SDN,COL,SAN02,6,2,8
SDN201009050,2010,100905,SDN,COL,SAN02,4,2,6
SDN201009060,2010,100906,SDN,LAN,SAN02,2,4,6
SDN201009070,2010,100907,SDN,LAN,SAN02,1,2,3
SDN201009080,2010,100908,SDN,LAN,SAN02,0,4,4
SDN201009090,2010,100909,SDN,SFN,SAN02,7,3,10
SDN201009100,2010,100910,SDN,SFN,SAN02,1,0,1
SDN201009110,2010,100911,SDN,SFN,SAN02,0,1,1
SDN201009120,2010,100912,SDN,SFN,SAN02,6,1,7
SDN201009240,2010,100924,SDN,CIN,SAN02,3,4,7
SDN201009250,2010,100925,SDN,CIN,SAN02,3,4,7
SDN201009260,2010,100926,SDN,CIN,SAN02,12,2,14
SDN201009270,2010,100927,SDN,CHN,SAN02,1,0,1
SDN201009280,2010,100928,SDN,CHN,SAN02,5,2,7
SDN201009290,2010,100929,SDN,CHN,SAN02,0,3,3
SDN201009300,2010,100930,SDN,CHN,SAN02,1,0,1
SDN201104050,2011,20110405,SDN,SFN,SAN02,1,3,4
SDN201104060,2011,20110406,SDN,SFN,SAN02,8,4,12
SDN201104080,2011,20110408,SDN,LAN,SAN02,4,2,6
SDN201104090,2011,20110409,SDN,LAN,SAN02,4,0,4
SDN201104100,2011,20110410,SDN,LAN,SAN02,2,7,9
SDN201104110,2011,20110411,SDN,CIN,SAN02,3,2,5
SDN201104120,2011,20110412,SDN,CIN,SAN02,8,2,10
SDN201104130,2011,20110413,SDN,CIN,SAN02,2,3,5
SDN201104210,2011,20110421,SDN,PHI,SAN02,3,0,3
SDN201104220,2011,20110422,SDN,PHI,SAN02,2,0,2
SDN201104230,2011,20110423,SDN,PHI,SAN02,4,2,6
SDN201104240,2011,20110424,SDN,PHI,SAN02,3,1,4
SDN201104250,2011,20110425,SDN,ATL,SAN02,3,5,8
SDN201104260,2011,20110426,SDN,ATL,SAN02,8,2,10
SDN201104270,2011,20110427,SDN,ATL,SAN02,7,0,7
SDN201105020,2011,20110502,SDN,PIT,SAN02,4,3,7
SDN201105030,2011,20110503,SDN,PIT,SAN02,5,6,11
SDN201105040,2011,20110504,SDN,PIT,SAN02,7,4,11
SDN201105060,2011,20110506,SDN,ARI,SAN02,3,4,7
SDN201105070,2011,20110507,SDN,ARI,SAN02,6,0,6
SDN201105080,2011,20110508,SDN,ARI,SAN02,3,4,7
SDN201105180,2011,20110518,SDN,MIL,SAN02,5,2,7
SDN201105190,2011,20110519,SDN,MIL,SAN02,0,1,1
SDN201105200,2011,20110520,SDN,SEA,SAN02,4,1,5
SDN201105210,2011,20110521,SDN,SEA,SAN02,4,0,4
SDN201105220,2011,20110522,SDN,SEA,SAN02,6,1,7
SDN201105230,2011,20110523,SDN,SLN,SAN02,3,1,4
SDN201105240,2011,20110524,SDN,SLN,SAN02,3,2,5
SDN201105250,2011,20110525,SDN,SLN,SAN02,1,3,4
SDN201106020,2011,20110602,SDN,HOU,SAN02,7,4,11
SDN201106030,2011,20110603,SDN,HOU,SAN02,1,3,4
SDN201106040,2011,20110604,SDN,HOU,SAN02,3,6,9
SDN201106050,2011,20110605,SDN,HOU,SAN02,2,7,9
SDN201106060,2011,20110606,SDN,COL,SAN02,3,0,3
SDN201106070,2011,20110607,SDN,COL,SAN02,0,2,2
SDN201106080,2011,20110608,SDN,COL,SAN02,5,3,8
SDN201106090,2011,20110609,SDN,WAS,SAN02,3,7,10
SDN201106100,2011,20110610,SDN,WAS,SAN02,2,1,3
SDN201106110,2011,20110611,SDN,WAS,SAN02,2,1,3
SDN201106120,2011,20110612,SDN,WAS,SAN02,2,0,2
SDN201106240,2011,20110624,SDN,ATL,SAN02,2,11,13
SDN201106250,2011,20110625,SDN,ATL,SAN02,10,1,11
SDN201106260,2011,20110626,SDN,ATL,SAN02,1,4,5
SDN201106270,2011,20110627,SDN,KCA,SAN02,3,4,7
SDN201106280,2011,20110628,SDN,KCA,SAN02,2,4,6
SDN201106290,2011,20110629,SDN,KCA,SAN02,1,4,5
SDN201107140,2011,20110714,SDN,SFN,SAN02,6,2,8
SDN201107150,2011,20110715,SDN,SFN,SAN02,6,1,7
SDN201107160,2011,20110716,SDN,SFN,SAN02,3,11,14
SDN201107170,2011,20110717,SDN,SFN,SAN02,4,3,7
SDN201107260,2011,20110726,SDN,ARI,SAN02,6,1,7
SDN201107270,2011,20110727,SDN,ARI,SAN02,4,3,7
SDN201107280,2011,20110728,SDN,ARI,SAN02,3,4,7
SDN201107290,2011,20110729,SDN,COL,SAN02,3,2,5
SDN201107300,2011,20110730,SDN,COL,SAN02,10,6,16
SDN201107310,2011,20110731,SDN,COL,SAN02,3,8,11
SDN201108010,2011,20110801,SDN,LAN,SAN02,6,2,8
SDN201108020,2011,20110802,SDN,LAN,SAN02,1,0,1
SDN201108030,2011,20110803,SDN,LAN,SAN02,0,3,3
SDN201108150,2011,20110815,SDN,NYN,SAN02,5,4,9
SDN201108160,2011,20110816,SDN,NYN,SAN02,1,6,7
SDN201108170,2011,20110817,SDN,NYN,SAN02,7,3,10
SDN201108180,2011,20110818,SDN,FLO,SAN02,1,3,4
SDN201108190,2011,20110819,SDN,FLO,SAN02,3,4,7
SDN201108200,2011,20110820,SDN,FLO,SAN02,1,14,15
SDN201108210,2011,20110821,SDN,FLO,SAN02,3,4,7
SDN201109020,2011,20110902,SDN,COL,SAN02,3,0,3
SDN201109030,2011,20110903,SDN,COL,SAN02,5,4,9
SDN201109040,2011,20110904,SDN,COL,SAN02,2,7,9
SDN201109050,2011,20110905,SDN,SFN,SAN02,7,2,9
SDN201109060,2011,20110906,SDN,SFN,SAN02,6,4,10
SDN201109070,2011,20110907,SDN,SFN,SAN02,1,3,4
SDN201109160,2011,20110916,SDN,ARI,SAN02,0,2,2
SDN201109170,2011,20110917,SDN,ARI,SAN02,1,3,4
SDN201109180,2011,20110918,SDN,ARI,SAN02,5,1,6
SDN201109230,2011,20110923,SDN,LAN,SAN02,2,0,2
SDN201109240,2011,20110924,SDN,LAN,SAN02,0,3,3
SDN201109250,2011,20110925,SDN,LAN,SAN02,6,2,8
SDN201109260,2011,20110926,SDN,CHN,SAN02,0,2,2
SDN201109270,2011,20110927,SDN,CHN,SAN02,6,2,8
SDN201109280,2011,20110928,SDN,CHN,SAN02,2,9,11
SDN201204050,2012,120405,SDN,LAN,SAN02,5,3,8
SDN201204060,2012,120406,SDN,LAN,SAN02,6,0,6
SDN201204070,2012,120407,SDN,LAN,SAN02,6,5,11
SDN201204080,2012,120408,SDN,LAN,SAN02,4,8,12
SDN201204100,2012,120410,SDN,ARI,SAN02,4,2,6
SDN201204110,2012,120411,SDN,ARI,SAN02,1,2,3
SDN201204120,2012,120412,SDN,ARI,SAN02,3,1,4
SDN201204190,2012,120419,SDN,PHI,SAN02,2,0,2
SDN201204200,2012,120420,SDN,PHI,SAN02,4,1,5
SDN201204210,2012,120421,SDN,PHI,SAN02,1,5,6
SDN201204220,2012,120422,SDN,PHI,SAN02,1,6,7
SDN201204240,2012,120424,SDN,WAS,SAN02,3,1,4
SDN201204250,2012,120425,SDN,WAS,SAN02,7,2,9
SDN201204260,2012,120426,SDN,WAS,SAN02,1,2,3
SDN201204300,2012,120430,SDN,MIL,SAN02,8,3,11
SDN201205010,2012,120501,SDN,MIL,SAN02,0,2,2
SDN201205020,2012,120502,SDN,MIL,SAN02,0,5,5
SDN201205040,2012,120504,SDN,MIA,SAN02,9,8,17
SDN201205050,2012,120505,SDN,MIA,SAN02,4,1,5
SDN201205060,2012,120506,SDN,MIA,SAN02,6,3,9
SDN201205070,2012,120507,SDN,COL,SAN02,2,3,5
SDN201205080,2012,120508,SDN,COL,SAN02,1,3,4
SDN201205090,2012,120509,SDN,COL,SAN02,6,2,8
SDN201205160,2012,120516,SDN,LAN,SAN02,2,4,6
SDN201205170,2012,120517,SDN,LAN,SAN02,8,1,9
SDN201205180,2012,120518,SDN,ANA,SAN02,7,2,9
SDN201205190,2012,120519,SDN,ANA,SAN02,2,3,5
SDN201205200,2012,120520,SDN,ANA,SAN02,2,3,5
SDN201206010,2012,120601,SDN,ARI,SAN02,1,7,8
SDN201206020,2012,120602,SDN,ARI,SAN02,4,2,6
SDN201206030,2012,120603,SDN,ARI,SAN02,6,0,6
SDN201206050,2012,120605,SDN,SFN,SAN02,5,6,11
SDN201206060,2012,120606,SDN,SFN,SAN02,6,5,11
SDN201206070,2012,120607,SDN,SFN,SAN02,8,3,11
SDN201206180,2012,120618,SDN,TEX,SAN02,2,1,3
SDN201206190,2012,120619,SDN,TEX,SAN02,7,3,10
SDN201206200,2012,120620,SDN,TEX,SAN02,4,2,6
SDN201206220,2012,120622,SDN,SEA,SAN02,5,9,14
SDN201206230,2012,120623,SDN,SEA,SAN02,5,1,6
SDN201206240,2012,120624,SDN,SEA,SAN02,0,2,2
SDN201207050,2012,120705,SDN,CIN,SAN02,1,2,3
SDN201207060,2012,120706,SDN,CIN,SAN02,6,0,6
SDN201207070,2012,120707,SDN,CIN,SAN02,6,5,11
SDN201207080,2012,120708,SDN,CIN,SAN02,4,2,6
SDN201207160,2012,120716,SDN,HOU,SAN02,2,0,2
SDN201207170,2012,120717,SDN,HOU,SAN02,2,8,10
SDN201207180,2012,120718,SDN,HOU,SAN02,4,8,12
SDN201207190,2012,120719,SDN,HOU,SAN02,0,1,1
SDN201207200,2012,120720,SDN,COL,SAN02,5,9,14
SDN201207210,2012,120721,SDN,COL,SAN02,8,6,14
SDN201207220,2012,120722,SDN,COL,SAN02,2,3,5
SDN201208030,2012,120803,SDN,NYN,SAN02,1,3,4
SDN201208040,2012,120804,SDN,NYN,SAN02,6,2,8
SDN201208050,2012,120805,SDN,NYN,SAN02,3,7,10
SDN201208060,2012,120806,SDN,CHN,SAN02,0,2,2
SDN201208070,2012,120807,SDN,CHN,SAN02,4,7,11
SDN201208080,2012,120808,SDN,CHN,SAN02,0,2,2
SDN201208170,2012,120817,SDN,SFN,SAN02,10,1,11
SDN201208180,2012,120818,SDN,SFN,SAN02,8,7,15
SDN201208190,2012,120819,SDN,SFN,SAN02,1,7,8
SDN201208200,2012,120820,SDN,PIT,SAN02,1,3,4
SDN201208210,2012,120821,SDN,PIT,SAN02,5,7,12
SDN201208220,2012,120822,SDN,PIT,SAN02,2,4,6
SDN201208270,2012,120827,SDN,ATL,SAN02,0,3,3
SDN201208280,2012,120828,SDN,ATL,SAN02,2,0,2
SDN201208290,2012,120829,SDN,ATL,SAN02,2,8,10
SDN201209070,2012,120907,SDN,ARI,SAN02,5,6,11
SDN201209080,2012,120908,SDN,ARI,SAN02,8,5,13
SDN201209090,2012,120909,SDN,ARI,SAN02,2,8,10
SDN201209100,2012,120910,SDN,SLN,SAN02,3,11,14
SDN201209110,2012,120911,SDN,SLN,SAN02,4,6,10
SDN201209120,2012,120912,SDN,SLN,SAN02,2,3,5
SDN201209140,2012,120914,SDN,COL,SAN02,7,4,11
SDN201209150,2012,120915,SDN,COL,SAN02,3,4,7
SDN201209160,2012,120916,SDN,COL,SAN02,11,12,23
SDN201209250,2012,120925,SDN,LAN,SAN02,1,2,3
SDN201209260,2012,120926,SDN,LAN,SAN02,8,2,10
SDN201209270,2012,120927,SDN,LAN,SAN02,8,4,12
SDN201209280,2012,120928,SDN,SFN,SAN02,3,1,4
SDN201209290,2012,120929,SDN,SFN,SAN02,3,7,10
SDN201209300,2012,120930,SDN,SFN,SAN02,7,5,12
SDN201304090,2013,20130409,SDN,LAN,SAN02,3,9,12
SDN201304100,2013,20130410,SDN,LAN,SAN02,4,3,7
SDN201304110,2013,20130411,SDN,LAN,SAN02,3,2,5
SDN201304120,2013,20130412,SDN,COL,SAN02,7,5,12
SDN201304130,2013,20130413,SDN,COL,SAN02,9,5,14
SDN201304140,2013,20130414,SDN,COL,SAN02,2,1,3
SDN201304220,2013,20130422,SDN,MIL,SAN02,7,1,8
SDN201304230,2013,20130423,SDN,MIL,SAN02,6,3,9
SDN201304240,2013,20130424,SDN,MIL,SAN02,1,2,3
SDN201304260,2013,20130426,SDN,SFN,SAN02,1,2,3
SDN201304270,2013,20130427,SDN,SFN,SAN02,7,8,15
SDN201304280,2013,20130428,SDN,SFN,SAN02,4,6,10
SDN201305030,2013,20130503,SDN,ARI,SAN02,6,7,13
SDN201305040,2013,20130504,SDN,ARI,SAN02,8,1,9
SDN201305050,2013,20130505,SDN,ARI,SAN02,1,5,6
SDN201305060,2013,20130506,SDN,MIA,SAN02,0,5,5
SDN201305070,2013,20130507,SDN,MIA,SAN02,1,5,6
SDN201305080,2013,20130508,SDN,MIA,SAN02,0,1,1
SDN201305160,2013,20130516,SDN,WAS,SAN02,6,2,8
SDN201305170,2013,20130517,SDN,WAS,SAN02,6,5,11
SDN201305180,2013,20130518,SDN,WAS,SAN02,1,2,3
SDN201305190,2013,20130519,SDN,WAS,SAN02,4,13,17
SDN201305200,2013,20130520,SDN,SLN,SAN02,2,4,6
SDN201305210,2013,20130521,SDN,SLN,SAN02,10,2,12
SDN201305220,2013,20130522,SDN,SLN,SAN02,5,3,8
SDN201305290,2013,20130529,SDN,SEA,SAN02,2,3,5
SDN201305300,2013,20130530,SDN,SEA,SAN02,7,1,8
SDN201305310,2013,20130531,SDN,TOR,SAN02,3,4,7
SDN201306010,2013,20130601,SDN,TOR,SAN02,3,4,7
SDN201306020,2013,20130602,SDN,TOR,SAN02,7,4,11
SDN201306100,2013,20130610,SDN,ATL,SAN02,6,7,13
SDN201306110,2013,20130611,SDN,ATL,SAN02,2,3,5
SDN201306120,2013,20130612,SDN,ATL,SAN02,3,5,8
SDN201306140,2013,20130614,SDN,ARI,SAN02,1,2,3
SDN201306150,2013,20130615,SDN,ARI,SAN02,4,6,10
SDN201306160,2013,20130616,SDN,ARI,SAN02,1,4,5
SDN201306200,2013,20130620,SDN,LAN,SAN02,3,6,9
SDN201306210,2013,20130621,SDN,LAN,SAN02,2,5,7
SDN201306220,2013,20130622,SDN,LAN,SAN02,6,1,7
SDN201306230,2013,20130623,SDN,LAN,SAN02,3,1,4
SDN201306240,2013,20130624,SDN,PHI,SAN02,3,4,7
SDN201306250,2013,20130625,SDN,PHI,SAN02,6,2,8
SDN201306260,2013,20130626,SDN,PHI,SAN02,7,5,12
SDN201307080,2013,20130708,SDN,COL,SAN02,4,2,6
SDN201307090,2013,20130709,SDN,COL,SAN02,1,2,3
SDN201307100,2013,20130710,SDN,COL,SAN02,5,4,9
SDN201307110,2013,20130711,SDN,SFN,SAN02,4,2,6
SDN201307120,2013,20130712,SDN,SFN,SAN02,10,1,11
SDN201307130,2013,20130713,SDN,SFN,SAN02,9,0,9
SDN201307140,2013,20130714,SDN,SFN,SAN02,1,10,11
SDN201307290,2013,20130729,SDN,CIN,SAN02,1,2,3
SDN201307300,2013,20130730,SDN,CIN,SAN02,2,4,6
SDN201307310,2013,20130731,SDN,CIN,SAN02,4,1,5
SDN201308020,2013,20130802,SDN,NYA,SAN02,2,7,9
SDN201308030,2013,20130803,SDN,NYA,SAN02,3,0,3
SDN201308040,2013,20130804,SDN,NYA,SAN02,3,6,9
SDN201308060,2013,20130806,SDN,BAL,SAN02,4,1,5
SDN201308070,2013,20130807,SDN,BAL,SAN02,10,3,13
SDN201308150,2013,20130815,SDN,NYN,SAN02,4,1,5
SDN201308160,2013,20130816,SDN,NYN,SAN02,5,2,7
SDN201308170,2013,20130817,SDN,NYN,SAN02,2,8,10
SDN201308180,2013,20130818,SDN,NYN,SAN02,3,4,7
SDN201308190,2013,20130819,SDN,PIT,SAN02,3,1,4
SDN201308200,2013,20130820,SDN,PIT,SAN02,8,1,9
SDN201308210,2013,20130821,SDN,PIT,SAN02,1,2,3
SDN201308230,2013,20130823,SDN,CHN,SAN02,6,8,14
SDN201308240,2013,20130824,SDN,CHN,SAN02,3,2,5
SDN201308250,2013,20130825,SDN,CHN,SAN02,2,3,5
SDN201309020,2013,20130902,SDN,SFN,SAN02,1,4,5
SDN201309030,2013,20130903,SDN,SFN,SAN02,2,3,5
SDN201309040,2013,20130904,SDN,SFN,SAN02,13,5,18
SDN201309060,2013,20130906,SDN,COL,SAN02,3,4,7
SDN201309070,2013,20130907,SDN,COL,SAN02,1,2,3
SDN201309080,2013,20130908,SDN,COL,SAN02,2,5,7
SDN201309200,2013,20130920,SDN,LAN,SAN02,0,2,2
SDN201309210,2013,20130921,SDN,LAN,SAN02,4,0,4
SDN201309220,2013,20130922,SDN,LAN,SAN02,1,0,1
SDN201309230,2013,20130923,SDN,ARI,SAN02,1,4,5
SDN201309240,2013,20130924,SDN,ARI,SAN02,2,1,3
SDN201309250,2013,20130925,SDN,ARI,SAN02,2,12,14
SDN201309260,2013,20130926,SDN,ARI,SAN02,2,3,5
SEA201004120,2010,100412,SEA,OAK,SEA03,4,0,4
SEA201004130,2010,100413,SEA,OAK,SEA03,0,3,3
SEA201004140,2010,100414,SEA,OAK,SEA03,2,4,6
SEA201004160,2010,100416,SEA,DET,SEA03,3,11,14
SEA201004170,2010,100417,SEA,DET,SEA03,2,4,6
SEA201004180,2010,100418,SEA,DET,SEA03,4,2,6
SEA201004190,2010,100419,SEA,BAL,SEA03,2,8,10
SEA201004200,2010,100420,SEA,BAL,SEA03,1,3,4
SEA201004210,2010,100421,SEA,BAL,SEA03,1,4,5
SEA201004300,2010,100430,SEA,TEX,SEA03,2,0,2
SEA201005010,2010,100501,SEA,TEX,SEA03,6,3,9
SEA201005020,2010,100502,SEA,TEX,SEA03,3,1,4
SEA201005040,2010,100504,SEA,TBA,SEA03,5,2,7
SEA201005050,2010,100505,SEA,TBA,SEA03,8,3,11
SEA201005060,2010,100506,SEA,TBA,SEA03,8,0,8
SEA201005070,2010,100507,SEA,ANA,SEA03,8,0,8
SEA201005080,2010,100508,SEA,ANA,SEA03,4,3,7
SEA201005090,2010,100509,SEA,ANA,SEA03,1,8,9
SEA201005190,2010,100519,SEA,TOR,SEA03,3,2,5
SEA201005200,2010,100520,SEA,TOR,SEA03,3,4,7
SEA201005210,2010,100521,SEA,SDN,SEA03,8,15,23
SEA201005220,2010,100522,SEA,SDN,SEA03,2,1,3
SEA201005230,2010,100523,SEA,SDN,SEA03,8,1,9
SEA201005250,2010,100525,SEA,DET,SEA03,3,5,8
SEA201005260,2010,100526,SEA,DET,SEA03,4,5,9
SEA201005310,2010,100531,SEA,MIN,SEA03,5,4,9
SEA201006010,2010,100601,SEA,MIN,SEA03,1,7,8
SEA201006020,2010,100602,SEA,MIN,SEA03,1,2,3
SEA201006030,2010,100603,SEA,MIN,SEA03,1,4,5
SEA201006040,2010,100604,SEA,ANA,SEA03,7,1,8
SEA201006050,2010,100605,SEA,ANA,SEA03,11,2,13
SEA201006060,2010,100606,SEA,ANA,SEA03,9,4,13
SEA201006180,2010,100618,SEA,CIN,SEA03,0,1,1
SEA201006190,2010,100619,SEA,CIN,SEA03,1,5,6
SEA201006200,2010,100620,SEA,CIN,SEA03,0,1,1
SEA201006220,2010,100622,SEA,CHN,SEA03,0,2,2
SEA201006230,2010,100623,SEA,CHN,SEA03,1,8,9
SEA201006240,2010,100624,SEA,CHN,SEA03,3,2,5
SEA201007050,2010,100705,SEA,KCA,SEA03,6,4,10
SEA201007060,2010,100706,SEA,KCA,SEA03,3,2,5
SEA201007070,2010,100707,SEA,KCA,SEA03,7,3,10
SEA201007080,2010,100708,SEA,NYA,SEA03,3,1,4
SEA201007090,2010,100709,SEA,NYA,SEA03,6,1,7
SEA201007100,2010,100710,SEA,NYA,SEA03,1,4,5
SEA201007110,2010,100711,SEA,NYA,SEA03,8,2,10
SEA201007190,2010,100719,SEA,CHA,SEA03,6,1,7
SEA201007200,2010,100720,SEA,CHA,SEA03,4,0,4
SEA201007210,2010,100721,SEA,CHA,SEA03,1,2,3
SEA201007220,2010,100722,SEA,BOS,SEA03,8,6,14
SEA201007230,2010,100723,SEA,BOS,SEA03,2,1,3
SEA201007240,2010,100724,SEA,BOS,SEA03,1,5,6
SEA201007250,2010,100725,SEA,BOS,SEA03,2,4,6
SEA201008030,2010,100803,SEA,TEX,SEA03,2,3,5
SEA201008040,2010,100804,SEA,TEX,SEA03,11,6,17
SEA201008050,2010,100805,SEA,TEX,SEA03,6,0,6
SEA201008060,2010,100806,SEA,KCA,SEA03,1,7,8
SEA201008070,2010,100807,SEA,KCA,SEA03,2,1,3
SEA201008080,2010,100808,SEA,KCA,SEA03,2,3,5
SEA201008090,2010,100809,SEA,OAK,SEA03,1,3,4
SEA201008100,2010,100810,SEA,OAK,SEA03,0,2,2
SEA201008110,2010,100811,SEA,OAK,SEA03,5,1,6
SEA201008270,2010,100827,SEA,MIN,SEA03,6,3,9
SEA201008280,2010,100828,SEA,MIN,SEA03,1,0,1
SEA201008290,2010,100829,SEA,MIN,SEA03,1,2,3
SEA201008300,2010,100830,SEA,ANA,SEA03,5,3,8
SEA201008310,2010,100831,SEA,ANA,SEA03,1,3,4
SEA201009010,2010,100901,SEA,ANA,SEA03,4,2,6
SEA201009020,2010,100902,SEA,CLE,SEA03,6,3,9
SEA201009030,2010,100903,SEA,CLE,SEA03,0,1,1
SEA201009040,2010,100904,SEA,CLE,SEA03,4,2,6
SEA201009050,2010,100905,SEA,CLE,SEA03,0,3,3
SEA201009130,2010,100913,SEA,BOS,SEA03,5,1,6
SEA201009140,2010,100914,SEA,BOS,SEA03,9,6,15
SEA201009150,2010,100915,SEA,BOS,SEA03,5,1,6
SEA201009170,2010,100917,SEA,TEX,SEA03,1,2,3
SEA201009180,2010,100918,SEA,TEX,SEA03,6,1,7
SEA201009190,2010,100919,SEA,TEX,SEA03,1,2,3
SEA201009300,2010,100930,SEA,OAK,SEA03,8,1,9
SEA201010010,2010,101001,SEA,OAK,SEA03,9,0,9
SEA201010020,2010,101002,SEA,OAK,SEA03,5,3,8
SEA201010030,2010,101003,SEA,OAK,SEA03,4,3,7
SEA201104080,2011,20110408,SEA,CLE,SEA03,12,3,15
SEA201104090,2011,20110409,SEA,CLE,SEA03,2,1,3
SEA201104100,2011,20110410,SEA,CLE,SEA03,6,4,10
SEA201104110,2011,20110411,SEA,TOR,SEA03,7,8,15
SEA201104120,2011,20110412,SEA,TOR,SEA03,2,3,5
SEA201104130,2011,20110413,SEA,TOR,SEA03,8,3,11
SEA201104180,2011,20110418,SEA,DET,SEA03,8,3,11
SEA201104190,2011,20110419,SEA,DET,SEA03,3,13,16
SEA201104200,2011,20110420,SEA,DET,SEA03,3,2,5
SEA201104210,2011,20110421,SEA,OAK,SEA03,0,1,1
SEA201104220,2011,20110422,SEA,OAK,SEA03,0,4,4
SEA201104230,2011,20110423,SEA,OAK,SEA03,9,1,10
SEA201104240,2011,20110424,SEA,OAK,SEA03,5,2,7
SEA201105030,2011,20110503,SEA,TEX,SEA03,3,4,7
SEA201105040,2011,20110504,SEA,TEX,SEA03,5,2,7
SEA201105050,2011,20110505,SEA,TEX,SEA03,1,3,4
SEA201105060,2011,20110506,SEA,CHA,SEA03,2,3,5
SEA201105070,2011,20110507,SEA,CHA,SEA03,6,0,6
SEA201105080,2011,20110508,SEA,CHA,SEA03,5,2,7
SEA201105160,2011,20110516,SEA,MIN,SEA03,2,5,7
SEA201105170,2011,20110517,SEA,MIN,SEA03,2,1,3
SEA201105180,2011,20110518,SEA,ANA,SEA03,0,3,3
SEA201105190,2011,20110519,SEA,ANA,SEA03,1,2,3
SEA201105270,2011,20110527,SEA,NYA,SEA03,3,4,7
SEA201105280,2011,20110528,SEA,NYA,SEA03,4,5,9
SEA201105290,2011,20110529,SEA,NYA,SEA03,7,1,8
SEA201105300,2011,20110530,SEA,BAL,SEA03,3,4,7
SEA201105310,2011,20110531,SEA,BAL,SEA03,2,3,5
SEA201106010,2011,20110601,SEA,BAL,SEA03,2,1,3
SEA201106020,2011,20110602,SEA,TBA,SEA03,2,8,10
SEA201106030,2011,20110603,SEA,TBA,SEA03,0,7,7
SEA201106040,2011,20110604,SEA,TBA,SEA03,3,2,5
SEA201106050,2011,20110605,SEA,TBA,SEA03,6,9,15
SEA201106130,2011,20110613,SEA,ANA,SEA03,6,3,9
SEA201106140,2011,20110614,SEA,ANA,SEA03,4,0,4
SEA201106150,2011,20110615,SEA,ANA,SEA03,1,3,4
SEA201106170,2011,20110617,SEA,PHI,SEA03,2,4,6
SEA201106180,2011,20110618,SEA,PHI,SEA03,5,1,6
SEA201106190,2011,20110619,SEA,PHI,SEA03,0,2,2
SEA201106270,2011,20110627,SEA,ATL,SEA03,3,1,4
SEA201106280,2011,20110628,SEA,ATL,SEA03,5,4,9
SEA201106290,2011,20110629,SEA,ATL,SEA03,5,3,8
SEA201107010,2011,20110701,SEA,SDN,SEA03,0,6,6
SEA201107020,2011,20110702,SEA,SDN,SEA03,1,0,1
SEA201107030,2011,20110703,SEA,SDN,SEA03,1,3,4
SEA201107140,2011,20110714,SEA,TEX,SEA03,5,0,5
SEA201107150,2011,20110715,SEA,TEX,SEA03,4,0,4
SEA201107160,2011,20110716,SEA,TEX,SEA03,5,1,6
SEA201107170,2011,20110717,SEA,TEX,SEA03,3,1,4
SEA201107290,2011,20110729,SEA,TBA,SEA03,8,0,8
SEA201107300,2011,20110730,SEA,TBA,SEA03,2,3,5
SEA201107310,2011,20110731,SEA,TBA,SEA03,8,1,9
SEA201108010,2011,20110801,SEA,OAK,SEA03,4,8,12
SEA201108020,2011,20110802,SEA,OAK,SEA03,2,4,6
SEA201108030,2011,20110803,SEA,OAK,SEA03,4,7,11
SEA201108120,2011,20110812,SEA,BOS,SEA03,6,4,10
SEA201108130,2011,20110813,SEA,BOS,SEA03,4,5,9
SEA201108140,2011,20110814,SEA,BOS,SEA03,3,5,8
SEA201108150,2011,20110815,SEA,TOR,SEA03,5,6,11
SEA201108160,2011,20110816,SEA,TOR,SEA03,13,7,20
SEA201108170,2011,20110817,SEA,TOR,SEA03,5,1,6
SEA201108260,2011,20110826,SEA,CHA,SEA03,4,2,6
SEA201108270,2011,20110827,SEA,CHA,SEA03,3,0,3
SEA201108280,2011,20110828,SEA,CHA,SEA03,9,3,12
SEA201108290,2011,20110829,SEA,ANA,SEA03,3,5,8
SEA201108300,2011,20110830,SEA,ANA,SEA03,13,6,19
SEA201108310,2011,20110831,SEA,ANA,SEA03,1,2,3
SEA201109010,2011,20110901,SEA,ANA,SEA03,4,3,7
SEA201109080,2011,20110908,SEA,KCA,SEA03,1,4,5
SEA201109090,2011,20110909,SEA,KCA,SEA03,3,7,10
SEA201109100,2011,20110910,SEA,KCA,SEA03,4,2,6
SEA201109110,2011,20110911,SEA,KCA,SEA03,2,1,3
SEA201109120,2011,20110912,SEA,NYA,SEA03,9,3,12
SEA201109130,2011,20110913,SEA,NYA,SEA03,3,2,5
SEA201109140,2011,20110914,SEA,NYA,SEA03,1,2,3
SEA201109160,2011,20110916,SEA,TEX,SEA03,0,4,4
SEA201109170,2011,20110917,SEA,TEX,SEA03,7,6,13
SEA201109180,2011,20110918,SEA,TEX,SEA03,3,0,3
SEA201109260,2011,20110926,SEA,OAK,SEA03,2,4,6
SEA201109270,2011,20110927,SEA,OAK,SEA03,7,0,7
SEA201109280,2011,20110928,SEA,OAK,SEA03,2,0,2
SEA201204130,2012,120413,SEA,OAK,SEA03,4,0,4
SEA201204140,2012,120414,SEA,OAK,SEA03,0,4,4
SEA201204150,2012,120415,SEA,OAK,SEA03,3,5,8
SEA201204170,2012,120417,SEA,CLE,SEA03,9,8,17
SEA201204180,2012,120418,SEA,CLE,SEA03,1,4,5
SEA201204190,2012,120419,SEA,CLE,SEA03,2,1,3
SEA201204200,2012,120420,SEA,CHA,SEA03,7,3,10
SEA201204210,2012,120421,SEA,CHA,SEA03,4,0,4
SEA201204220,2012,120422,SEA,CHA,SEA03,7,4,11
SEA201205040,2012,120504,SEA,MIN,SEA03,3,2,5
SEA201205050,2012,120505,SEA,MIN,SEA03,0,7,7
SEA201205060,2012,120506,SEA,MIN,SEA03,2,5,7
SEA201205070,2012,120507,SEA,DET,SEA03,2,3,5
SEA201205080,2012,120508,SEA,DET,SEA03,6,4,10
SEA201205090,2012,120509,SEA,DET,SEA03,1,2,3
SEA201205210,2012,120521,SEA,TEX,SEA03,1,6,7
SEA201205220,2012,120522,SEA,TEX,SEA03,3,1,4
SEA201205230,2012,120523,SEA,TEX,SEA03,3,5,8
SEA201205240,2012,120524,SEA,ANA,SEA03,3,0,3
SEA201205250,2012,120525,SEA,ANA,SEA03,6,4,10
SEA201205260,2012,120526,SEA,ANA,SEA03,5,3,8
SEA201205270,2012,120527,SEA,ANA,SEA03,4,2,6
SEA201206080,2012,120608,SEA,LAN,SEA03,0,1,1
SEA201206090,2012,120609,SEA,LAN,SEA03,8,3,11
SEA201206100,2012,120610,SEA,LAN,SEA03,8,2,10
SEA201206120,2012,120612,SEA,SDN,SEA03,5,4,9
SEA201206130,2012,120613,SEA,SDN,SEA03,1,0,1
SEA201206140,2012,120614,SEA,SDN,SEA03,6,2,8
SEA201206150,2012,120615,SEA,SFN,SEA03,4,2,6
SEA201206160,2012,120616,SEA,SFN,SEA03,4,7,11
SEA201206170,2012,120617,SEA,SFN,SEA03,1,2,3
SEA201206250,2012,120625,SEA,OAK,SEA03,1,0,1
SEA201206260,2012,120626,SEA,OAK,SEA03,2,3,5
SEA201206270,2012,120627,SEA,OAK,SEA03,2,1,3
SEA201206280,2012,120628,SEA,BOS,SEA03,0,1,1
SEA201206290,2012,120629,SEA,BOS,SEA03,5,0,5
SEA201206300,2012,120630,SEA,BOS,SEA03,2,3,5
SEA201207010,2012,120701,SEA,BOS,SEA03,2,1,3
SEA201207020,2012,120702,SEA,BAL,SEA03,3,6,9
SEA201207030,2012,120703,SEA,BAL,SEA03,5,4,9
SEA201207040,2012,120704,SEA,BAL,SEA03,4,2,6
SEA201207130,2012,120713,SEA,TEX,SEA03,3,2,5
SEA201207140,2012,120714,SEA,TEX,SEA03,0,7,7
SEA201207150,2012,120715,SEA,TEX,SEA03,4,0,4
SEA201207230,2012,120723,SEA,NYA,SEA03,4,1,5
SEA201207240,2012,120724,SEA,NYA,SEA03,2,4,6
SEA201207250,2012,120725,SEA,NYA,SEA03,5,2,7
SEA201207260,2012,120726,SEA,KCA,SEA03,1,4,5
SEA201207270,2012,120727,SEA,KCA,SEA03,1,6,7
SEA201207280,2012,120728,SEA,KCA,SEA03,3,4,7
SEA201207290,2012,120729,SEA,KCA,SEA03,6,7,13
SEA201207300,2012,120730,SEA,TOR,SEA03,1,4,5
SEA201207310,2012,120731,SEA,TOR,SEA03,2,7,9
SEA201208010,2012,120801,SEA,TOR,SEA03,3,5,8
SEA201208130,2012,120813,SEA,TBA,SEA03,4,1,5
SEA201208140,2012,120814,SEA,TBA,SEA03,2,3,5
SEA201208150,2012,120815,SEA,TBA,SEA03,0,1,1
SEA201208170,2012,120817,SEA,MIN,SEA03,3,5,8
SEA201208180,2012,120818,SEA,MIN,SEA03,2,3,5
SEA201208190,2012,120819,SEA,MIN,SEA03,1,5,6
SEA201208200,2012,120820,SEA,CLE,SEA03,3,5,8
SEA201208210,2012,120821,SEA,CLE,SEA03,1,5,6
SEA201208220,2012,120822,SEA,CLE,SEA03,1,3,4
SEA201208310,2012,120831,SEA,ANA,SEA03,9,1,10
SEA201209010,2012,120901,SEA,ANA,SEA03,5,2,7
SEA201209020,2012,120902,SEA,ANA,SEA03,1,2,3
SEA201209030,2012,120903,SEA,BOS,SEA03,1,4,5
SEA201209040,2012,120904,SEA,BOS,SEA03,4,3,7
SEA201209050,2012,120905,SEA,BOS,SEA03,1,2,3
SEA201209070,2012,120907,SEA,OAK,SEA03,6,1,7
SEA201209080,2012,120908,SEA,OAK,SEA03,6,1,7
SEA201209090,2012,120909,SEA,OAK,SEA03,4,2,6
SEA201209170,2012,120917,SEA,BAL,SEA03,10,4,14
SEA201209180,2012,120918,SEA,BAL,SEA03,4,2,6
SEA201209190,2012,120919,SEA,BAL,SEA03,3,1,4
SEA201209210,2012,120921,SEA,TEX,SEA03,3,6,9
SEA201209220,2012,120922,SEA,TEX,SEA03,0,1,1
SEA201209230,2012,120923,SEA,TEX,SEA03,3,2,5
SEA201210010,2012,121001,SEA,ANA,SEA03,8,4,12
SEA201210020,2012,121002,SEA,ANA,SEA03,1,6,7
SEA201210030,2012,121003,SEA,ANA,SEA03,0,12,12
SEA201304080,2013,20130408,SEA,HOU,SEA03,0,3,3
SEA201304090,2013,20130409,SEA,HOU,SEA03,16,9,25
SEA201304100,2013,20130410,SEA,HOU,SEA03,8,3,11
SEA201304110,2013,20130411,SEA,TEX,SEA03,4,3,7
SEA201304120,2013,20130412,SEA,TEX,SEA03,1,3,4
SEA201304130,2013,20130413,SEA,TEX,SEA03,3,1,4
SEA201304140,2013,20130414,SEA,TEX,SEA03,3,4,7
SEA201304160,2013,20130416,SEA,DET,SEA03,6,2,8
SEA201304170,2013,20130417,SEA,DET,SEA03,2,1,3
SEA201304180,2013,20130418,SEA,DET,SEA03,0,2,2
SEA201304250,2013,20130425,SEA,ANA,SEA03,0,6,6
SEA201304260,2013,20130426,SEA,ANA,SEA03,6,3,9
SEA201304270,2013,20130427,SEA,ANA,SEA03,2,3,5
SEA201304280,2013,20130428,SEA,ANA,SEA03,1,2,3
SEA201304290,2013,20130429,SEA,BAL,SEA03,2,6,8
SEA201304300,2013,20130430,SEA,BAL,SEA03,7,2,9
SEA201305010,2013,20130501,SEA,BAL,SEA03,3,8,11
SEA201305100,2013,20130510,SEA,OAK,SEA03,3,6,9
SEA201305110,2013,20130511,SEA,OAK,SEA03,4,3,7
SEA201305120,2013,20130512,SEA,OAK,SEA03,1,6,7
SEA201305240,2013,20130524,SEA,TEX,SEA03,9,5,14
SEA201305250,2013,20130525,SEA,TEX,SEA03,5,2,7
SEA201305260,2013,20130526,SEA,TEX,SEA03,3,4,7
SEA201305270,2013,20130527,SEA,SDN,SEA03,0,9,9
SEA201305280,2013,20130528,SEA,SDN,SEA03,6,1,7
SEA201306030,2013,20130603,SEA,CHA,SEA03,2,4,6
SEA201306040,2013,20130604,SEA,CHA,SEA03,4,7,11
SEA201306050,2013,20130605,SEA,CHA,SEA03,7,5,12
SEA201306060,2013,20130606,SEA,NYA,SEA03,6,1,7
SEA201306070,2013,20130607,SEA,NYA,SEA03,1,4,5
SEA201306080,2013,20130608,SEA,NYA,SEA03,3,1,4
SEA201306090,2013,20130609,SEA,NYA,SEA03,2,1,3
SEA201306100,2013,20130610,SEA,HOU,SEA03,2,3,5
SEA201306110,2013,20130611,SEA,HOU,SEA03,0,4,4
SEA201306120,2013,20130612,SEA,HOU,SEA03,6,1,7
SEA201306210,2013,20130621,SEA,OAK,SEA03,6,3,9
SEA201306220,2013,20130622,SEA,OAK,SEA03,5,7,12
SEA201306230,2013,20130623,SEA,OAK,SEA03,3,6,9
SEA201306250,2013,20130625,SEA,PIT,SEA03,9,4,13
SEA201306260,2013,20130626,SEA,PIT,SEA03,4,2,6
SEA201306280,2013,20130628,SEA,CHN,SEA03,4,5,9
SEA201306290,2013,20130629,SEA,CHN,SEA03,5,3,8
SEA201306300,2013,20130630,SEA,CHN,SEA03,7,6,13
SEA201307080,2013,20130708,SEA,BOS,SEA03,4,11,15
SEA201307090,2013,20130709,SEA,BOS,SEA03,11,8,19
SEA201307100,2013,20130710,SEA,BOS,SEA03,11,4,15
SEA201307110,2013,20130711,SEA,BOS,SEA03,8,7,15
SEA201307120,2013,20130712,SEA,ANA,SEA03,3,8,11
SEA201307130,2013,20130713,SEA,ANA,SEA03,0,6,6
SEA201307140,2013,20130714,SEA,ANA,SEA03,3,4,7
SEA201307220,2013,20130722,SEA,CLE,SEA03,1,2,3
SEA201307230,2013,20130723,SEA,CLE,SEA03,3,4,7
SEA201307240,2013,20130724,SEA,CLE,SEA03,10,1,11
SEA201307250,2013,20130725,SEA,MIN,SEA03,2,8,10
SEA201307260,2013,20130726,SEA,MIN,SEA03,3,2,5
SEA201307270,2013,20130727,SEA,MIN,SEA03,4,0,4
SEA201307280,2013,20130728,SEA,MIN,SEA03,4,6,10
SEA201308050,2013,20130805,SEA,TOR,SEA03,3,1,4
SEA201308060,2013,20130806,SEA,TOR,SEA03,7,2,9
SEA201308070,2013,20130807,SEA,TOR,SEA03,7,9,16
SEA201308090,2013,20130809,SEA,MIL,SEA03,10,5,15
SEA201308100,2013,20130810,SEA,MIL,SEA03,10,0,10
SEA201308110,2013,20130811,SEA,MIL,SEA03,0,2,2
SEA201308230,2013,20130823,SEA,ANA,SEA03,2,0,2
SEA201308240,2013,20130824,SEA,ANA,SEA03,5,1,6
SEA201308250,2013,20130825,SEA,ANA,SEA03,7,1,8
SEA201308260,2013,20130826,SEA,TEX,SEA03,8,3,11
SEA201308270,2013,20130827,SEA,TEX,SEA03,4,3,7
SEA201308280,2013,20130828,SEA,TEX,SEA03,12,4,16
SEA201309060,2013,20130906,SEA,TBA,SEA03,4,6,10
SEA201309070,2013,20130907,SEA,TBA,SEA03,2,6,8
SEA201309080,2013,20130908,SEA,TBA,SEA03,4,1,5
SEA201309090,2013,20130909,SEA,HOU,SEA03,6,4,10
SEA201309100,2013,20130910,SEA,HOU,SEA03,13,2,15
SEA201309110,2013,20130911,SEA,HOU,SEA03,6,1,7
SEA201309230,2013,20130923,SEA,KCA,SEA03,6,5,11
SEA201309240,2013,20130924,SEA,KCA,SEA03,0,4,4
SEA201309250,2013,20130925,SEA,KCA,SEA03,0,6,6
SEA201309270,2013,20130927,SEA,OAK,SEA03,8,2,10
SEA201309280,2013,20130928,SEA,OAK,SEA03,5,7,12
SEA201309290,2013,20130929,SEA,OAK,SEA03,9,0,9
SFN201004090,2010,100409,SFN,ATL,SFO03,4,5,9
SFN201004100,2010,100410,SFN,ATL,SFO03,7,2,9
SFN201004110,2010,100411,SFN,ATL,SFO03,3,6,9
SFN201004120,2010,100412,SFN,PIT,SFO03,3,9,12
SFN201004130,2010,100413,SFN,PIT,SFO03,6,5,11
SFN201004140,2010,100414,SFN,PIT,SFO03,0,6,6
SFN201004230,2010,100423,SFN,SLN,SFO03,1,4,5
SFN201004240,2010,100424,SFN,SLN,SFO03,0,2,2
SFN201004250,2010,100425,SFN,SLN,SFO03,2,0,2
SFN201004260,2010,100426,SFN,PHI,SFO03,1,5,6
SFN201004270,2010,100427,SFN,PHI,SFO03,2,6,8
SFN201004280,2010,100428,SFN,PHI,SFO03,7,6,13
SFN201004300,2010,100430,SFN,COL,SFO03,2,5,7
SFN201005010,2010,100501,SFN,COL,SFO03,1,6,7
SFN201005020,2010,100502,SFN,COL,SFO03,4,1,5
SFN201005110,2010,100511,SFN,SDN,SFO03,3,2,5
SFN201005120,2010,100512,SFN,SDN,SFO03,5,2,7
SFN201005130,2010,100513,SFN,SDN,SFO03,1,0,1
SFN201005140,2010,100514,SFN,HOU,SFO03,2,8,10
SFN201005150,2010,100515,SFN,HOU,SFO03,1,2,3
SFN201005160,2010,100516,SFN,HOU,SFO03,3,4,7
SFN201005250,2010,100525,SFN,WAS,SFO03,2,4,6
SFN201005260,2010,100526,SFN,WAS,SFO03,7,3,10
SFN201005270,2010,100527,SFN,WAS,SFO03,4,5,9
SFN201005280,2010,100528,SFN,ARI,SFO03,0,5,5
SFN201005290,2010,100529,SFN,ARI,SFO03,1,12,13
SFN201005300,2010,100530,SFN,ARI,SFO03,5,6,11
SFN201005310,2010,100531,SFN,COL,SFO03,4,0,4
SFN201006010,2010,100601,SFN,COL,SFO03,2,1,3
SFN201006020,2010,100602,SFN,COL,SFO03,1,4,5
SFN201006110,2010,100611,SFN,OAK,SFO03,2,6,8
SFN201006120,2010,100612,SFN,OAK,SFO03,4,5,9
SFN201006130,2010,100613,SFN,OAK,SFO03,2,6,8
SFN201006140,2010,100614,SFN,BAL,SFO03,2,10,12
SFN201006150,2010,100615,SFN,BAL,SFO03,4,1,5
SFN201006160,2010,100616,SFN,BAL,SFO03,3,6,9
SFN201006250,2010,100625,SFN,BOS,SFO03,4,5,9
SFN201006260,2010,100626,SFN,BOS,SFO03,4,2,6
SFN201006270,2010,100627,SFN,BOS,SFO03,5,1,6
SFN201006280,2010,100628,SFN,LAN,SFO03,4,2,6
SFN201006290,2010,100629,SFN,LAN,SFO03,4,2,6
SFN201006300,2010,100630,SFN,LAN,SFO03,8,2,10
SFN201007150,2010,100715,SFN,NYN,SFO03,0,2,2
SFN201007160,2010,100716,SFN,NYN,SFO03,0,1,1
SFN201007170,2010,100717,SFN,NYN,SFO03,4,8,12
SFN201007180,2010,100718,SFN,NYN,SFO03,4,3,7
SFN201007260,2010,100726,SFN,FLO,SFO03,4,3,7
SFN201007270,2010,100727,SFN,FLO,SFO03,4,6,10
SFN201007280,2010,100728,SFN,FLO,SFO03,9,10,19
SFN201007290,2010,100729,SFN,FLO,SFO03,5,0,5
SFN201007300,2010,100730,SFN,LAN,SFO03,5,6,11
SFN201007310,2010,100731,SFN,LAN,SFO03,1,2,3
SFN201008010,2010,100801,SFN,LAN,SFO03,0,2,2
SFN201008090,2010,100809,SFN,CHN,SFO03,3,4,7
SFN201008100,2010,100810,SFN,CHN,SFO03,8,6,14
SFN201008110,2010,100811,SFN,CHN,SFO03,4,5,9
SFN201008120,2010,100812,SFN,CHN,SFO03,7,8,15
SFN201008130,2010,100813,SFN,SDN,SFO03,3,2,5
SFN201008140,2010,100814,SFN,SDN,SFO03,2,3,5
SFN201008150,2010,100815,SFN,SDN,SFO03,8,2,10
SFN201008230,2010,100823,SFN,CIN,SFO03,2,11,13
SFN201008240,2010,100824,SFN,CIN,SFO03,5,16,21
SFN201008250,2010,100825,SFN,CIN,SFO03,12,11,23
SFN201008270,2010,100827,SFN,ARI,SFO03,6,0,6
SFN201008280,2010,100828,SFN,ARI,SFO03,11,3,14
SFN201008290,2010,100829,SFN,ARI,SFO03,7,9,16
SFN201008300,2010,100830,SFN,COL,SFO03,2,1,3
SFN201008310,2010,100831,SFN,COL,SFO03,2,5,7
SFN201009010,2010,100901,SFN,COL,SFO03,1,2,3
SFN201009140,2010,100914,SFN,LAN,SFO03,1,0,1
SFN201009150,2010,100915,SFN,LAN,SFO03,1,2,3
SFN201009160,2010,100916,SFN,LAN,SFO03,2,10,12
SFN201009170,2010,100917,SFN,MIL,SFO03,3,0,3
SFN201009180,2010,100918,SFN,MIL,SFO03,2,1,3
SFN201009190,2010,100919,SFN,MIL,SFO03,2,9,11
SFN201009280,2010,100928,SFN,ARI,SFO03,2,4,6
SFN201009290,2010,100929,SFN,ARI,SFO03,1,3,4
SFN201009300,2010,100930,SFN,ARI,SFO03,1,4,5
SFN201010010,2010,101001,SFN,SDN,SFO03,6,4,10
SFN201010020,2010,101002,SFN,SDN,SFO03,4,2,6
SFN201010030,2010,101003,SFN,SDN,SFO03,0,3,3
SFN201010070,2010,101007,SFN,ATL,SFO03,0,1,1
SFN201010080,2010,101008,SFN,ATL,SFO03,5,4,9
SFN201010190,2010,101019,SFN,PHI,SFO03,0,3,3
SFN201010200,2010,101020,SFN,PHI,SFO03,5,6,11
SFN201010210,2010,101021,SFN,PHI,SFO03,4,2,6
SFN201010270,2010,101027,SFN,TEX,SFO03,7,11,18
SFN201010280,2010,101028,SFN,TEX,SFO03,0,9,9
SFN201104080,2011,20110408,SFN,SLN,SFO03,4,5,9
SFN201104090,2011,20110409,SFN,SLN,SFO03,2,3,5
SFN201104100,2011,20110410,SFN,SLN,SFO03,6,1,7
SFN201104110,2011,20110411,SFN,LAN,SFO03,6,1,7
SFN201104120,2011,20110412,SFN,LAN,SFO03,4,5,9
SFN201104130,2011,20110413,SFN,LAN,SFO03,3,4,7
SFN201104220,2011,20110422,SFN,ATL,SFO03,4,1,5
SFN201104230,2011,20110423,SFN,ATL,SFO03,5,2,7
SFN201104240,2011,20110424,SFN,ATL,SFO03,9,6,15
SFN201105060,2011,20110506,SFN,COL,SFO03,3,4,7
SFN201105070,2011,20110507,SFN,COL,SFO03,2,3,5
SFN201105080,2011,20110508,SFN,COL,SFO03,0,3,3
SFN201105100,2011,20110510,SFN,ARI,SFO03,0,1,1
SFN201105110,2011,20110511,SFN,ARI,SFO03,3,4,7
SFN201105120,2011,20110512,SFN,ARI,SFO03,2,3,5
SFN201105200,2011,20110520,SFN,OAK,SFO03,1,2,3
SFN201105210,2011,20110521,SFN,OAK,SFO03,0,3,3
SFN201105220,2011,20110522,SFN,OAK,SFO03,4,5,9
SFN201105240,2011,20110524,SFN,FLO,SFO03,5,1,6
SFN201105250,2011,20110525,SFN,FLO,SFO03,7,6,13
SFN201105260,2011,20110526,SFN,FLO,SFO03,1,0,1
SFN201106030,2011,20110603,SFN,COL,SFO03,1,3,4
SFN201106040,2011,20110604,SFN,COL,SFO03,2,1,3
SFN201106050,2011,20110605,SFN,COL,SFO03,1,2,3
SFN201106060,2011,20110606,SFN,WAS,SFO03,4,5,9
SFN201106070,2011,20110607,SFN,WAS,SFO03,2,1,3
SFN201106080,2011,20110608,SFN,WAS,SFO03,1,3,4
SFN201106090,2011,20110609,SFN,CIN,SFO03,3,0,3
SFN201106100,2011,20110610,SFN,CIN,SFO03,2,3,5
SFN201106110,2011,20110611,SFN,CIN,SFO03,10,2,12
SFN201106120,2011,20110612,SFN,CIN,SFO03,2,4,6
SFN201106210,2011,20110621,SFN,MIN,SFO03,9,2,11
SFN201106220,2011,20110622,SFN,MIN,SFO03,1,5,6
SFN201106230,2011,20110623,SFN,MIN,SFO03,1,2,3
SFN201106240,2011,20110624,SFN,CLE,SFO03,3,4,7
SFN201106250,2011,20110625,SFN,CLE,SFO03,0,1,1
SFN201106260,2011,20110626,SFN,CLE,SFO03,1,3,4
SFN201107040,2011,20110704,SFN,SDN,SFO03,5,3,8
SFN201107050,2011,20110705,SFN,SDN,SFO03,5,3,8
SFN201107060,2011,20110706,SFN,SDN,SFO03,5,6,11
SFN201107070,2011,20110707,SFN,SDN,SFO03,1,2,3
SFN201107080,2011,20110708,SFN,NYN,SFO03,5,2,7
SFN201107090,2011,20110709,SFN,NYN,SFO03,1,3,4
SFN201107100,2011,20110710,SFN,NYN,SFO03,2,4,6
SFN201107180,2011,20110718,SFN,LAN,SFO03,0,5,5
SFN201107190,2011,20110719,SFN,LAN,SFO03,3,5,8
SFN201107200,2011,20110720,SFN,LAN,SFO03,1,0,1
SFN201107220,2011,20110722,SFN,MIL,SFO03,4,2,6
SFN201107230,2011,20110723,SFN,MIL,SFO03,2,4,6
SFN201107240,2011,20110724,SFN,MIL,SFO03,1,2,3
SFN201108010,2011,20110801,SFN,ARI,SFO03,5,2,7
SFN201108020,2011,20110802,SFN,ARI,SFO03,6,1,7
SFN201108030,2011,20110803,SFN,ARI,SFO03,1,8,9
SFN201108040,2011,20110804,SFN,PHI,SFO03,3,0,3
SFN201108050,2011,20110805,SFN,PHI,SFO03,9,2,11
SFN201108060,2011,20110806,SFN,PHI,SFO03,2,1,3
SFN201108070,2011,20110807,SFN,PHI,SFO03,1,3,4
SFN201108080,2011,20110808,SFN,PIT,SFO03,5,0,5
SFN201108090,2011,20110809,SFN,PIT,SFO03,0,6,6
SFN201108100,2011,20110810,SFN,PIT,SFO03,9,2,11
SFN201108230,2011,20110823,SFN,SDN,SFO03,7,5,12
SFN201108240,2011,20110824,SFN,SDN,SFO03,1,2,3
SFN201108250,2011,20110825,SFN,HOU,SFO03,3,1,4
SFN201108260,2011,20110826,SFN,HOU,SFO03,1,2,3
SFN201108270,2011,20110827,SFN,HOU,SFO03,1,2,3
SFN201108280,2011,20110828,SFN,HOU,SFO03,4,3,7
SFN201108290,2011,20110829,SFN,CHN,SFO03,7,0,7
SFN201108300,2011,20110830,SFN,CHN,SFO03,5,2,7
SFN201108310,2011,20110831,SFN,CHN,SFO03,0,4,4
SFN201109020,2011,20110902,SFN,ARI,SFO03,2,6,8
SFN201109030,2011,20110903,SFN,ARI,SFO03,7,2,9
SFN201109040,2011,20110904,SFN,ARI,SFO03,4,1,5
SFN201109090,2011,20110909,SFN,LAN,SFO03,2,1,3
SFN201109100,2011,20110910,SFN,LAN,SFO03,3,0,3
SFN201109110,2011,20110911,SFN,LAN,SFO03,1,8,9
SFN201109120,2011,20110912,SFN,SDN,SFO03,3,8,11
SFN201109130,2011,20110913,SFN,SDN,SFO03,2,3,5
SFN201109140,2011,20110914,SFN,SDN,SFO03,1,3,4
SFN201109260,2011,20110926,SFN,COL,SFO03,1,3,4
SFN201109270,2011,20110927,SFN,COL,SFO03,0,7,7
SFN201109280,2011,20110928,SFN,COL,SFO03,6,3,9
SFN201204130,2012,120413,SFN,PIT,SFO03,0,5,5
SFN201204140,2012,120414,SFN,PIT,SFO03,3,4,7
SFN201204150,2012,120415,SFN,PIT,SFO03,4,1,5
SFN201204160,2012,120416,SFN,PHI,SFO03,5,2,7
SFN201204170,2012,120417,SFN,PHI,SFO03,2,4,6
SFN201204180,2012,120418,SFN,PHI,SFO03,0,1,1
SFN201204270,2012,120427,SFN,SDN,SFO03,5,3,8
SFN201204280,2012,120428,SFN,SDN,SFO03,1,2,3
SFN201204290,2012,120429,SFN,SDN,SFO03,1,4,5
SFN201205010,2012,120501,SFN,MIA,SFO03,2,1,3
SFN201205020,2012,120502,SFN,MIA,SFO03,3,2,5
SFN201205030,2012,120503,SFN,MIA,SFO03,3,2,5
SFN201205040,2012,120504,SFN,MIL,SFO03,6,4,10
SFN201205050,2012,120505,SFN,MIL,SFO03,2,5,7
SFN201205060,2012,120506,SFN,MIL,SFO03,3,4,7
SFN201205140,2012,120514,SFN,COL,SFO03,2,3,5
SFN201205150,2012,120515,SFN,COL,SFO03,5,4,9
SFN201205160,2012,120516,SFN,SLN,SFO03,4,1,5
SFN201205170,2012,120517,SFN,SLN,SFO03,5,7,12
SFN201205180,2012,120518,SFN,OAK,SFO03,6,8,14
SFN201205190,2012,120519,SFN,OAK,SFO03,0,4,4
SFN201205200,2012,120520,SFN,OAK,SFO03,6,2,8
SFN201205280,2012,120528,SFN,ARI,SFO03,2,4,6
SFN201205290,2012,120529,SFN,ARI,SFO03,1,3,4
SFN201205300,2012,120530,SFN,ARI,SFO03,4,1,5
SFN201206010,2012,120601,SFN,CHN,SFO03,3,4,7
SFN201206020,2012,120602,SFN,CHN,SFO03,1,2,3
SFN201206030,2012,120603,SFN,CHN,SFO03,0,2,2
SFN201206040,2012,120604,SFN,CHN,SFO03,2,3,5
SFN201206080,2012,120608,SFN,TEX,SFO03,5,0,5
SFN201206090,2012,120609,SFN,TEX,SFO03,2,5,7
SFN201206100,2012,120610,SFN,TEX,SFO03,5,0,5
SFN201206120,2012,120612,SFN,HOU,SFO03,3,6,9
SFN201206130,2012,120613,SFN,HOU,SFO03,0,10,10
SFN201206140,2012,120614,SFN,HOU,SFO03,6,3,9
SFN201206250,2012,120625,SFN,LAN,SFO03,0,8,8
SFN201206260,2012,120626,SFN,LAN,SFO03,0,2,2
SFN201206270,2012,120627,SFN,LAN,SFO03,0,3,3
SFN201206280,2012,120628,SFN,CIN,SFO03,0,5,5
SFN201206290,2012,120629,SFN,CIN,SFO03,5,1,6
SFN201206300,2012,120630,SFN,CIN,SFO03,2,1,3
SFN201207010,2012,120701,SFN,CIN,SFO03,3,4,7
SFN201207130,2012,120713,SFN,HOU,SFO03,1,5,6
SFN201207140,2012,120714,SFN,HOU,SFO03,2,3,5
SFN201207150,2012,120715,SFN,HOU,SFO03,2,3,5
SFN201207230,2012,120723,SFN,SDN,SFO03,1,7,8
SFN201207240,2012,120724,SFN,SDN,SFO03,2,3,5
SFN201207250,2012,120725,SFN,SDN,SFO03,6,3,9
SFN201207270,2012,120727,SFN,LAN,SFO03,5,3,8
SFN201207280,2012,120728,SFN,LAN,SFO03,10,0,10
SFN201207290,2012,120729,SFN,LAN,SFO03,4,0,4
SFN201207300,2012,120730,SFN,NYN,SFO03,8,7,15
SFN201207310,2012,120731,SFN,NYN,SFO03,1,4,5
SFN201208010,2012,120801,SFN,NYN,SFO03,2,1,3
SFN201208020,2012,120802,SFN,NYN,SFO03,9,1,10
SFN201208100,2012,120810,SFN,COL,SFO03,3,0,3
SFN201208110,2012,120811,SFN,COL,SFO03,3,9,12
SFN201208120,2012,120812,SFN,COL,SFO03,6,9,15
SFN201208130,2012,120813,SFN,WAS,SFO03,14,2,16
SFN201208140,2012,120814,SFN,WAS,SFO03,1,6,7
SFN201208150,2012,120815,SFN,WAS,SFO03,6,4,10
SFN201208230,2012,120823,SFN,ATL,SFO03,2,5,7
SFN201208240,2012,120824,SFN,ATL,SFO03,3,5,8
SFN201208250,2012,120825,SFN,ATL,SFO03,7,3,10
SFN201208260,2012,120826,SFN,ATL,SFO03,7,1,8
SFN201209030,2012,120903,SFN,ARI,SFO03,8,9,17
SFN201209040,2012,120904,SFN,ARI,SFO03,8,6,14
SFN201209050,2012,120905,SFN,ARI,SFO03,6,2,8
SFN201209070,2012,120907,SFN,LAN,SFO03,2,5,7
SFN201209080,2012,120908,SFN,LAN,SFO03,3,2,5
SFN201209090,2012,120909,SFN,LAN,SFO03,0,4,4
SFN201209170,2012,120917,SFN,COL,SFO03,1,2,3
SFN201209180,2012,120918,SFN,COL,SFO03,3,6,9
SFN201209190,2012,120919,SFN,COL,SFO03,1,7,8
SFN201209200,2012,120920,SFN,COL,SFO03,2,9,11
SFN201209210,2012,120921,SFN,SDN,SFO03,1,5,6
SFN201209220,2012,120922,SFN,SDN,SFO03,4,8,12
SFN201209230,2012,120923,SFN,SDN,SFO03,6,4,10
SFN201209250,2012,120925,SFN,ARI,SFO03,7,2,9
SFN201209260,2012,120926,SFN,ARI,SFO03,0,6,6
SFN201209270,2012,120927,SFN,ARI,SFO03,3,7,10
SFN201210060,2012,121006,SFN,CIN,SFO03,5,2,7
SFN201210070,2012,121007,SFN,CIN,SFO03,9,0,9
SFN201210140,2012,121014,SFN,SLN,SFO03,6,4,10
SFN201210150,2012,121015,SFN,SLN,SFO03,1,7,8
SFN201210210,2012,121021,SFN,SLN,SFO03,1,6,7
SFN201210220,2012,121022,SFN,SLN,SFO03,0,9,9
SFN201210240,2012,121024,SFN,DET,SFO03,3,8,11
SFN201210250,2012,121025,SFN,DET,SFO03,0,2,2
SFN201304050,2013,20130405,SFN,SLN,SFO03,0,1,1
SFN201304060,2013,20130406,SFN,SLN,SFO03,6,3,9
SFN201304070,2013,20130407,SFN,SLN,SFO03,14,3,17
SFN201304080,2013,20130408,SFN,COL,SFO03,2,4,6
SFN201304090,2013,20130409,SFN,COL,SFO03,6,9,15
SFN201304100,2013,20130410,SFN,COL,SFO03,0,10,10
SFN201304190,2013,20130419,SFN,SDN,SFO03,2,3,5
SFN201304200,2013,20130420,SFN,SDN,SFO03,0,2,2
SFN201304210,2013,20130421,SFN,SDN,SFO03,0,5,5
SFN201304220,2013,20130422,SFN,ARI,SFO03,4,5,9
SFN201304230,2013,20130423,SFN,ARI,SFO03,6,4,10
SFN201304240,2013,20130424,SFN,ARI,SFO03,3,2,5
SFN201305030,2013,20130503,SFN,LAN,SFO03,1,2,3
SFN201305040,2013,20130504,SFN,LAN,SFO03,9,10,19
SFN201305050,2013,20130505,SFN,LAN,SFO03,3,4,7
SFN201305060,2013,20130506,SFN,PHI,SFO03,6,2,8
SFN201305070,2013,20130507,SFN,PHI,SFO03,6,2,8
SFN201305080,2013,20130508,SFN,PHI,SFO03,3,4,7
SFN201305090,2013,20130509,SFN,ATL,SFO03,6,3,9
SFN201305100,2013,20130510,SFN,ATL,SFO03,2,8,10
SFN201305110,2013,20130511,SFN,ATL,SFO03,1,10,11
SFN201305120,2013,20130512,SFN,ATL,SFO03,1,5,6
SFN201305200,2013,20130520,SFN,WAS,SFO03,0,8,8
SFN201305210,2013,20130521,SFN,WAS,SFO03,2,4,6
SFN201305220,2013,20130522,SFN,WAS,SFO03,2,1,3
SFN201305240,2013,20130524,SFN,COL,SFO03,5,0,5
SFN201305250,2013,20130525,SFN,COL,SFO03,5,6,11
SFN201305260,2013,20130526,SFN,COL,SFO03,3,7,10
SFN201305290,2013,20130529,SFN,OAK,SFO03,9,6,15
SFN201305300,2013,20130530,SFN,OAK,SFO03,2,5,7
SFN201306040,2013,20130604,SFN,TOR,SFO03,1,2,3
SFN201306050,2013,20130605,SFN,TOR,SFO03,4,0,4
SFN201306170,2013,20130617,SFN,SDN,SFO03,5,3,8
SFN201306180,2013,20130618,SFN,SDN,SFO03,4,5,9
SFN201306190,2013,20130619,SFN,SDN,SFO03,2,4,6
SFN201306200,2013,20130620,SFN,MIA,SFO03,2,1,3
SFN201306210,2013,20130621,SFN,MIA,SFO03,6,3,9
SFN201306220,2013,20130622,SFN,MIA,SFO03,1,2,3
SFN201306230,2013,20130623,SFN,MIA,SFO03,7,2,9
SFN201307050,2013,20130705,SFN,LAN,SFO03,10,2,12
SFN201307060,2013,20130706,SFN,LAN,SFO03,2,4,6
SFN201307070,2013,20130707,SFN,LAN,SFO03,4,1,5
SFN201307080,2013,20130708,SFN,NYN,SFO03,4,3,7
SFN201307090,2013,20130709,SFN,NYN,SFO03,10,6,16
SFN201307100,2013,20130710,SFN,NYN,SFO03,7,2,9
SFN201307190,2013,20130719,SFN,ARI,SFO03,0,2,2
SFN201307200,2013,20130720,SFN,ARI,SFO03,3,4,7
SFN201307210,2013,20130721,SFN,ARI,SFO03,3,1,4
SFN201307220,2013,20130722,SFN,CIN,SFO03,11,0,11
SFN201307231,2013,20130723,SFN,CIN,SFO03,9,3,12
SFN201307240,2013,20130724,SFN,CIN,SFO03,8,3,11
SFN201307260,2013,20130726,SFN,CHN,SFO03,3,2,5
SFN201307270,2013,20130727,SFN,CHN,SFO03,1,0,1
SFN201307280,2013,20130728,SFN,CHN,SFO03,2,1,3
SFN201308050,2013,20130805,SFN,MIL,SFO03,2,4,6
SFN201308060,2013,20130806,SFN,MIL,SFO03,3,1,4
SFN201308070,2013,20130807,SFN,MIL,SFO03,6,1,7
SFN201308080,2013,20130808,SFN,MIL,SFO03,1,4,5
SFN201308090,2013,20130809,SFN,BAL,SFO03,5,2,7
SFN201308100,2013,20130810,SFN,BAL,SFO03,2,3,5
SFN201308110,2013,20130811,SFN,BAL,SFO03,10,2,12
SFN201308190,2013,20130819,SFN,BOS,SFO03,7,0,7
SFN201308200,2013,20130820,SFN,BOS,SFO03,2,3,5
SFN201308210,2013,20130821,SFN,BOS,SFO03,12,1,13
SFN201308220,2013,20130822,SFN,PIT,SFO03,10,5,15
SFN201308230,2013,20130823,SFN,PIT,SFO03,3,1,4
SFN201308240,2013,20130824,SFN,PIT,SFO03,3,6,9
SFN201308250,2013,20130825,SFN,PIT,SFO03,0,4,4
SFN201309050,2013,20130905,SFN,ARI,SFO03,4,2,6
SFN201309060,2013,20130906,SFN,ARI,SFO03,0,3,3
SFN201309070,2013,20130907,SFN,ARI,SFO03,2,1,3
SFN201309080,2013,20130908,SFN,ARI,SFO03,2,3,5
SFN201309090,2013,20130909,SFN,COL,SFO03,2,3,5
SFN201309100,2013,20130910,SFN,COL,SFO03,9,8,17
SFN201309110,2013,20130911,SFN,COL,SFO03,3,4,7
SFN201309240,2013,20130924,SFN,LAN,SFO03,2,1,3
SFN201309250,2013,20130925,SFN,LAN,SFO03,4,6,10
SFN201309260,2013,20130926,SFN,LAN,SFO03,2,3,5
SFN201309270,2013,20130927,SFN,SDN,SFO03,3,7,10
SFN201309280,2013,20130928,SFN,SDN,SFO03,9,3,12
SFN201309290,2013,20130929,SFN,SDN,SFO03,6,7,13
SLN201004120,2010,100412,SLN,HOU,STL10,0,5,5
SLN201004140,2010,100414,SLN,HOU,STL10,1,2,3
SLN201004150,2010,100415,SLN,HOU,STL10,5,1,6
SLN201004160,2010,100416,SLN,NYN,STL10,3,4,7
SLN201004170,2010,100417,SLN,NYN,STL10,2,1,3
SLN201004180,2010,100418,SLN,NYN,STL10,3,5,8
SLN201004260,2010,100426,SLN,ATL,STL10,3,4,7
SLN201004270,2010,100427,SLN,ATL,STL10,4,5,9
SLN201004280,2010,100428,SLN,ATL,STL10,0,6,6
SLN201004290,2010,100429,SLN,ATL,STL10,4,10,14
SLN201004300,2010,100430,SLN,CIN,STL10,3,2,5
SLN201005010,2010,100501,SLN,CIN,STL10,3,6,9
SLN201005020,2010,100502,SLN,CIN,STL10,0,6,6
SLN201005110,2010,100511,SLN,HOU,STL10,6,3,9
SLN201005120,2010,100512,SLN,HOU,STL10,9,6,15
SLN201005130,2010,100513,SLN,HOU,STL10,4,1,5
SLN201005170,2010,100517,SLN,WAS,STL10,2,6,8
SLN201005180,2010,100518,SLN,WAS,STL10,2,3,5
SLN201005190,2010,100519,SLN,FLO,STL10,5,1,6
SLN201005200,2010,100520,SLN,FLO,STL10,2,4,6
SLN201005210,2010,100521,SLN,ANA,STL10,5,9,14
SLN201005220,2010,100522,SLN,ANA,STL10,10,7,17
SLN201005230,2010,100523,SLN,ANA,STL10,5,6,11
SLN201005310,2010,100531,SLN,CIN,STL10,4,12,16
SLN201006010,2010,100601,SLN,CIN,STL10,9,8,17
SLN201006020,2010,100602,SLN,CIN,STL10,1,4,5
SLN201006040,2010,100604,SLN,MIL,STL10,0,8,8
SLN201006050,2010,100605,SLN,MIL,STL10,4,5,9
SLN201006060,2010,100606,SLN,MIL,STL10,4,3,7
SLN201006140,2010,100614,SLN,SEA,STL10,3,9,12
SLN201006150,2010,100615,SLN,SEA,STL10,2,4,6
SLN201006160,2010,100616,SLN,SEA,STL10,2,1,3
SLN201006180,2010,100618,SLN,OAK,STL10,4,6,10
SLN201006190,2010,100619,SLN,OAK,STL10,3,4,7
SLN201006200,2010,100620,SLN,OAK,STL10,3,2,5
SLN201006280,2010,100628,SLN,ARI,STL10,5,6,11
SLN201006290,2010,100629,SLN,ARI,STL10,0,8,8
SLN201006300,2010,100630,SLN,ARI,STL10,4,2,6
SLN201007010,2010,100701,SLN,MIL,STL10,4,1,5
SLN201007020,2010,100702,SLN,MIL,STL10,0,5,5
SLN201007030,2010,100703,SLN,MIL,STL10,12,5,17
SLN201007040,2010,100704,SLN,MIL,STL10,1,7,8
SLN201007150,2010,100715,SLN,LAN,STL10,1,7,8
SLN201007160,2010,100716,SLN,LAN,STL10,4,8,12
SLN201007170,2010,100717,SLN,LAN,STL10,0,2,2
SLN201007180,2010,100718,SLN,LAN,STL10,4,5,9
SLN201007190,2010,100719,SLN,PHI,STL10,4,8,12
SLN201007200,2010,100720,SLN,PHI,STL10,1,7,8
SLN201007210,2010,100721,SLN,PHI,STL10,1,5,6
SLN201007220,2010,100722,SLN,PHI,STL10,2,0,2
SLN201007300,2010,100730,SLN,PIT,STL10,0,1,1
SLN201007310,2010,100731,SLN,PIT,STL10,1,11,12
SLN201008010,2010,100801,SLN,PIT,STL10,1,9,10
SLN201008020,2010,100802,SLN,HOU,STL10,9,4,13
SLN201008030,2010,100803,SLN,HOU,STL10,18,4,22
SLN201008040,2010,100804,SLN,HOU,STL10,4,8,12
SLN201008130,2010,100813,SLN,CHN,STL10,3,6,9
SLN201008140,2010,100814,SLN,CHN,STL10,3,2,5
SLN201008150,2010,100815,SLN,CHN,STL10,9,7,16
SLN201008170,2010,100817,SLN,MIL,STL10,3,2,5
SLN201008180,2010,100818,SLN,MIL,STL10,3,2,5
SLN201008200,2010,100820,SLN,SFN,STL10,6,3,9
SLN201008210,2010,100821,SLN,SFN,STL10,1,5,6
SLN201008220,2010,100822,SLN,SFN,STL10,0,9,9
SLN201009030,2010,100903,SLN,CIN,STL10,2,3,5
SLN201009040,2010,100904,SLN,CIN,STL10,6,1,7
SLN201009050,2010,100905,SLN,CIN,STL10,2,4,6
SLN201009130,2010,100913,SLN,CHN,STL10,5,1,6
SLN201009140,2010,100914,SLN,CHN,STL10,7,2,9
SLN201009150,2010,100915,SLN,CHN,STL10,7,3,10
SLN201009160,2010,100916,SLN,SDN,STL10,0,4,4
SLN201009170,2010,100917,SLN,SDN,STL10,4,14,18
SLN201009180,2010,100918,SLN,SDN,STL10,8,4,12
SLN201009190,2010,100919,SLN,SDN,STL10,1,4,5
SLN201009270,2010,100927,SLN,PIT,STL10,4,6,10
SLN201009280,2010,100928,SLN,PIT,STL10,7,2,9
SLN201009290,2010,100929,SLN,PIT,STL10,1,4,5
SLN201009300,2010,100930,SLN,COL,STL10,1,6,7
SLN201010010,2010,101001,SLN,COL,STL10,0,3,3
SLN201010020,2010,101002,SLN,COL,STL10,0,1,1
SLN201010030,2010,101003,SLN,COL,STL10,1,6,7
SLN201103310,2011,20110331,SLN,SDN,STL10,5,3,8
SLN201104020,2011,20110402,SLN,SDN,STL10,11,3,14
SLN201104030,2011,20110403,SLN,SDN,STL10,0,2,2
SLN201104040,2011,20110404,SLN,PIT,STL10,4,3,7
SLN201104050,2011,20110405,SLN,PIT,STL10,2,3,5
SLN201104060,2011,20110406,SLN,PIT,STL10,3,1,4
SLN201104201,2011,20110420,SLN,WAS,STL10,8,6,14
SLN201104202,2011,20110420,SLN,WAS,STL10,3,5,8
SLN201104210,2011,20110421,SLN,WAS,STL10,0,5,5
SLN201104220,2011,20110422,SLN,CIN,STL10,2,4,6
SLN201104230,2011,20110423,SLN,CIN,STL10,5,3,8
SLN201104240,2011,20110424,SLN,CIN,STL10,0,3,3
SLN201105020,2011,20110502,SLN,FLO,STL10,6,5,11
SLN201105030,2011,20110503,SLN,FLO,STL10,5,7,12
SLN201105040,2011,20110504,SLN,FLO,STL10,8,7,15
SLN201105050,2011,20110505,SLN,FLO,STL10,3,6,9
SLN201105060,2011,20110506,SLN,MIL,STL10,0,6,6
SLN201105070,2011,20110507,SLN,MIL,STL10,4,0,4
SLN201105080,2011,20110508,SLN,MIL,STL10,1,3,4
SLN201105160,2011,20110516,SLN,PHI,STL10,1,3,4
SLN201105170,2011,20110517,SLN,PHI,STL10,1,2,3
SLN201105180,2011,20110518,SLN,HOU,STL10,1,5,6
SLN201105190,2011,20110519,SLN,HOU,STL10,2,4,6
SLN201105300,2011,20110530,SLN,SFN,STL10,7,3,10
SLN201105310,2011,20110531,SLN,SFN,STL10,3,4,7
SLN201106010,2011,20110601,SLN,SFN,STL10,7,5,12
SLN201106020,2011,20110602,SLN,SFN,STL10,12,7,19
SLN201106030,2011,20110603,SLN,CHN,STL10,1,6,7
SLN201106040,2011,20110604,SLN,CHN,STL10,4,5,9
SLN201106050,2011,20110605,SLN,CHN,STL10,2,3,5
SLN201106170,2011,20110617,SLN,KCA,STL10,5,4,9
SLN201106180,2011,20110618,SLN,KCA,STL10,4,5,9
SLN201106190,2011,20110619,SLN,KCA,STL10,4,5,9
SLN201106210,2011,20110621,SLN,PHI,STL10,10,2,12
SLN201106220,2011,20110622,SLN,PHI,STL10,4,0,4
SLN201106230,2011,20110623,SLN,PHI,STL10,2,12,14
SLN201106240,2011,20110624,SLN,TOR,STL10,5,4,9
SLN201106250,2011,20110625,SLN,TOR,STL10,6,3,9
SLN201106260,2011,20110626,SLN,TOR,STL10,5,0,5
SLN201107040,2011,20110704,SLN,CIN,STL10,0,1,1
SLN201107050,2011,20110705,SLN,CIN,STL10,1,8,9
SLN201107060,2011,20110706,SLN,CIN,STL10,9,8,17
SLN201107070,2011,20110707,SLN,ARI,STL10,4,1,5
SLN201107080,2011,20110708,SLN,ARI,STL10,7,6,13
SLN201107090,2011,20110709,SLN,ARI,STL10,6,7,13
SLN201107100,2011,20110710,SLN,ARI,STL10,2,4,6
SLN201107250,2011,20110725,SLN,HOU,STL10,5,10,15
SLN201107260,2011,20110726,SLN,HOU,STL10,1,3,4
SLN201107270,2011,20110727,SLN,HOU,STL10,4,2,6
SLN201107280,2011,20110728,SLN,HOU,STL10,5,3,8
SLN201107290,2011,20110729,SLN,CHN,STL10,2,9,11
SLN201107300,2011,20110730,SLN,CHN,STL10,5,13,18
SLN201107310,2011,20110731,SLN,CHN,STL10,6,3,9
SLN201108090,2011,20110809,SLN,MIL,STL10,5,3,8
SLN201108100,2011,20110810,SLN,MIL,STL10,5,1,6
SLN201108110,2011,20110811,SLN,MIL,STL10,2,5,7
SLN201108120,2011,20110812,SLN,COL,STL10,1,6,7
SLN201108130,2011,20110813,SLN,COL,STL10,6,1,7
SLN201108140,2011,20110814,SLN,COL,STL10,2,6,8
SLN201108220,2011,20110822,SLN,LAN,STL10,2,1,3
SLN201108230,2011,20110823,SLN,LAN,STL10,13,2,15
SLN201108240,2011,20110824,SLN,LAN,STL10,9,4,13
SLN201108250,2011,20110825,SLN,PIT,STL10,4,8,12
SLN201108260,2011,20110826,SLN,PIT,STL10,4,5,9
SLN201108270,2011,20110827,SLN,PIT,STL10,7,0,7
SLN201108280,2011,20110828,SLN,PIT,STL10,4,7,11
SLN201109020,2011,20110902,SLN,CIN,STL10,11,8,19
SLN201109030,2011,20110903,SLN,CIN,STL10,4,6,10
SLN201109040,2011,20110904,SLN,CIN,STL10,3,2,5
SLN201109050,2011,20110905,SLN,MIL,STL10,4,1,5
SLN201109060,2011,20110906,SLN,MIL,STL10,2,4,6
SLN201109070,2011,20110907,SLN,MIL,STL10,0,2,2
SLN201109090,2011,20110909,SLN,ATL,STL10,3,4,7
SLN201109100,2011,20110910,SLN,ATL,STL10,3,4,7
SLN201109110,2011,20110911,SLN,ATL,STL10,3,6,9
SLN201109200,2011,20110920,SLN,NYN,STL10,6,11,17
SLN201109210,2011,20110921,SLN,NYN,STL10,5,6,11
SLN201109220,2011,20110922,SLN,NYN,STL10,8,6,14
SLN201109230,2011,20110923,SLN,CHN,STL10,5,1,6
SLN201109240,2011,20110924,SLN,CHN,STL10,1,2,3
SLN201109250,2011,20110925,SLN,CHN,STL10,2,3,5
SLN201110040,2011,20111004,SLN,PHI,STL10,3,2,5
SLN201110050,2011,20111005,SLN,PHI,STL10,3,5,8
SLN201110120,2011,20111012,SLN,MIL,STL10,3,4,7
SLN201110130,2011,20111013,SLN,MIL,STL10,4,2,6
SLN201110140,2011,20111014,SLN,MIL,STL10,1,7,8
SLN201110190,2011,20111019,SLN,TEX,STL10,2,3,5
SLN201110200,2011,20111020,SLN,TEX,STL10,2,1,3
SLN201110270,2011,20111027,SLN,TEX,STL10,9,10,19
SLN201110280,2011,20111028,SLN,TEX,STL10,2,6,8
SLN201204130,2012,120413,SLN,CHN,STL10,9,5,14
SLN201204140,2012,120414,SLN,CHN,STL10,1,5,6
SLN201204150,2012,120415,SLN,CHN,STL10,3,10,13
SLN201204170,2012,120417,SLN,CIN,STL10,1,2,3
SLN201204180,2012,120418,SLN,CIN,STL10,1,11,12
SLN201204190,2012,120419,SLN,CIN,STL10,6,3,9
SLN201204270,2012,120427,SLN,MIL,STL10,1,13,14
SLN201204280,2012,120428,SLN,MIL,STL10,3,7,10
SLN201204290,2012,120429,SLN,MIL,STL10,3,2,5
SLN201205010,2012,120501,SLN,PIT,STL10,7,10,17
SLN201205020,2012,120502,SLN,PIT,STL10,3,12,15
SLN201205030,2012,120503,SLN,PIT,STL10,6,3,9
SLN201205110,2012,120511,SLN,ATL,STL10,9,7,16
SLN201205120,2012,120512,SLN,ATL,STL10,7,2,9
SLN201205130,2012,120513,SLN,ATL,STL10,7,4,11
SLN201205140,2012,120514,SLN,CHN,STL10,6,4,10
SLN201205150,2012,120515,SLN,CHN,STL10,6,7,13
SLN201205210,2012,120521,SLN,SDN,STL10,3,4,7
SLN201205220,2012,120522,SLN,SDN,STL10,0,4,4
SLN201205230,2012,120523,SLN,SDN,STL10,3,6,9
SLN201205240,2012,120524,SLN,PHI,STL10,10,9,19
SLN201205250,2012,120525,SLN,PHI,STL10,5,3,8
SLN201205260,2012,120526,SLN,PHI,STL10,4,0,4
SLN201205270,2012,120527,SLN,PHI,STL10,3,8,11
SLN201206080,2012,120608,SLN,CLE,STL10,6,2,8
SLN201206090,2012,120609,SLN,CLE,STL10,0,2,2
SLN201206100,2012,120610,SLN,CLE,STL10,4,1,5
SLN201206120,2012,120612,SLN,CHA,STL10,6,1,7
SLN201206130,2012,120613,SLN,CHA,STL10,0,1,1
SLN201206140,2012,120614,SLN,CHA,STL10,3,5,8
SLN201206150,2012,120615,SLN,KCA,STL10,3,2,5
SLN201206160,2012,120616,SLN,KCA,STL10,7,10,17
SLN201206170,2012,120617,SLN,KCA,STL10,5,3,8
SLN201206290,2012,120629,SLN,PIT,STL10,14,5,19
SLN201206300,2012,120630,SLN,PIT,STL10,7,3,10
SLN201207010,2012,120701,SLN,PIT,STL10,4,5,9
SLN201207020,2012,120702,SLN,COL,STL10,3,9,12
SLN201207030,2012,120703,SLN,COL,STL10,3,2,5
SLN201207040,2012,120704,SLN,COL,STL10,1,4,5
SLN201207050,2012,120705,SLN,COL,STL10,2,6,8
SLN201207060,2012,120706,SLN,MIA,STL10,3,2,5
SLN201207070,2012,120707,SLN,MIA,STL10,2,3,5
SLN201207080,2012,120708,SLN,MIA,STL10,4,5,9
SLN201207200,2012,120720,SLN,CHN,STL10,1,4,5
SLN201207210,2012,120721,SLN,CHN,STL10,0,12,12
SLN201207220,2012,120722,SLN,CHN,STL10,0,7,7
SLN201207230,2012,120723,SLN,LAN,STL10,5,3,8
SLN201207240,2012,120724,SLN,LAN,STL10,2,8,10
SLN201207250,2012,120725,SLN,LAN,STL10,2,3,5
SLN201207260,2012,120726,SLN,LAN,STL10,4,7,11
SLN201208030,2012,120803,SLN,MIL,STL10,3,9,12
SLN201208040,2012,120804,SLN,MIL,STL10,1,6,7
SLN201208050,2012,120805,SLN,MIL,STL10,0,3,3
SLN201208060,2012,120806,SLN,SFN,STL10,2,8,10
SLN201208070,2012,120807,SLN,SFN,STL10,4,2,6
SLN201208080,2012,120808,SLN,SFN,STL10,15,0,15
SLN201208090,2012,120809,SLN,SFN,STL10,1,3,4
SLN201208140,2012,120814,SLN,ARI,STL10,2,8,10
SLN201208150,2012,120815,SLN,ARI,STL10,2,5,7
SLN201208160,2012,120816,SLN,ARI,STL10,2,1,3
SLN201208170,2012,120817,SLN,PIT,STL10,2,1,3
SLN201208180,2012,120818,SLN,PIT,STL10,4,5,9
SLN201208190,2012,120819,SLN,PIT,STL10,6,3,9
SLN201208210,2012,120821,SLN,HOU,STL10,0,7,7
SLN201208220,2012,120822,SLN,HOU,STL10,2,4,6
SLN201208230,2012,120823,SLN,HOU,STL10,5,13,18
SLN201209030,2012,120903,SLN,NYN,STL10,4,5,9
SLN201209040,2012,120904,SLN,NYN,STL10,1,5,6
SLN201209050,2012,120905,SLN,NYN,STL10,6,2,8
SLN201209070,2012,120907,SLN,MIL,STL10,5,4,9
SLN201209080,2012,120908,SLN,MIL,STL10,6,3,9
SLN201209090,2012,120909,SLN,MIL,STL10,4,5,9
SLN201209180,2012,120918,SLN,HOU,STL10,1,4,5
SLN201209190,2012,120919,SLN,HOU,STL10,0,5,5
SLN201209200,2012,120920,SLN,HOU,STL10,4,5,9
SLN201209280,2012,120928,SLN,WAS,STL10,2,12,14
SLN201209290,2012,120929,SLN,WAS,STL10,6,4,10
SLN201209300,2012,120930,SLN,WAS,STL10,4,10,14
SLN201210010,2012,121001,SLN,CIN,STL10,2,4,6
SLN201210020,2012,121002,SLN,CIN,STL10,3,1,4
SLN201210030,2012,121003,SLN,CIN,STL10,0,1,1
SLN201210070,2012,121007,SLN,WAS,STL10,3,2,5
SLN201210080,2012,121008,SLN,WAS,STL10,4,12,16
SLN201210170,2012,121017,SLN,SFN,STL10,1,3,4
SLN201210180,2012,121018,SLN,SFN,STL10,3,8,11
SLN201210190,2012,121019,SLN,SFN,STL10,5,0,5
SLN201304080,2013,20130408,SLN,CIN,STL10,13,4,17
SLN201304090,2013,20130409,SLN,CIN,STL10,1,5,6
SLN201304100,2013,20130410,SLN,CIN,STL10,0,10,10
SLN201304120,2013,20130412,SLN,MIL,STL10,0,2,2
SLN201304130,2013,20130413,SLN,MIL,STL10,0,8,8
SLN201304140,2013,20130414,SLN,MIL,STL10,4,3,7
SLN201304260,2013,20130426,SLN,PIT,STL10,1,9,10
SLN201304270,2013,20130427,SLN,PIT,STL10,5,3,8
SLN201304280,2013,20130428,SLN,PIT,STL10,9,0,9
SLN201304290,2013,20130429,SLN,CIN,STL10,2,1,3
SLN201304300,2013,20130430,SLN,CIN,STL10,1,2,3
SLN201305010,2013,20130501,SLN,CIN,STL10,2,4,6
SLN201305100,2013,20130510,SLN,COL,STL10,0,3,3
SLN201305110,2013,20130511,SLN,COL,STL10,0,3,3
SLN201305120,2013,20130512,SLN,COL,STL10,8,2,10
SLN201305130,2013,20130513,SLN,NYN,STL10,3,6,9
SLN201305140,2013,20130514,SLN,NYN,STL10,4,10,14
SLN201305150,2013,20130515,SLN,NYN,STL10,2,4,6
SLN201305160,2013,20130516,SLN,NYN,STL10,5,2,7
SLN201305170,2013,20130517,SLN,MIL,STL10,6,7,13
SLN201305180,2013,20130518,SLN,MIL,STL10,6,4,10
SLN201305190,2013,20130519,SLN,MIL,STL10,2,4,6
SLN201305290,2013,20130529,SLN,KCA,STL10,3,5,8
SLN201305300,2013,20130530,SLN,KCA,STL10,4,2,6
SLN201306011,2013,20130601,SLN,SFN,STL10,0,8,8
SLN201306012,2013,20130601,SLN,SFN,STL10,1,7,8
SLN201306020,2013,20130602,SLN,SFN,STL10,4,2,6
SLN201306030,2013,20130603,SLN,ARI,STL10,1,7,8
SLN201306040,2013,20130604,SLN,ARI,STL10,7,6,13
SLN201306050,2013,20130605,SLN,ARI,STL10,10,3,13
SLN201306060,2013,20130606,SLN,ARI,STL10,8,12,20
SLN201306170,2013,20130617,SLN,CHN,STL10,2,5,7
SLN201306180,2013,20130618,SLN,CHN,STL10,4,2,6
SLN201306190,2013,20130619,SLN,CHN,STL10,1,4,5
SLN201306200,2013,20130620,SLN,CHN,STL10,1,6,7
SLN201306210,2013,20130621,SLN,TEX,STL10,6,4,10
SLN201306220,2013,20130622,SLN,TEX,STL10,4,2,6
SLN201306230,2013,20130623,SLN,TEX,STL10,2,1,3
SLN201307050,2013,20130705,SLN,MIA,STL10,1,4,5
SLN201307060,2013,20130706,SLN,MIA,STL10,4,5,9
SLN201307070,2013,20130707,SLN,MIA,STL10,2,3,5
SLN201307090,2013,20130709,SLN,HOU,STL10,5,9,14
SLN201307100,2013,20130710,SLN,HOU,STL10,4,5,9
SLN201307190,2013,20130719,SLN,SDN,STL10,6,9,15
SLN201307200,2013,20130720,SLN,SDN,STL10,5,3,8
SLN201307210,2013,20130721,SLN,SDN,STL10,2,3,5
SLN201307230,2013,20130723,SLN,PHI,STL10,1,4,5
SLN201307240,2013,20130724,SLN,PHI,STL10,3,11,14
SLN201307250,2013,20130725,SLN,PHI,STL10,1,3,4
SLN201308050,2013,20130805,SLN,LAN,STL10,3,2,5
SLN201308060,2013,20130806,SLN,LAN,STL10,1,5,6
SLN201308070,2013,20130807,SLN,LAN,STL10,13,4,17
SLN201308080,2013,20130808,SLN,LAN,STL10,5,1,6
SLN201308090,2013,20130809,SLN,CHN,STL10,3,0,3
SLN201308100,2013,20130810,SLN,CHN,STL10,6,5,11
SLN201308110,2013,20130811,SLN,CHN,STL10,4,8,12
SLN201308130,2013,20130813,SLN,PIT,STL10,3,4,7
SLN201308140,2013,20130814,SLN,PIT,STL10,5,1,6
SLN201308150,2013,20130815,SLN,PIT,STL10,5,6,11
SLN201308220,2013,20130822,SLN,ATL,STL10,2,6,8
SLN201308230,2013,20130823,SLN,ATL,STL10,1,3,4
SLN201308240,2013,20130824,SLN,ATL,STL10,2,6,8
SLN201308250,2013,20130825,SLN,ATL,STL10,5,2,7
SLN201308260,2013,20130826,SLN,CIN,STL10,6,8,14
SLN201308270,2013,20130827,SLN,CIN,STL10,1,6,7
SLN201308280,2013,20130828,SLN,CIN,STL10,10,0,10
SLN201309060,2013,20130906,SLN,PIT,STL10,8,12,20
SLN201309070,2013,20130907,SLN,PIT,STL10,0,5,5
SLN201309080,2013,20130908,SLN,PIT,STL10,2,9,11
SLN201309100,2013,20130910,SLN,MIL,STL10,2,4,6
SLN201309110,2013,20130911,SLN,MIL,STL10,1,5,6
SLN201309120,2013,20130912,SLN,MIL,STL10,5,3,8
SLN201309130,2013,20130913,SLN,SEA,STL10,1,2,3
SLN201309140,2013,20130914,SLN,SEA,STL10,4,1,5
SLN201309150,2013,20130915,SLN,SEA,STL10,2,12,14
SLN201309230,2013,20130923,SLN,WAS,STL10,3,4,7
SLN201309240,2013,20130924,SLN,WAS,STL10,0,2,2
SLN201309250,2013,20130925,SLN,WAS,STL10,1,4,5
SLN201309270,2013,20130927,SLN,CHN,STL10,0,7,7
SLN201309280,2013,20130928,SLN,CHN,STL10,2,6,8
SLN201309290,2013,20130929,SLN,CHN,STL10,0,4,4
SLN201310030,2013,20131003,SLN,PIT,STL10,1,9,10
SLN201310040,2013,20131004,SLN,PIT,STL10,7,1,8
SLN201310090,2013,20131009,SLN,PIT,STL10,1,6,7
SLN201310110,2013,20131011,SLN,LAN,STL10,2,3,5
SLN201310120,2013,20131012,SLN,LAN,STL10,0,1,1
SLN201310180,2013,20131018,SLN,LAN,STL10,0,9,9
SLN201310260,2013,20131026,SLN,BOS,STL10,4,5,9
SLN201310270,2013,20131027,SLN,BOS,STL10,4,2,6
SLN201310280,2013,20131028,SLN,BOS,STL10,3,1,4
TBA201004060,2010,100406,TBA,BAL,STP01,3,4,7
TBA201004070,2010,100407,TBA,BAL,STP01,3,4,7
TBA201004080,2010,100408,TBA,BAL,STP01,5,4,9
TBA201004090,2010,100409,TBA,NYA,STP01,3,9,12
TBA201004100,2010,100410,TBA,NYA,STP01,10,0,10
TBA201004110,2010,100411,TBA,NYA,STP01,7,3,10
TBA201004230,2010,100423,TBA,TOR,STP01,6,5,11
TBA201004240,2010,100424,TBA,TOR,STP01,3,9,12
TBA201004250,2010,100425,TBA,TOR,STP01,0,6,6
TBA201004270,2010,100427,TBA,OAK,STP01,6,8,14
TBA201004280,2010,100428,TBA,OAK,STP01,3,10,13
TBA201004290,2010,100429,TBA,KCA,STP01,1,11,12
TBA201004300,2010,100430,TBA,KCA,STP01,3,2,5
TBA201005010,2010,100501,TBA,KCA,STP01,4,2,6
TBA201005020,2010,100502,TBA,KCA,STP01,0,1,1
TBA201005140,2010,100514,TBA,SEA,STP01,4,3,7
TBA201005150,2010,100515,TBA,SEA,STP01,2,3,5
TBA201005160,2010,100516,TBA,SEA,STP01,1,2,3
TBA201005170,2010,100517,TBA,CLE,STP01,3,4,7
TBA201005180,2010,100518,TBA,CLE,STP01,2,6,8
TBA201005240,2010,100524,TBA,BOS,STP01,6,1,7
TBA201005250,2010,100525,TBA,BOS,STP01,2,0,2
TBA201005260,2010,100526,TBA,BOS,STP01,11,3,14
TBA201005270,2010,100527,TBA,CHA,STP01,1,5,6
TBA201005280,2010,100528,TBA,CHA,STP01,4,2,6
TBA201005290,2010,100529,TBA,CHA,STP01,5,8,13
TBA201005300,2010,100530,TBA,CHA,STP01,8,5,13
TBA201006080,2010,100608,TBA,TOR,STP01,0,9,9
TBA201006090,2010,100609,TBA,TOR,STP01,1,10,11
TBA201006100,2010,100610,TBA,TOR,STP01,3,2,5
TBA201006110,2010,100611,TBA,FLO,STP01,14,9,23
TBA201006120,2010,100612,TBA,FLO,STP01,5,6,11
TBA201006130,2010,100613,TBA,FLO,STP01,6,1,7
TBA201006220,2010,100622,TBA,SDN,STP01,2,1,3
TBA201006230,2010,100623,TBA,SDN,STP01,5,4,9
TBA201006240,2010,100624,TBA,SDN,STP01,3,5,8
TBA201006250,2010,100625,TBA,ARI,STP01,1,0,1
TBA201006260,2010,100626,TBA,ARI,STP01,3,5,8
TBA201006270,2010,100627,TBA,ARI,STP01,2,1,3
TBA201007050,2010,100705,TBA,BOS,STP01,5,6,11
TBA201007060,2010,100706,TBA,BOS,STP01,2,3,5
TBA201007070,2010,100707,TBA,BOS,STP01,4,6,10
TBA201007080,2010,100708,TBA,CLE,STP01,2,5,7
TBA201007090,2010,100709,TBA,CLE,STP01,9,3,12
TBA201007100,2010,100710,TBA,CLE,STP01,0,4,4
TBA201007110,2010,100711,TBA,CLE,STP01,5,6,11
TBA201007260,2010,100726,TBA,DET,STP01,0,5,5
TBA201007270,2010,100727,TBA,DET,STP01,2,3,5
TBA201007280,2010,100728,TBA,DET,STP01,4,7,11
TBA201007290,2010,100729,TBA,DET,STP01,2,4,6
TBA201007300,2010,100730,TBA,NYA,STP01,2,3,5
TBA201007310,2010,100731,TBA,NYA,STP01,5,4,9
TBA201008010,2010,100801,TBA,NYA,STP01,0,3,3
TBA201008020,2010,100802,TBA,MIN,STP01,2,4,6
TBA201008030,2010,100803,TBA,MIN,STP01,4,6,10
TBA201008040,2010,100804,TBA,MIN,STP01,2,1,3
TBA201008050,2010,100805,TBA,MIN,STP01,8,6,14
TBA201008130,2010,100813,TBA,BAL,STP01,5,0,5
TBA201008140,2010,100814,TBA,BAL,STP01,3,7,10
TBA201008150,2010,100815,TBA,BAL,STP01,2,3,5
TBA201008160,2010,100816,TBA,TEX,STP01,4,6,10
TBA201008170,2010,100817,TBA,TEX,STP01,1,10,11
TBA201008180,2010,100818,TBA,TEX,STP01,6,8,14
TBA201008270,2010,100827,TBA,BOS,STP01,3,1,4
TBA201008280,2010,100828,TBA,BOS,STP01,2,3,5
TBA201008290,2010,100829,TBA,BOS,STP01,3,5,8
TBA201008300,2010,100830,TBA,TOR,STP01,2,6,8
TBA201008310,2010,100831,TBA,TOR,STP01,13,5,18
TBA201009010,2010,100901,TBA,TOR,STP01,1,2,3
TBA201009130,2010,100913,TBA,NYA,STP01,0,1,1
TBA201009140,2010,100914,TBA,NYA,STP01,8,7,15
TBA201009150,2010,100915,TBA,NYA,STP01,3,4,7
TBA201009170,2010,100917,TBA,ANA,STP01,4,3,7
TBA201009180,2010,100918,TBA,ANA,STP01,3,4,7
TBA201009190,2010,100919,TBA,ANA,STP01,6,3,9
TBA201009240,2010,100924,TBA,SEA,STP01,3,5,8
TBA201009250,2010,100925,TBA,SEA,STP01,1,9,10
TBA201009260,2010,100926,TBA,SEA,STP01,6,2,8
TBA201009270,2010,100927,TBA,BAL,STP01,4,0,4
TBA201009280,2010,100928,TBA,BAL,STP01,0,5,5
TBA201009290,2010,100929,TBA,BAL,STP01,2,0,2
TBA201010060,2010,101006,TBA,TEX,STP01,5,1,6
TBA201010070,2010,101007,TBA,TEX,STP01,6,0,6
TBA201010120,2010,101012,TBA,TEX,STP01,5,1,6
TBA201104010,2011,20110401,TBA,BAL,STP01,4,1,5
TBA201104020,2011,20110402,TBA,BAL,STP01,3,1,4
TBA201104030,2011,20110403,TBA,BAL,STP01,5,1,6
TBA201104050,2011,20110405,TBA,ANA,STP01,5,3,8
TBA201104060,2011,20110406,TBA,ANA,STP01,5,1,6
TBA201104140,2011,20110414,TBA,MIN,STP01,3,4,7
TBA201104150,2011,20110415,TBA,MIN,STP01,2,5,7
TBA201104160,2011,20110416,TBA,MIN,STP01,3,4,7
TBA201104170,2011,20110417,TBA,MIN,STP01,4,2,6
TBA201104180,2011,20110418,TBA,CHA,STP01,0,5,5
TBA201104190,2011,20110419,TBA,CHA,STP01,1,2,3
TBA201104200,2011,20110420,TBA,CHA,STP01,1,4,5
TBA201104210,2011,20110421,TBA,CHA,STP01,9,2,11
TBA201104290,2011,20110429,TBA,ANA,STP01,8,5,13
TBA201104300,2011,20110430,TBA,ANA,STP01,1,2,3
TBA201105010,2011,20110501,TBA,ANA,STP01,6,5,11
TBA201105030,2011,20110503,TBA,TOR,STP01,2,3,5
TBA201105040,2011,20110504,TBA,TOR,STP01,3,2,5
TBA201105050,2011,20110505,TBA,TOR,STP01,1,3,4
TBA201105130,2011,20110513,TBA,BAL,STP01,0,3,3
TBA201105140,2011,20110514,TBA,BAL,STP01,6,0,6
TBA201105150,2011,20110515,TBA,BAL,STP01,9,3,12
TBA201105160,2011,20110516,TBA,NYA,STP01,5,6,11
TBA201105170,2011,20110517,TBA,NYA,STP01,6,2,8
TBA201105270,2011,20110527,TBA,CLE,STP01,0,5,5
TBA201105280,2011,20110528,TBA,CLE,STP01,7,3,10
TBA201105290,2011,20110529,TBA,CLE,STP01,0,7,7
TBA201105300,2011,20110530,TBA,TEX,STP01,11,5,16
TBA201105310,2011,20110531,TBA,TEX,STP01,4,5,9
TBA201106010,2011,20110601,TBA,TEX,STP01,3,0,3
TBA201106140,2011,20110614,TBA,BOS,STP01,0,4,4
TBA201106150,2011,20110615,TBA,BOS,STP01,3,0,3
TBA201106160,2011,20110616,TBA,BOS,STP01,4,2,6
TBA201106170,2011,20110617,TBA,FLO,STP01,1,5,6
TBA201106180,2011,20110618,TBA,FLO,STP01,4,7,11
TBA201106190,2011,20110619,TBA,FLO,STP01,1,2,3
TBA201106270,2011,20110627,TBA,CIN,STP01,5,0,5
TBA201106280,2011,20110628,TBA,CIN,STP01,3,4,7
TBA201106290,2011,20110629,TBA,CIN,STP01,4,3,7
TBA201107010,2011,20110701,TBA,SLN,STP01,5,3,8
TBA201107020,2011,20110702,TBA,SLN,STP01,1,5,6
TBA201107030,2011,20110703,TBA,SLN,STP01,3,8,11
TBA201107150,2011,20110715,TBA,BOS,STP01,6,9,15
TBA201107160,2011,20110716,TBA,BOS,STP01,9,5,14
TBA201107170,2011,20110717,TBA,BOS,STP01,1,0,1
TBA201107180,2011,20110718,TBA,NYA,STP01,5,4,9
TBA201107190,2011,20110719,TBA,NYA,STP01,2,3,5
TBA201107200,2011,20110720,TBA,NYA,STP01,4,0,4
TBA201107210,2011,20110721,TBA,NYA,STP01,1,2,3
TBA201108020,2011,20110802,TBA,TOR,STP01,3,1,4
TBA201108030,2011,20110803,TBA,TOR,STP01,1,9,10
TBA201108040,2011,20110804,TBA,TOR,STP01,6,7,13
TBA201108050,2011,20110805,TBA,OAK,STP01,4,8,12
TBA201108060,2011,20110806,TBA,OAK,STP01,8,0,8
TBA201108070,2011,20110807,TBA,OAK,STP01,5,4,9
TBA201108080,2011,20110808,TBA,KCA,STP01,1,2,3
TBA201108090,2011,20110809,TBA,KCA,STP01,0,4,4
TBA201108100,2011,20110810,TBA,KCA,STP01,7,8,15
TBA201108110,2011,20110811,TBA,KCA,STP01,1,4,5
TBA201108190,2011,20110819,TBA,SEA,STP01,2,3,5
TBA201108200,2011,20110820,TBA,SEA,STP01,0,8,8
TBA201108210,2011,20110821,TBA,SEA,STP01,7,8,15
TBA201108220,2011,20110822,TBA,DET,STP01,5,2,7
TBA201108230,2011,20110823,TBA,DET,STP01,2,1,3
TBA201108240,2011,20110824,TBA,DET,STP01,2,3,5
TBA201108250,2011,20110825,TBA,DET,STP01,2,0,2
TBA201109020,2011,20110902,TBA,BAL,STP01,3,2,5
TBA201109030,2011,20110903,TBA,BAL,STP01,3,6,9
TBA201109040,2011,20110904,TBA,BAL,STP01,1,8,9
TBA201109050,2011,20110905,TBA,TEX,STP01,1,5,6
TBA201109060,2011,20110906,TBA,TEX,STP01,8,0,8
TBA201109070,2011,20110907,TBA,TEX,STP01,4,5,9
TBA201109090,2011,20110909,TBA,BOS,STP01,2,7,9
TBA201109100,2011,20110910,TBA,BOS,STP01,5,6,11
TBA201109110,2011,20110911,TBA,BOS,STP01,1,9,10
TBA201109230,2011,20110923,TBA,TOR,STP01,5,1,6
TBA201109240,2011,20110924,TBA,TOR,STP01,2,6,8
TBA201109250,2011,20110925,TBA,TOR,STP01,2,5,7
TBA201109260,2011,20110926,TBA,NYA,STP01,2,5,7
TBA201109270,2011,20110927,TBA,NYA,STP01,3,5,8
TBA201109280,2011,20110928,TBA,NYA,STP01,7,8,15
TBA201110030,2011,20111003,TBA,TEX,STP01,4,3,7
TBA201110040,2011,20111004,TBA,TEX,STP01,4,3,7
TBA201204060,2012,120406,TBA,NYA,STP01,6,7,13
TBA201204070,2012,120407,TBA,NYA,STP01,6,8,14
TBA201204080,2012,120408,TBA,NYA,STP01,0,3,3
TBA201204200,2012,120420,TBA,MIN,STP01,5,4,9
TBA201204210,2012,120421,TBA,MIN,STP01,1,4,5
TBA201204220,2012,120422,TBA,MIN,STP01,2,6,8
TBA201204240,2012,120424,TBA,ANA,STP01,0,5,5
TBA201204250,2012,120425,TBA,ANA,STP01,2,3,5
TBA201204260,2012,120426,TBA,ANA,STP01,3,4,7
TBA201204300,2012,120430,TBA,SEA,STP01,2,3,5
TBA201205010,2012,120501,TBA,SEA,STP01,1,3,4
TBA201205020,2012,120502,TBA,SEA,STP01,4,5,9
TBA201205030,2012,120503,TBA,SEA,STP01,3,4,7
TBA201205040,2012,120504,TBA,OAK,STP01,2,7,9
TBA201205050,2012,120505,TBA,OAK,STP01,4,3,7
TBA201205060,2012,120506,TBA,OAK,STP01,9,5,14
TBA201205160,2012,120516,TBA,BOS,STP01,1,2,3
TBA201205170,2012,120517,TBA,BOS,STP01,5,3,8
TBA201205180,2012,120518,TBA,ATL,STP01,5,3,8
TBA201205190,2012,120519,TBA,ATL,STP01,2,5,7
TBA201205200,2012,120520,TBA,ATL,STP01,2,0,2
TBA201205210,2012,120521,TBA,TOR,STP01,6,2,8
TBA201205220,2012,120522,TBA,TOR,STP01,5,8,13
TBA201205230,2012,120523,TBA,TOR,STP01,4,5,9
TBA201205280,2012,120528,TBA,CHA,STP01,2,1,3
TBA201205290,2012,120529,TBA,CHA,STP01,7,2,9
TBA201205300,2012,120530,TBA,CHA,STP01,4,3,7
TBA201206010,2012,120601,TBA,BAL,STP01,0,5,5
TBA201206020,2012,120602,TBA,BAL,STP01,2,1,3
TBA201206030,2012,120603,TBA,BAL,STP01,4,8,12
TBA201206120,2012,120612,TBA,NYN,STP01,11,2,13
TBA201206130,2012,120613,TBA,NYN,STP01,9,1,10
TBA201206140,2012,120614,TBA,NYN,STP01,9,6,15
TBA201206150,2012,120615,TBA,MIA,STP01,0,11,11
TBA201206160,2012,120616,TBA,MIA,STP01,4,3,7
TBA201206170,2012,120617,TBA,MIA,STP01,0,3,3
TBA201206280,2012,120628,TBA,DET,STP01,5,2,7
TBA201206290,2012,120629,TBA,DET,STP01,2,4,6
TBA201206300,2012,120630,TBA,DET,STP01,6,2,8
TBA201207010,2012,120701,TBA,DET,STP01,5,3,8
TBA201207020,2012,120702,TBA,NYA,STP01,3,4,7
TBA201207030,2012,120703,TBA,NYA,STP01,4,7,11
TBA201207040,2012,120704,TBA,NYA,STP01,4,3,7
TBA201207130,2012,120713,TBA,BOS,STP01,3,1,4
TBA201207140,2012,120714,TBA,BOS,STP01,3,5,8
TBA201207150,2012,120715,TBA,BOS,STP01,7,3,10
TBA201207160,2012,120716,TBA,CLE,STP01,3,2,5
TBA201207170,2012,120717,TBA,CLE,STP01,2,4,6
TBA201207180,2012,120718,TBA,CLE,STP01,10,6,16
TBA201207190,2012,120719,TBA,CLE,STP01,0,6,6
TBA201207200,2012,120720,TBA,SEA,STP01,3,4,7
TBA201207210,2012,120721,TBA,SEA,STP01,2,1,3
TBA201207220,2012,120722,TBA,SEA,STP01,2,1,3
TBA201208030,2012,120803,TBA,BAL,STP01,0,2,2
TBA201208040,2012,120804,TBA,BAL,STP01,4,0,4
TBA201208050,2012,120805,TBA,BAL,STP01,1,0,1
TBA201208070,2012,120807,TBA,TOR,STP01,1,4,5
TBA201208080,2012,120808,TBA,TOR,STP01,2,3,5
TBA201208090,2012,120809,TBA,TOR,STP01,1,7,8
TBA201208200,2012,120820,TBA,KCA,STP01,1,5,6
TBA201208210,2012,120821,TBA,KCA,STP01,1,0,1
TBA201208220,2012,120822,TBA,KCA,STP01,3,5,8
TBA201208230,2012,120823,TBA,OAK,STP01,0,5,5
TBA201208240,2012,120824,TBA,OAK,STP01,5,4,9
TBA201208250,2012,120825,TBA,OAK,STP01,4,2,6
TBA201209030,2012,120903,TBA,NYA,STP01,3,4,7
TBA201209040,2012,120904,TBA,NYA,STP01,2,5,7
TBA201209050,2012,120905,TBA,NYA,STP01,6,4,10
TBA201209070,2012,120907,TBA,TEX,STP01,1,3,4
TBA201209080,2012,120908,TBA,TEX,STP01,4,2,6
TBA201209090,2012,120909,TBA,TEX,STP01,0,6,6
TBA201209170,2012,120917,TBA,BOS,STP01,5,2,7
TBA201209180,2012,120918,TBA,BOS,STP01,7,5,12
TBA201209190,2012,120919,TBA,BOS,STP01,3,13,16
TBA201209200,2012,120920,TBA,BOS,STP01,4,7,11
TBA201209210,2012,120921,TBA,TOR,STP01,1,12,13
TBA201209220,2012,120922,TBA,TOR,STP01,5,11,16
TBA201209230,2012,120923,TBA,TOR,STP01,0,3,3
TBA201210010,2012,121001,TBA,BAL,STP01,3,5,8
TBA201210020,2012,121002,TBA,BAL,STP01,1,0,1
TBA201210030,2012,121003,TBA,BAL,STP01,1,4,5
TBA201304020,2013,20130402,TBA,BAL,STP01,7,4,11
TBA201304030,2013,20130403,TBA,BAL,STP01,7,8,15
TBA201304040,2013,20130404,TBA,BAL,STP01,6,3,9
TBA201304050,2013,20130405,TBA,CLE,STP01,0,4,4
TBA201304060,2013,20130406,TBA,CLE,STP01,0,6,6
TBA201304070,2013,20130407,TBA,CLE,STP01,13,0,13
TBA201304190,2013,20130419,TBA,OAK,STP01,3,8,11
TBA201304200,2013,20130420,TBA,OAK,STP01,0,1,1
TBA201304210,2013,20130421,TBA,OAK,STP01,1,8,9
TBA201304220,2013,20130422,TBA,NYA,STP01,1,5,6
TBA201304230,2013,20130423,TBA,NYA,STP01,4,3,7
TBA201304240,2013,20130424,TBA,NYA,STP01,0,3,3
TBA201305060,2013,20130506,TBA,TOR,STP01,8,7,15
TBA201305070,2013,20130507,TBA,TOR,STP01,6,4,10
TBA201305080,2013,20130508,TBA,TOR,STP01,4,10,14
TBA201305090,2013,20130509,TBA,TOR,STP01,4,5,9
TBA201305100,2013,20130510,TBA,SDN,STP01,3,6,9
TBA201305110,2013,20130511,TBA,SDN,STP01,7,8,15
TBA201305120,2013,20130512,TBA,SDN,STP01,2,4,6
TBA201305140,2013,20130514,TBA,BOS,STP01,3,5,8
TBA201305150,2013,20130515,TBA,BOS,STP01,9,2,11
TBA201305160,2013,20130516,TBA,BOS,STP01,4,3,7
TBA201305240,2013,20130524,TBA,NYA,STP01,9,4,13
TBA201305250,2013,20130525,TBA,NYA,STP01,4,3,7
TBA201305260,2013,20130526,TBA,NYA,STP01,3,8,11
TBA201305270,2013,20130527,TBA,MIA,STP01,6,10,16
TBA201305280,2013,20130528,TBA,MIA,STP01,6,7,13
TBA201306070,2013,20130607,TBA,BAL,STP01,1,2,3
TBA201306080,2013,20130608,TBA,BAL,STP01,0,8,8
TBA201306090,2013,20130609,TBA,BAL,STP01,10,7,17
TBA201306100,2013,20130610,TBA,BOS,STP01,10,8,18
TBA201306110,2013,20130611,TBA,BOS,STP01,3,8,11
TBA201306120,2013,20130612,TBA,BOS,STP01,2,1,3
TBA201306130,2013,20130613,TBA,KCA,STP01,10,1,11
TBA201306140,2013,20130614,TBA,KCA,STP01,7,2,9
TBA201306150,2013,20130615,TBA,KCA,STP01,3,5,8
TBA201306160,2013,20130616,TBA,KCA,STP01,5,3,8
TBA201306240,2013,20130624,TBA,TOR,STP01,1,4,5
TBA201306250,2013,20130625,TBA,TOR,STP01,1,5,6
TBA201306260,2013,20130626,TBA,TOR,STP01,3,0,3
TBA201306280,2013,20130628,TBA,DET,STP01,6,3,9
TBA201306290,2013,20130629,TBA,DET,STP01,3,4,7
TBA201306300,2013,20130630,TBA,DET,STP01,1,3,4
TBA201307050,2013,20130705,TBA,CHA,STP01,3,8,11
TBA201307060,2013,20130706,TBA,CHA,STP01,0,3,3
TBA201307070,2013,20130707,TBA,CHA,STP01,1,3,4
TBA201307080,2013,20130708,TBA,MIN,STP01,4,7,11
TBA201307090,2013,20130709,TBA,MIN,STP01,1,4,5
TBA201307100,2013,20130710,TBA,MIN,STP01,3,4,7
TBA201307110,2013,20130711,TBA,MIN,STP01,3,4,7
TBA201307120,2013,20130712,TBA,HOU,STP01,2,1,3
TBA201307130,2013,20130713,TBA,HOU,STP01,3,4,7
TBA201307140,2013,20130714,TBA,HOU,STP01,0,5,5
TBA201307300,2013,20130730,TBA,ARI,STP01,2,5,7
TBA201307310,2013,20130731,TBA,ARI,STP01,7,0,7
TBA201308020,2013,20130802,TBA,SFN,STP01,4,1,5
TBA201308030,2013,20130803,TBA,SFN,STP01,1,2,3
TBA201308040,2013,20130804,TBA,SFN,STP01,3,4,7
TBA201308130,2013,20130813,TBA,SEA,STP01,5,4,9
TBA201308140,2013,20130814,TBA,SEA,STP01,4,5,9
TBA201308150,2013,20130815,TBA,SEA,STP01,1,7,8
TBA201308160,2013,20130816,TBA,TOR,STP01,4,5,9
TBA201308170,2013,20130817,TBA,TOR,STP01,6,2,8
TBA201308180,2013,20130818,TBA,TOR,STP01,1,2,3
TBA201308230,2013,20130823,TBA,NYA,STP01,2,7,9
TBA201308240,2013,20130824,TBA,NYA,STP01,2,4,6
TBA201308250,2013,20130825,TBA,NYA,STP01,3,2,5
TBA201308270,2013,20130827,TBA,ANA,STP01,6,5,11
TBA201308280,2013,20130828,TBA,ANA,STP01,1,4,5
TBA201308290,2013,20130829,TBA,ANA,STP01,2,0,2
TBA201309100,2013,20130910,TBA,BOS,STP01,2,0,2
TBA201309110,2013,20130911,TBA,BOS,STP01,7,3,10
TBA201309120,2013,20130912,TBA,BOS,STP01,3,4,7
TBA201309160,2013,20130916,TBA,TEX,STP01,2,6,8
TBA201309170,2013,20130917,TBA,TEX,STP01,7,1,8
TBA201309180,2013,20130918,TBA,TEX,STP01,3,4,7
TBA201309190,2013,20130919,TBA,TEX,STP01,8,2,10
TBA201309200,2013,20130920,TBA,BAL,STP01,4,5,9
TBA201309210,2013,20130921,TBA,BAL,STP01,1,5,6
TBA201309220,2013,20130922,TBA,BAL,STP01,1,3,4
TBA201309230,2013,20130923,TBA,BAL,STP01,4,5,9
TBA201310070,2013,20131007,TBA,BOS,STP01,4,5,9
TBA201310080,2013,20131008,TBA,BOS,STP01,3,1,4
TEX201004050,2010,100405,TEX,TOR,ARL02,4,5,9
TEX201004070,2010,100407,TEX,TOR,ARL02,7,4,11
TEX201004080,2010,100408,TEX,TOR,ARL02,3,1,4
TEX201004090,2010,100409,TEX,SEA,ARL02,2,6,8
TEX201004100,2010,100410,TEX,SEA,ARL02,4,3,7
TEX201004110,2010,100411,TEX,SEA,ARL02,2,9,11
TEX201004230,2010,100423,TEX,DET,ARL02,4,5,9
TEX201004240,2010,100424,TEX,DET,ARL02,8,4,12
TEX201004250,2010,100425,TEX,DET,ARL02,4,8,12
TEX201004260,2010,100426,TEX,DET,ARL02,8,6,14
TEX201004270,2010,100427,TEX,CHA,ARL02,2,4,6
TEX201004280,2010,100428,TEX,CHA,ARL02,5,6,11
TEX201004290,2010,100429,TEX,CHA,ARL02,7,5,12
TEX201005060,2010,100506,TEX,KCA,ARL02,12,13,25
TEX201005070,2010,100507,TEX,KCA,ARL02,1,4,5
TEX201005080,2010,100508,TEX,KCA,ARL02,2,3,5
TEX201005090,2010,100509,TEX,KCA,ARL02,4,6,10
TEX201005110,2010,100511,TEX,OAK,ARL02,7,6,13
TEX201005120,2010,100512,TEX,OAK,ARL02,1,10,11
TEX201005130,2010,100513,TEX,OAK,ARL02,1,2,3
TEX201005170,2010,100517,TEX,ANA,ARL02,3,4,7
TEX201005180,2010,100518,TEX,ANA,ARL02,7,8,15
TEX201005190,2010,100519,TEX,BAL,ARL02,3,4,7
TEX201005200,2010,100520,TEX,BAL,ARL02,7,13,20
TEX201005210,2010,100521,TEX,CHN,ARL02,1,2,3
TEX201005220,2010,100522,TEX,CHN,ARL02,5,4,9
TEX201005230,2010,100523,TEX,CHN,ARL02,5,4,9
TEX201006040,2010,100604,TEX,TBA,ARL02,6,9,15
TEX201006050,2010,100605,TEX,TBA,ARL02,1,6,7
TEX201006060,2010,100606,TEX,TBA,ARL02,9,5,14
TEX201006070,2010,100607,TEX,SEA,ARL02,4,2,6
TEX201006080,2010,100608,TEX,SEA,ARL02,1,7,8
TEX201006090,2010,100609,TEX,SEA,ARL02,2,12,14
TEX201006100,2010,100610,TEX,SEA,ARL02,3,12,15
TEX201006220,2010,100622,TEX,PIT,ARL02,3,6,9
TEX201006230,2010,100623,TEX,PIT,ARL02,3,13,16
TEX201006240,2010,100624,TEX,PIT,ARL02,5,6,11
TEX201006250,2010,100625,TEX,HOU,ARL02,7,4,11
TEX201006260,2010,100626,TEX,HOU,ARL02,2,7,9
TEX201006270,2010,100627,TEX,HOU,ARL02,1,10,11
TEX201007020,2010,100702,TEX,CHA,ARL02,5,3,8
TEX201007030,2010,100703,TEX,CHA,ARL02,1,3,4
TEX201007040,2010,100704,TEX,CHA,ARL02,5,3,8
TEX201007050,2010,100705,TEX,CLE,ARL02,9,3,12
TEX201007060,2010,100706,TEX,CLE,ARL02,1,12,13
TEX201007070,2010,100707,TEX,CLE,ARL02,3,4,7
TEX201007080,2010,100708,TEX,BAL,ARL02,6,4,10
TEX201007090,2010,100709,TEX,BAL,ARL02,7,6,13
TEX201007100,2010,100710,TEX,BAL,ARL02,6,1,7
TEX201007110,2010,100711,TEX,BAL,ARL02,4,1,5
TEX201007220,2010,100722,TEX,ANA,ARL02,2,3,5
TEX201007230,2010,100723,TEX,ANA,ARL02,0,1,1
TEX201007240,2010,100724,TEX,ANA,ARL02,6,2,8
TEX201007250,2010,100725,TEX,ANA,ARL02,4,6,10
TEX201007270,2010,100727,TEX,OAK,ARL02,1,3,4
TEX201007280,2010,100728,TEX,OAK,ARL02,3,1,4
TEX201007290,2010,100729,TEX,OAK,ARL02,4,7,11
TEX201008100,2010,100810,TEX,NYA,ARL02,3,4,7
TEX201008110,2010,100811,TEX,NYA,ARL02,7,6,13
TEX201008130,2010,100813,TEX,BOS,ARL02,9,10,19
TEX201008140,2010,100814,TEX,BOS,ARL02,3,1,4
TEX201008150,2010,100815,TEX,BOS,ARL02,3,7,10
TEX201008230,2010,100823,TEX,MIN,ARL02,0,4,4
TEX201008240,2010,100824,TEX,MIN,ARL02,3,4,7
TEX201008250,2010,100825,TEX,MIN,ARL02,3,4,7
TEX201008260,2010,100826,TEX,MIN,ARL02,6,4,10
TEX201008270,2010,100827,TEX,OAK,ARL02,3,7,10
TEX201008280,2010,100828,TEX,OAK,ARL02,5,0,5
TEX201008290,2010,100829,TEX,OAK,ARL02,8,2,10
TEX201009100,2010,100910,TEX,NYA,ARL02,5,6,11
TEX201009110,2010,100911,TEX,NYA,ARL02,6,7,13
TEX201009120,2010,100912,TEX,NYA,ARL02,1,4,5
TEX201009140,2010,100914,TEX,DET,ARL02,4,11,15
TEX201009150,2010,100915,TEX,DET,ARL02,7,11,18
TEX201009270,2010,100927,TEX,SEA,ARL02,7,5,12
TEX201009280,2010,100928,TEX,SEA,ARL02,3,1,4
TEX201009290,2010,100929,TEX,SEA,ARL02,5,6,11
TEX201009300,2010,100930,TEX,ANA,ARL02,2,3,5
TEX201010010,2010,101001,TEX,ANA,ARL02,5,4,9
TEX201010020,2010,101002,TEX,ANA,ARL02,2,6,8
TEX201010030,2010,101003,TEX,ANA,ARL02,6,2,8
TEX201010090,2010,101009,TEX,TBA,ARL02,6,3,9
TEX201010100,2010,101010,TEX,TBA,ARL02,5,2,7
TEX201010150,2010,101015,TEX,NYA,ARL02,6,5,11
TEX201010160,2010,101016,TEX,NYA,ARL02,2,7,9
TEX201010220,2010,101022,TEX,NYA,ARL02,1,6,7
TEX201010300,2010,101030,TEX,SFN,ARL02,2,4,6
TEX201010310,2010,101031,TEX,SFN,ARL02,4,0,4
TEX201011010,2010,101101,TEX,SFN,ARL02,3,1,4
TEX201104010,2011,20110401,TEX,BOS,ARL02,5,9,14
TEX201104020,2011,20110402,TEX,BOS,ARL02,5,12,17
TEX201104030,2011,20110403,TEX,BOS,ARL02,1,5,6
TEX201104040,2011,20110404,TEX,SEA,ARL02,4,6,10
TEX201104050,2011,20110405,TEX,SEA,ARL02,2,3,5
TEX201104060,2011,20110406,TEX,SEA,ARL02,3,7,10
TEX201104180,2011,20110418,TEX,ANA,ARL02,1,7,8
TEX201104190,2011,20110419,TEX,ANA,ARL02,15,4,19
TEX201104200,2011,20110420,TEX,ANA,ARL02,4,1,5
TEX201104220,2011,20110422,TEX,KCA,ARL02,6,11,17
TEX201104230,2011,20110423,TEX,KCA,ARL02,1,3,4
TEX201104240,2011,20110424,TEX,KCA,ARL02,7,8,15
TEX201104250,2011,20110425,TEX,TOR,ARL02,6,4,10
TEX201104260,2011,20110426,TEX,TOR,ARL02,10,3,13
TEX201104270,2011,20110427,TEX,TOR,ARL02,6,7,13
TEX201104280,2011,20110428,TEX,TOR,ARL02,5,2,7
TEX201105060,2011,20110506,TEX,NYA,ARL02,4,1,5
TEX201105070,2011,20110507,TEX,NYA,ARL02,5,7,12
TEX201105080,2011,20110508,TEX,NYA,ARL02,12,5,17
TEX201105090,2011,20110509,TEX,OAK,ARL02,7,2,9
TEX201105100,2011,20110510,TEX,OAK,ARL02,2,7,9
TEX201105130,2011,20110513,TEX,ANA,ARL02,1,4,5
TEX201105140,2011,20110514,TEX,ANA,ARL02,3,2,5
TEX201105150,2011,20110515,TEX,ANA,ARL02,4,5,9
TEX201105230,2011,20110523,TEX,CHA,ARL02,0,4,4
TEX201105240,2011,20110524,TEX,CHA,ARL02,8,6,14
TEX201105250,2011,20110525,TEX,CHA,ARL02,1,2,3
TEX201105270,2011,20110527,TEX,KCA,ARL02,12,7,19
TEX201105280,2011,20110528,TEX,KCA,ARL02,1,10,11
TEX201105290,2011,20110529,TEX,KCA,ARL02,6,7,13
TEX201106060,2011,20110606,TEX,DET,ARL02,13,7,20
TEX201106070,2011,20110607,TEX,DET,ARL02,8,1,9
TEX201106080,2011,20110608,TEX,DET,ARL02,3,7,10
TEX201106200,2011,20110620,TEX,HOU,ARL02,3,8,11
TEX201106210,2011,20110621,TEX,HOU,ARL02,4,5,9
TEX201106220,2011,20110622,TEX,HOU,ARL02,5,3,8
TEX201106240,2011,20110624,TEX,NYN,ARL02,1,8,9
TEX201106250,2011,20110625,TEX,NYN,ARL02,14,5,19
TEX201106260,2011,20110626,TEX,NYN,ARL02,8,5,13
TEX201107010,2011,20110701,TEX,FLO,ARL02,5,15,20
TEX201107020,2011,20110702,TEX,FLO,ARL02,9,5,14
TEX201107030,2011,20110703,TEX,FLO,ARL02,6,4,10
TEX201107040,2011,20110704,TEX,BAL,ARL02,4,13,17
TEX201107050,2011,20110705,TEX,BAL,ARL02,2,4,6
TEX201107060,2011,20110706,TEX,BAL,ARL02,5,13,18
TEX201107070,2011,20110707,TEX,OAK,ARL02,0,6,6
TEX201107080,2011,20110708,TEX,OAK,ARL02,5,8,13
TEX201107090,2011,20110709,TEX,OAK,ARL02,6,7,13
TEX201107100,2011,20110710,TEX,OAK,ARL02,0,2,2
TEX201107220,2011,20110722,TEX,TOR,ARL02,2,12,14
TEX201107230,2011,20110723,TEX,TOR,ARL02,4,5,9
TEX201107240,2011,20110724,TEX,TOR,ARL02,3,0,3
TEX201107250,2011,20110725,TEX,MIN,ARL02,6,20,26
TEX201107260,2011,20110726,TEX,MIN,ARL02,9,8,17
TEX201107270,2011,20110727,TEX,MIN,ARL02,7,2,9
TEX201107280,2011,20110728,TEX,MIN,ARL02,1,4,5
TEX201108050,2011,20110805,TEX,CLE,ARL02,7,8,15
TEX201108060,2011,20110806,TEX,CLE,ARL02,7,5,12
TEX201108070,2011,20110807,TEX,CLE,ARL02,3,5,8
TEX201108080,2011,20110808,TEX,SEA,ARL02,2,9,11
TEX201108090,2011,20110809,TEX,SEA,ARL02,6,7,13
TEX201108100,2011,20110810,TEX,SEA,ARL02,4,3,7
TEX201108220,2011,20110822,TEX,BOS,ARL02,0,4,4
TEX201108230,2011,20110823,TEX,BOS,ARL02,11,5,16
TEX201108240,2011,20110824,TEX,BOS,ARL02,13,2,15
TEX201108250,2011,20110825,TEX,BOS,ARL02,6,0,6
TEX201108260,2011,20110826,TEX,ANA,ARL02,7,11,18
TEX201108270,2011,20110827,TEX,ANA,ARL02,8,4,12
TEX201108280,2011,20110828,TEX,ANA,ARL02,5,9,14
TEX201108300,2011,20110830,TEX,TBA,ARL02,0,2,2
TEX201108310,2011,20110831,TEX,TBA,ARL02,4,1,5
TEX201109010,2011,20110901,TEX,TBA,ARL02,2,7,9
TEX201109090,2011,20110909,TEX,OAK,ARL02,4,13,17
TEX201109100,2011,20110910,TEX,OAK,ARL02,8,7,15
TEX201109110,2011,20110911,TEX,OAK,ARL02,1,8,9
TEX201109130,2011,20110913,TEX,CLE,ARL02,4,10,14
TEX201109140,2011,20110914,TEX,CLE,ARL02,1,9,10
TEX201109150,2011,20110915,TEX,CLE,ARL02,4,7,11
TEX201109230,2011,20110923,TEX,SEA,ARL02,3,5,8
TEX201109240,2011,20110924,TEX,SEA,ARL02,3,7,10
TEX201109250,2011,20110925,TEX,SEA,ARL02,5,12,17
TEX201109300,2011,20110930,TEX,TBA,ARL02,9,0,9
TEX201110010,2011,20111001,TEX,TBA,ARL02,6,8,14
TEX201110080,2011,20111008,TEX,DET,ARL02,2,3,5
TEX201110100,2011,20111010,TEX,DET,ARL02,3,7,10
TEX201110150,2011,20111015,TEX,DET,ARL02,5,15,20
TEX201110220,2011,20111022,TEX,SLN,ARL02,16,7,23
TEX201110230,2011,20111023,TEX,SLN,ARL02,0,4,4
TEX201110240,2011,20111024,TEX,SLN,ARL02,2,4,6
TEX201204060,2012,120406,TEX,CHA,ARL02,2,3,5
TEX201204070,2012,120407,TEX,CHA,ARL02,4,3,7
TEX201204080,2012,120408,TEX,CHA,ARL02,0,5,5
TEX201204090,2012,120409,TEX,SEA,ARL02,5,11,16
TEX201204100,2012,120410,TEX,SEA,ARL02,0,1,1
TEX201204110,2012,120411,TEX,SEA,ARL02,4,3,7
TEX201204120,2012,120412,TEX,SEA,ARL02,3,5,8
TEX201204230,2012,120423,TEX,NYA,ARL02,7,4,11
TEX201204240,2012,120424,TEX,NYA,ARL02,0,2,2
TEX201204250,2012,120425,TEX,NYA,ARL02,3,7,10
TEX201204270,2012,120427,TEX,TBA,ARL02,8,4,12
TEX201204280,2012,120428,TEX,TBA,ARL02,2,7,9
TEX201204290,2012,120429,TEX,TBA,ARL02,5,2,7
TEX201205110,2012,120511,TEX,ANA,ARL02,3,10,13
TEX201205120,2012,120512,TEX,ANA,ARL02,4,2,6
TEX201205130,2012,120513,TEX,ANA,ARL02,6,13,19
TEX201205140,2012,120514,TEX,KCA,ARL02,3,1,4
TEX201205150,2012,120515,TEX,KCA,ARL02,7,4,11
TEX201205160,2012,120516,TEX,OAK,ARL02,1,4,5
TEX201205170,2012,120517,TEX,OAK,ARL02,5,4,9
TEX201205250,2012,120525,TEX,TOR,ARL02,3,14,17
TEX201205260,2012,120526,TEX,TOR,ARL02,7,8,15
TEX201205270,2012,120527,TEX,TOR,ARL02,6,12,18
TEX201205280,2012,120528,TEX,SEA,ARL02,2,4,6
TEX201205290,2012,120529,TEX,SEA,ARL02,10,3,13
TEX201205300,2012,120530,TEX,SEA,ARL02,21,8,29
TEX201206120,2012,120612,TEX,ARI,ARL02,1,9,10
TEX201206130,2012,120613,TEX,ARI,ARL02,0,1,1
TEX201206140,2012,120614,TEX,ARI,ARL02,11,3,14
TEX201206150,2012,120615,TEX,HOU,ARL02,2,6,8
TEX201206160,2012,120616,TEX,HOU,ARL02,3,8,11
TEX201206170,2012,120617,TEX,HOU,ARL02,3,9,12
TEX201206220,2012,120622,TEX,COL,ARL02,1,4,5
TEX201206230,2012,120623,TEX,COL,ARL02,11,7,18
TEX201206240,2012,120624,TEX,COL,ARL02,2,4,6
TEX201206250,2012,120625,TEX,DET,ARL02,8,2,10
TEX201206260,2012,120626,TEX,DET,ARL02,5,7,12
TEX201206270,2012,120627,TEX,DET,ARL02,9,13,22
TEX201206280,2012,120628,TEX,OAK,ARL02,6,7,13
TEX201206290,2012,120629,TEX,OAK,ARL02,3,4,7
TEX201206300,2012,120630,TEX,OAK,ARL02,2,7,9
TEX201207010,2012,120701,TEX,OAK,ARL02,3,1,4
TEX201207060,2012,120706,TEX,MIN,ARL02,5,1,6
TEX201207070,2012,120707,TEX,MIN,ARL02,3,4,7
TEX201207080,2012,120708,TEX,MIN,ARL02,3,4,7
TEX201207230,2012,120723,TEX,BOS,ARL02,1,9,10
TEX201207240,2012,120724,TEX,BOS,ARL02,2,1,3
TEX201207250,2012,120725,TEX,BOS,ARL02,3,5,8
TEX201207270,2012,120727,TEX,CHA,ARL02,9,5,14
TEX201207280,2012,120728,TEX,CHA,ARL02,5,2,7
TEX201207290,2012,120729,TEX,CHA,ARL02,0,2,2
TEX201207300,2012,120730,TEX,ANA,ARL02,15,8,23
TEX201207310,2012,120731,TEX,ANA,ARL02,6,2,8
TEX201208010,2012,120801,TEX,ANA,ARL02,10,11,21
TEX201208020,2012,120802,TEX,ANA,ARL02,9,15,24
TEX201208100,2012,120810,TEX,DET,ARL02,6,2,8
TEX201208110,2012,120811,TEX,DET,ARL02,1,2,3
TEX201208120,2012,120812,TEX,DET,ARL02,3,8,11
TEX201208200,2012,120820,TEX,BAL,ARL02,1,5,6
TEX201208210,2012,120821,TEX,BAL,ARL02,5,3,8
TEX201208220,2012,120822,TEX,BAL,ARL02,3,12,15
TEX201208230,2012,120823,TEX,MIN,ARL02,6,10,16
TEX201208240,2012,120824,TEX,MIN,ARL02,0,8,8
TEX201208250,2012,120825,TEX,MIN,ARL02,3,9,12
TEX201208260,2012,120826,TEX,MIN,ARL02,6,5,11
TEX201208270,2012,120827,TEX,TBA,ARL02,5,6,11
TEX201208280,2012,120828,TEX,TBA,ARL02,0,1,1
TEX201208290,2012,120829,TEX,TBA,ARL02,8,4,12
TEX201209110,2012,120911,TEX,CLE,ARL02,4,6,10
TEX201209120,2012,120912,TEX,CLE,ARL02,2,5,7
TEX201209130,2012,120913,TEX,CLE,ARL02,5,4,9
TEX201209140,2012,120914,TEX,SEA,ARL02,3,9,12
TEX201209150,2012,120915,TEX,SEA,ARL02,8,6,14
TEX201209160,2012,120916,TEX,SEA,ARL02,1,2,3
TEX201209240,2012,120924,TEX,OAK,ARL02,4,5,9
TEX201209250,2012,120925,TEX,OAK,ARL02,3,2,5
TEX201209260,2012,120926,TEX,OAK,ARL02,9,3,12
TEX201209270,2012,120927,TEX,OAK,ARL02,7,9,16
TEX201209280,2012,120928,TEX,ANA,ARL02,7,4,11
TEX201209301,2012,120930,TEX,ANA,ARL02,5,4,9
TEX201209302,2012,120930,TEX,ANA,ARL02,7,8,15
TEX201210050,2012,121005,TEX,BAL,ARL02,5,1,6
TEX201304050,2013,20130405,TEX,ANA,ARL02,2,3,5
TEX201304060,2013,20130406,TEX,ANA,ARL02,8,4,12
TEX201304070,2013,20130407,TEX,ANA,ARL02,3,7,10
TEX201304080,2013,20130408,TEX,TBA,ARL02,4,5,9
TEX201304090,2013,20130409,TEX,TBA,ARL02,1,6,7
TEX201304100,2013,20130410,TEX,TBA,ARL02,2,0,2
TEX201304190,2013,20130419,TEX,SEA,ARL02,0,7,7
TEX201304200,2013,20130420,TEX,SEA,ARL02,0,5,5
TEX201304210,2013,20130421,TEX,SEA,ARL02,3,11,14
TEX201304300,2013,20130430,TEX,CHA,ARL02,6,10,16
TEX201305010,2013,20130501,TEX,CHA,ARL02,5,2,7
TEX201305020,2013,20130502,TEX,CHA,ARL02,3,1,4
TEX201305030,2013,20130503,TEX,BOS,ARL02,0,7,7
TEX201305040,2013,20130504,TEX,BOS,ARL02,1,5,6
TEX201305050,2013,20130505,TEX,BOS,ARL02,3,4,7
TEX201305160,2013,20130516,TEX,DET,ARL02,4,10,14
TEX201305170,2013,20130517,TEX,DET,ARL02,2,1,3
TEX201305180,2013,20130518,TEX,DET,ARL02,2,7,9
TEX201305190,2013,20130519,TEX,DET,ARL02,8,11,19
TEX201305200,2013,20130520,TEX,OAK,ARL02,9,2,11
TEX201305210,2013,20130521,TEX,OAK,ARL02,1,0,1
TEX201305220,2013,20130522,TEX,OAK,ARL02,1,3,4
TEX201305300,2013,20130530,TEX,ARI,ARL02,5,9,14
TEX201305310,2013,20130531,TEX,KCA,ARL02,2,7,9
TEX201306010,2013,20130601,TEX,KCA,ARL02,4,1,5
TEX201306020,2013,20130602,TEX,KCA,ARL02,1,3,4
TEX201306100,2013,20130610,TEX,CLE,ARL02,3,6,9
TEX201306110,2013,20130611,TEX,CLE,ARL02,5,2,7
TEX201306120,2013,20130612,TEX,CLE,ARL02,5,2,7
TEX201306130,2013,20130613,TEX,TOR,ARL02,3,1,4
TEX201306140,2013,20130614,TEX,TOR,ARL02,8,0,8
TEX201306150,2013,20130615,TEX,TOR,ARL02,6,1,7
TEX201306160,2013,20130616,TEX,TOR,ARL02,7,2,9
TEX201306170,2013,20130617,TEX,OAK,ARL02,7,8,15
TEX201306180,2013,20130618,TEX,OAK,ARL02,6,2,8
TEX201306190,2013,20130619,TEX,OAK,ARL02,4,9,13
TEX201306200,2013,20130620,TEX,OAK,ARL02,3,4,7
TEX201306280,2013,20130628,TEX,CIN,ARL02,0,4,4
TEX201306290,2013,20130629,TEX,CIN,ARL02,6,4,10
TEX201306300,2013,20130630,TEX,CIN,ARL02,2,3,5
TEX201307020,2013,20130702,TEX,SEA,ARL02,9,2,11
TEX201307030,2013,20130703,TEX,SEA,ARL02,4,2,6
TEX201307040,2013,20130704,TEX,SEA,ARL02,4,5,9
TEX201307050,2013,20130705,TEX,HOU,ARL02,5,10,15
TEX201307060,2013,20130706,TEX,HOU,ARL02,9,5,14
TEX201307070,2013,20130707,TEX,HOU,ARL02,4,5,9
TEX201307190,2013,20130719,TEX,BAL,ARL02,3,1,4
TEX201307200,2013,20130720,TEX,BAL,ARL02,7,4,11
TEX201307210,2013,20130721,TEX,BAL,ARL02,4,2,6
TEX201307220,2013,20130722,TEX,NYA,ARL02,0,3,3
TEX201307230,2013,20130723,TEX,NYA,ARL02,5,4,9
TEX201307240,2013,20130724,TEX,NYA,ARL02,1,3,4
TEX201307250,2013,20130725,TEX,NYA,ARL02,2,0,2
TEX201307290,2013,20130729,TEX,ANA,ARL02,3,4,7
TEX201307300,2013,20130730,TEX,ANA,ARL02,11,14,25
TEX201307310,2013,20130731,TEX,ANA,ARL02,1,2,3
TEX201308010,2013,20130801,TEX,ARI,ARL02,1,7,8
TEX201308130,2013,20130813,TEX,MIL,ARL02,5,1,6
TEX201308140,2013,20130814,TEX,MIL,ARL02,4,5,9
TEX201308160,2013,20130816,TEX,SEA,ARL02,3,1,4
TEX201308170,2013,20130817,TEX,SEA,ARL02,3,15,18
TEX201308180,2013,20130818,TEX,SEA,ARL02,4,3,7
TEX201308190,2013,20130819,TEX,HOU,ARL02,5,16,21
TEX201308200,2013,20130820,TEX,HOU,ARL02,2,4,6
TEX201308210,2013,20130821,TEX,HOU,ARL02,4,5,9
TEX201308300,2013,20130830,TEX,MIN,ARL02,3,2,5
TEX201308310,2013,20130831,TEX,MIN,ARL02,1,2,3
TEX201309010,2013,20130901,TEX,MIN,ARL02,4,2,6
TEX201309090,2013,20130909,TEX,PIT,ARL02,1,0,1
TEX201309100,2013,20130910,TEX,PIT,ARL02,5,4,9
TEX201309110,2013,20130911,TEX,PIT,ARL02,7,5,12
TEX201309130,2013,20130913,TEX,OAK,ARL02,9,8,17
TEX201309140,2013,20130914,TEX,OAK,ARL02,1,0,1
TEX201309150,2013,20130915,TEX,OAK,ARL02,5,1,6
TEX201309230,2013,20130923,TEX,HOU,ARL02,0,12,12
TEX201309240,2013,20130924,TEX,HOU,ARL02,2,3,5
TEX201309250,2013,20130925,TEX,HOU,ARL02,3,7,10
TEX201309260,2013,20130926,TEX,ANA,ARL02,5,6,11
TEX201309270,2013,20130927,TEX,ANA,ARL02,3,5,8
TEX201309280,2013,20130928,TEX,ANA,ARL02,4,7,11
TEX201309290,2013,20130929,TEX,ANA,ARL02,2,6,8
TEX201309300,2013,20130930,TEX,TBA,ARL02,5,2,7
TOR201004120,2010,100412,TOR,CHA,TOR02,8,7,15
TOR201004130,2010,100413,TOR,CHA,TOR02,2,4,6
TOR201004140,2010,100414,TOR,CHA,TOR02,11,1,12
TOR201004150,2010,100415,TOR,CHA,TOR02,3,7,10
TOR201004160,2010,100416,TOR,ANA,TOR02,7,5,12
TOR201004170,2010,100417,TOR,ANA,TOR02,6,3,9
TOR201004180,2010,100418,TOR,ANA,TOR02,3,1,4
TOR201004190,2010,100419,TOR,KCA,TOR02,1,8,9
TOR201004200,2010,100420,TOR,KCA,TOR02,3,4,7
TOR201004210,2010,100421,TOR,KCA,TOR02,4,3,7
TOR201004260,2010,100426,TOR,BOS,TOR02,13,12,25
TOR201004270,2010,100427,TOR,BOS,TOR02,2,1,3
TOR201004280,2010,100428,TOR,BOS,TOR02,2,0,2
TOR201004290,2010,100429,TOR,OAK,TOR02,3,6,9
TOR201004300,2010,100430,TOR,OAK,TOR02,2,10,12
TOR201005010,2010,100501,TOR,OAK,TOR02,4,3,7
TOR201005020,2010,100502,TOR,OAK,TOR02,3,9,12
TOR201005140,2010,100514,TOR,TEX,TOR02,10,16,26
TOR201005150,2010,100515,TOR,TEX,TOR02,0,6,6
TOR201005160,2010,100516,TOR,TEX,TOR02,2,5,7
TOR201005170,2010,100517,TOR,MIN,TOR02,8,3,11
TOR201005180,2010,100518,TOR,MIN,TOR02,2,11,13
TOR201005280,2010,100528,TOR,BAL,TOR02,0,5,5
TOR201005290,2010,100529,TOR,BAL,TOR02,2,5,7
TOR201005300,2010,100530,TOR,BAL,TOR02,1,6,7
TOR201005310,2010,100531,TOR,TBA,TOR02,2,3,5
TOR201006010,2010,100601,TOR,TBA,TOR02,7,6,13
TOR201006020,2010,100602,TOR,TBA,TOR02,7,3,10
TOR201006040,2010,100604,TOR,NYA,TOR02,1,6,7
TOR201006050,2010,100605,TOR,NYA,TOR02,2,3,5
TOR201006060,2010,100606,TOR,NYA,TOR02,4,3,7
TOR201006180,2010,100618,TOR,SFN,TOR02,2,3,5
TOR201006190,2010,100619,TOR,SFN,TOR02,0,3,3
TOR201006200,2010,100620,TOR,SFN,TOR02,9,6,15
TOR201006220,2010,100622,TOR,SLN,TOR02,9,4,13
TOR201006230,2010,100623,TOR,SLN,TOR02,1,0,1
TOR201006240,2010,100624,TOR,SLN,TOR02,0,5,5
TOR201006250,2010,100625,TOR,PHI,PHI13,9,0,9
TOR201006260,2010,100626,TOR,PHI,PHI13,1,5,6
TOR201006270,2010,100627,TOR,PHI,PHI13,11,2,13
TOR201007060,2010,100706,TOR,MIN,TOR02,7,6,13
TOR201007070,2010,100707,TOR,MIN,TOR02,5,6,11
TOR201007080,2010,100708,TOR,MIN,TOR02,1,8,9
TOR201007090,2010,100709,TOR,BOS,TOR02,14,3,17
TOR201007100,2010,100710,TOR,BOS,TOR02,5,9,14
TOR201007110,2010,100711,TOR,BOS,TOR02,3,2,5
TOR201007260,2010,100726,TOR,BAL,TOR02,5,9,14
TOR201007270,2010,100727,TOR,BAL,TOR02,2,8,10
TOR201007280,2010,100728,TOR,BAL,TOR02,0,5,5
TOR201007300,2010,100730,TOR,CLE,TOR02,1,8,9
TOR201007310,2010,100731,TOR,CLE,TOR02,2,1,3
TOR201008010,2010,100801,TOR,CLE,TOR02,5,4,9
TOR201008060,2010,100806,TOR,TBA,TOR02,1,2,3
TOR201008070,2010,100807,TOR,TBA,TOR02,11,17,28
TOR201008080,2010,100808,TOR,TBA,TOR02,0,1,1
TOR201008100,2010,100810,TOR,BOS,TOR02,7,5,12
TOR201008110,2010,100811,TOR,BOS,TOR02,10,1,11
TOR201008120,2010,100812,TOR,BOS,TOR02,5,6,11
TOR201008230,2010,100823,TOR,NYA,TOR02,2,3,5
TOR201008240,2010,100824,TOR,NYA,TOR02,11,5,16
TOR201008250,2010,100825,TOR,NYA,TOR02,3,6,9
TOR201008260,2010,100826,TOR,DET,TOR02,7,1,8
TOR201008270,2010,100827,TOR,DET,TOR02,2,3,5
TOR201008280,2010,100828,TOR,DET,TOR02,4,5,9
TOR201008290,2010,100829,TOR,DET,TOR02,10,4,14
TOR201009060,2010,100906,TOR,TEX,TOR02,2,7,9
TOR201009070,2010,100907,TOR,TEX,TOR02,5,8,13
TOR201009080,2010,100908,TOR,TEX,TOR02,8,1,9
TOR201009090,2010,100909,TOR,TEX,TOR02,4,2,6
TOR201009100,2010,100910,TOR,TBA,TOR02,9,8,17
TOR201009110,2010,100911,TOR,TBA,TOR02,13,1,14
TOR201009120,2010,100912,TOR,TBA,TOR02,4,5,9
TOR201009210,2010,100921,TOR,SEA,TOR02,3,5,8
TOR201009220,2010,100922,TOR,SEA,TOR02,6,3,9
TOR201009230,2010,100923,TOR,SEA,TOR02,0,1,1
TOR201009240,2010,100924,TOR,BAL,TOR02,4,6,10
TOR201009250,2010,100925,TOR,BAL,TOR02,4,5,9
TOR201009260,2010,100926,TOR,BAL,TOR02,2,5,7
TOR201009270,2010,100927,TOR,NYA,TOR02,5,7,12
TOR201009280,2010,100928,TOR,NYA,TOR02,6,1,7
TOR201009290,2010,100929,TOR,NYA,TOR02,4,8,12
TOR201104010,2011,20110401,TOR,MIN,TOR02,3,13,16
TOR201104020,2011,20110402,TOR,MIN,TOR02,1,6,7
TOR201104030,2011,20110403,TOR,MIN,TOR02,4,3,7
TOR201104050,2011,20110405,TOR,OAK,TOR02,6,7,13
TOR201104060,2011,20110406,TOR,OAK,TOR02,3,5,8
TOR201104070,2011,20110407,TOR,OAK,TOR02,2,1,3
TOR201104190,2011,20110419,TOR,NYA,TOR02,5,6,11
TOR201104200,2011,20110420,TOR,NYA,TOR02,6,2,8
TOR201104220,2011,20110422,TOR,TBA,TOR02,4,6,10
TOR201104230,2011,20110423,TOR,TBA,TOR02,6,4,10
TOR201104240,2011,20110424,TOR,TBA,TOR02,2,0,2
TOR201105060,2011,20110506,TOR,DET,TOR02,4,7,11
TOR201105070,2011,20110507,TOR,DET,TOR02,9,0,9
TOR201105080,2011,20110508,TOR,DET,TOR02,5,2,7
TOR201105090,2011,20110509,TOR,DET,TOR02,10,5,15
TOR201105100,2011,20110510,TOR,BOS,TOR02,6,7,13
TOR201105110,2011,20110511,TOR,BOS,TOR02,3,9,12
TOR201105180,2011,20110518,TOR,TBA,TOR02,6,5,11
TOR201105190,2011,20110519,TOR,TBA,TOR02,2,3,5
TOR201105200,2011,20110520,TOR,HOU,TOR02,5,2,7
TOR201105210,2011,20110521,TOR,HOU,TOR02,5,7,12
TOR201105220,2011,20110522,TOR,HOU,TOR02,3,2,5
TOR201105260,2011,20110526,TOR,CHA,TOR02,3,1,4
TOR201105270,2011,20110527,TOR,CHA,TOR02,2,4,6
TOR201105280,2011,20110528,TOR,CHA,TOR02,8,9,17
TOR201105290,2011,20110529,TOR,CHA,TOR02,4,13,17
TOR201105300,2011,20110530,TOR,CLE,TOR02,1,11,12
TOR201105310,2011,20110531,TOR,CLE,TOR02,6,3,9
TOR201106010,2011,20110601,TOR,CLE,TOR02,13,9,22
TOR201106100,2011,20110610,TOR,BOS,TOR02,5,1,6
TOR201106110,2011,20110611,TOR,BOS,TOR02,16,4,20
TOR201106120,2011,20110612,TOR,BOS,TOR02,14,1,15
TOR201106140,2011,20110614,TOR,BAL,TOR02,5,6,11
TOR201106150,2011,20110615,TOR,BAL,TOR02,1,4,5
TOR201106160,2011,20110616,TOR,BAL,TOR02,4,3,7
TOR201106280,2011,20110628,TOR,PIT,TOR02,7,6,13
TOR201106290,2011,20110629,TOR,PIT,TOR02,1,2,3
TOR201106300,2011,20110630,TOR,PIT,TOR02,6,2,8
TOR201107010,2011,20110701,TOR,PHI,TOR02,7,6,13
TOR201107020,2011,20110702,TOR,PHI,TOR02,5,3,8
TOR201107030,2011,20110703,TOR,PHI,TOR02,4,7,11
TOR201107140,2011,20110714,TOR,NYA,TOR02,7,16,23
TOR201107150,2011,20110715,TOR,NYA,TOR02,1,7,8
TOR201107160,2011,20110716,TOR,NYA,TOR02,4,1,5
TOR201107170,2011,20110717,TOR,NYA,TOR02,7,2,9
TOR201107190,2011,20110719,TOR,SEA,TOR02,5,6,11
TOR201107200,2011,20110720,TOR,SEA,TOR02,6,11,17
TOR201107210,2011,20110721,TOR,SEA,TOR02,5,7,12
TOR201107260,2011,20110726,TOR,BAL,TOR02,12,4,16
TOR201107270,2011,20110727,TOR,BAL,TOR02,0,3,3
TOR201107280,2011,20110728,TOR,BAL,TOR02,5,8,13
TOR201107290,2011,20110729,TOR,TEX,TOR02,2,3,5
TOR201107300,2011,20110730,TOR,TEX,TOR02,3,0,3
TOR201107310,2011,20110731,TOR,TEX,TOR02,3,7,10
TOR201108090,2011,20110809,TOR,OAK,TOR02,4,1,5
TOR201108100,2011,20110810,TOR,OAK,TOR02,4,8,12
TOR201108110,2011,20110811,TOR,OAK,TOR02,10,3,13
TOR201108120,2011,20110812,TOR,ANA,TOR02,5,1,6
TOR201108130,2011,20110813,TOR,ANA,TOR02,2,11,13
TOR201108140,2011,20110814,TOR,ANA,TOR02,4,5,9
TOR201108230,2011,20110823,TOR,KCA,TOR02,6,4,10
TOR201108240,2011,20110824,TOR,KCA,TOR02,3,4,7
TOR201108250,2011,20110825,TOR,KCA,TOR02,9,6,15
TOR201108260,2011,20110826,TOR,TBA,TOR02,6,1,7
TOR201108270,2011,20110827,TOR,TBA,TOR02,6,5,11
TOR201108280,2011,20110828,TOR,TBA,TOR02,12,0,12
TOR201108290,2011,20110829,TOR,TBA,TOR02,3,7,10
TOR201109050,2011,20110905,TOR,BOS,TOR02,0,1,1
TOR201109060,2011,20110906,TOR,BOS,TOR02,14,0,14
TOR201109070,2011,20110907,TOR,BOS,TOR02,10,11,21
TOR201109080,2011,20110908,TOR,BOS,TOR02,4,7,11
TOR201109090,2011,20110909,TOR,BAL,TOR02,2,0,2
TOR201109100,2011,20110910,TOR,BAL,TOR02,4,5,9
TOR201109110,2011,20110911,TOR,BAL,TOR02,5,6,11
TOR201109160,2011,20110916,TOR,NYA,TOR02,4,5,9
TOR201109170,2011,20110917,TOR,NYA,TOR02,7,6,13
TOR201109180,2011,20110918,TOR,NYA,TOR02,0,3,3
TOR201109190,2011,20110919,TOR,ANA,TOR02,2,3,5
TOR201109200,2011,20110920,TOR,ANA,TOR02,10,6,16
TOR201109210,2011,20110921,TOR,ANA,TOR02,7,2,9
TOR201109220,2011,20110922,TOR,ANA,TOR02,3,4,7
TOR201204090,2012,120409,TOR,BOS,TOR02,4,2,6
TOR201204100,2012,120410,TOR,BOS,TOR02,3,7,10
TOR201204110,2012,120411,TOR,BOS,TOR02,1,3,4
TOR201204130,2012,120413,TOR,BAL,TOR02,7,5,12
TOR201204140,2012,120414,TOR,BAL,TOR02,6,4,10
TOR201204150,2012,120415,TOR,BAL,TOR02,2,9,11
TOR201204170,2012,120417,TOR,TBA,TOR02,3,7,10
TOR201204180,2012,120418,TOR,TBA,TOR02,12,2,14
TOR201204190,2012,120419,TOR,TBA,TOR02,9,4,13
TOR201204270,2012,120427,TOR,SEA,TOR02,9,5,14
TOR201204280,2012,120428,TOR,SEA,TOR02,0,7,7
TOR201204290,2012,120429,TOR,SEA,TOR02,2,7,9
TOR201204300,2012,120430,TOR,TEX,TOR02,4,1,5
TOR201205010,2012,120501,TOR,TEX,TOR02,7,8,15
TOR201205020,2012,120502,TOR,TEX,TOR02,5,11,16
TOR201205140,2012,120514,TOR,TBA,TOR02,7,1,8
TOR201205150,2012,120515,TOR,TBA,TOR02,4,3,7
TOR201205160,2012,120516,TOR,NYA,TOR02,1,8,9
TOR201205170,2012,120517,TOR,NYA,TOR02,1,4,5
TOR201205180,2012,120518,TOR,NYN,TOR02,5,14,19
TOR201205190,2012,120519,TOR,NYN,TOR02,0,2,2
TOR201205200,2012,120520,TOR,NYN,TOR02,6,5,11
TOR201205280,2012,120528,TOR,BAL,TOR02,2,6,8
TOR201205290,2012,120529,TOR,BAL,TOR02,6,8,14
TOR201205300,2012,120530,TOR,BAL,TOR02,1,4,5
TOR201206010,2012,120601,TOR,BOS,TOR02,7,2,9
TOR201206020,2012,120602,TOR,BOS,TOR02,7,4,11
TOR201206030,2012,120603,TOR,BOS,TOR02,1,5,6
TOR201206110,2012,120611,TOR,WAS,TOR02,6,3,9
TOR201206120,2012,120612,TOR,WAS,TOR02,4,2,6
TOR201206130,2012,120613,TOR,WAS,TOR02,6,2,8
TOR201206150,2012,120615,TOR,PHI,TOR02,0,3,3
TOR201206160,2012,120616,TOR,PHI,TOR02,5,6,11
TOR201206170,2012,120617,TOR,PHI,TOR02,2,6,8
TOR201206280,2012,120628,TOR,ANA,TOR02,9,7,16
TOR201206290,2012,120629,TOR,ANA,TOR02,5,7,12
TOR201206300,2012,120630,TOR,ANA,TOR02,2,11,13
TOR201207010,2012,120701,TOR,ANA,TOR02,10,6,16
TOR201207020,2012,120702,TOR,KCA,TOR02,11,3,14
TOR201207030,2012,120703,TOR,KCA,TOR02,3,6,9
TOR201207040,2012,120704,TOR,KCA,TOR02,1,4,5
TOR201207050,2012,120705,TOR,KCA,TOR02,9,6,15
TOR201207130,2012,120713,TOR,CLE,TOR02,1,0,1
TOR201207140,2012,120714,TOR,CLE,TOR02,9,11,20
TOR201207150,2012,120715,TOR,CLE,TOR02,0,3,3
TOR201207240,2012,120724,TOR,OAK,TOR02,7,2,9
TOR201207250,2012,120725,TOR,OAK,TOR02,16,0,16
TOR201207260,2012,120726,TOR,OAK,TOR02,4,10,14
TOR201207270,2012,120727,TOR,DET,TOR02,3,8,11
TOR201207280,2012,120728,TOR,DET,TOR02,1,5,6
TOR201207290,2012,120729,TOR,DET,TOR02,4,1,5
TOR201208100,2012,120810,TOR,NYA,TOR02,10,4,14
TOR201208110,2012,120811,TOR,NYA,TOR02,5,2,7
TOR201208120,2012,120812,TOR,NYA,TOR02,7,10,17
TOR201208130,2012,120813,TOR,CHA,TOR02,2,3,5
TOR201208140,2012,120814,TOR,CHA,TOR02,3,2,5
TOR201208150,2012,120815,TOR,CHA,TOR02,9,5,14
TOR201208160,2012,120816,TOR,CHA,TOR02,7,2,9
TOR201208170,2012,120817,TOR,TEX,TOR02,2,3,5
TOR201208180,2012,120818,TOR,TEX,TOR02,2,1,3
TOR201208190,2012,120819,TOR,TEX,TOR02,11,2,13
TOR201208300,2012,120830,TOR,TBA,TOR02,0,2,2
TOR201208310,2012,120831,TOR,TBA,TOR02,1,2,3
TOR201209010,2012,120901,TOR,TBA,TOR02,5,4,9
TOR201209020,2012,120902,TOR,TBA,TOR02,9,4,13
TOR201209030,2012,120903,TOR,BAL,TOR02,4,0,4
TOR201209040,2012,120904,TOR,BAL,TOR02,12,0,12
TOR201209050,2012,120905,TOR,BAL,TOR02,4,6,10
TOR201209110,2012,120911,TOR,SEA,TOR02,4,3,7
TOR201209120,2012,120912,TOR,SEA,TOR02,3,2,5
TOR201209130,2012,120913,TOR,SEA,TOR02,3,8,11
TOR201209140,2012,120914,TOR,BOS,TOR02,8,5,13
TOR201209150,2012,120915,TOR,BOS,TOR02,3,2,5
TOR201209160,2012,120916,TOR,BOS,TOR02,0,5,5
TOR201209270,2012,120927,TOR,NYA,TOR02,0,6,6
TOR201209280,2012,120928,TOR,NYA,TOR02,11,4,15
TOR201209290,2012,120929,TOR,NYA,TOR02,2,3,5
TOR201209300,2012,120930,TOR,NYA,TOR02,9,6,15
TOR201210010,2012,121001,TOR,MIN,TOR02,5,6,11
TOR201210020,2012,121002,TOR,MIN,TOR02,3,4,7
TOR201210030,2012,121003,TOR,MIN,TOR02,1,2,3
TOR201304020,2013,20130402,TOR,CLE,TOR02,4,1,5
TOR201304030,2013,20130403,TOR,CLE,TOR02,3,2,5
TOR201304040,2013,20130404,TOR,CLE,TOR02,8,10,18
TOR201304050,2013,20130405,TOR,BOS,TOR02,6,4,10
TOR201304060,2013,20130406,TOR,BOS,TOR02,0,5,5
TOR201304070,2013,20130407,TOR,BOS,TOR02,13,0,13
TOR201304150,2013,20130415,TOR,CHA,TOR02,3,4,7
TOR201304160,2013,20130416,TOR,CHA,TOR02,4,3,7
TOR201304170,2013,20130417,TOR,CHA,TOR02,7,0,7
TOR201304180,2013,20130418,TOR,CHA,TOR02,1,3,4
TOR201304190,2013,20130419,TOR,NYA,TOR02,9,4,13
TOR201304200,2013,20130420,TOR,NYA,TOR02,5,3,8
TOR201304210,2013,20130421,TOR,NYA,TOR02,4,8,12
TOR201304300,2013,20130430,TOR,BOS,TOR02,7,9,16
TOR201305010,2013,20130501,TOR,BOS,TOR02,10,1,11
TOR201305020,2013,20130502,TOR,BOS,TOR02,3,1,4
TOR201305030,2013,20130503,TOR,SEA,TOR02,4,0,4
TOR201305040,2013,20130504,TOR,SEA,TOR02,8,1,9
TOR201305050,2013,20130505,TOR,SEA,TOR02,2,10,12
TOR201305140,2013,20130514,TOR,SFN,TOR02,6,10,16
TOR201305150,2013,20130515,TOR,SFN,TOR02,3,11,14
TOR201305200,2013,20130520,TOR,TBA,TOR02,5,7,12
TOR201305210,2013,20130521,TOR,TBA,TOR02,4,3,7
TOR201305220,2013,20130522,TOR,TBA,TOR02,3,4,7
TOR201305230,2013,20130523,TOR,BAL,TOR02,6,12,18
TOR201305240,2013,20130524,TOR,BAL,TOR02,10,6,16
TOR201305250,2013,20130525,TOR,BAL,TOR02,6,5,11
TOR201305260,2013,20130526,TOR,BAL,TOR02,5,6,11
TOR201305270,2013,20130527,TOR,ATL,TOR02,3,9,12
TOR201305280,2013,20130528,TOR,ATL,TOR02,7,6,13
TOR201306070,2013,20130607,TOR,TEX,TOR02,1,6,7
TOR201306080,2013,20130608,TOR,TEX,TOR02,3,4,7
TOR201306090,2013,20130609,TOR,TEX,TOR02,6,4,10
TOR201306170,2013,20130617,TOR,COL,TOR02,0,2,2
TOR201306180,2013,20130618,TOR,COL,TOR02,3,8,11
TOR201306190,2013,20130619,TOR,COL,TOR02,2,5,7
TOR201306210,2013,20130621,TOR,BAL,TOR02,6,7,13
TOR201306220,2013,20130622,TOR,BAL,TOR02,2,4,6
TOR201306230,2013,20130623,TOR,BAL,TOR02,5,13,18
TOR201307010,2013,20130701,TOR,DET,TOR02,3,8,11
TOR201307020,2013,20130702,TOR,DET,TOR02,7,6,13
TOR201307030,2013,20130703,TOR,DET,TOR02,6,2,8
TOR201307040,2013,20130704,TOR,DET,TOR02,11,1,12
TOR201307050,2013,20130705,TOR,MIN,TOR02,0,4,4
TOR201307060,2013,20130706,TOR,MIN,TOR02,6,0,6
TOR201307070,2013,20130707,TOR,MIN,TOR02,5,11,16
TOR201307190,2013,20130719,TOR,TBA,TOR02,8,5,13
TOR201307200,2013,20130720,TOR,TBA,TOR02,4,3,7
TOR201307210,2013,20130721,TOR,TBA,TOR02,4,3,7
TOR201307220,2013,20130722,TOR,LAN,TOR02,14,5,19
TOR201307230,2013,20130723,TOR,LAN,TOR02,10,9,19
TOR201307240,2013,20130724,TOR,LAN,TOR02,8,3,11
TOR201307250,2013,20130725,TOR,HOU,TOR02,0,4,4
TOR201307260,2013,20130726,TOR,HOU,TOR02,6,12,18
TOR201307270,2013,20130727,TOR,HOU,TOR02,8,6,14
TOR201307280,2013,20130728,TOR,HOU,TOR02,1,2,3
TOR201308090,2013,20130809,TOR,OAK,TOR02,14,6,20
TOR201308100,2013,20130810,TOR,OAK,TOR02,4,5,9
TOR201308110,2013,20130811,TOR,OAK,TOR02,6,4,10
TOR201308120,2013,20130812,TOR,OAK,TOR02,5,1,6
TOR201308130,2013,20130813,TOR,BOS,TOR02,4,2,6
TOR201308140,2013,20130814,TOR,BOS,TOR02,3,4,7
TOR201308150,2013,20130815,TOR,BOS,TOR02,1,2,3
TOR201308260,2013,20130826,TOR,NYA,TOR02,2,5,7
TOR201308270,2013,20130827,TOR,NYA,TOR02,7,1,8
TOR201308280,2013,20130828,TOR,NYA,TOR02,2,7,9
TOR201308300,2013,20130830,TOR,KCA,TOR02,2,3,5
TOR201308310,2013,20130831,TOR,KCA,TOR02,2,4,6
TOR201309010,2013,20130901,TOR,KCA,TOR02,5,0,5
TOR201309100,2013,20130910,TOR,ANA,TOR02,12,6,18
TOR201309110,2013,20130911,TOR,ANA,TOR02,5,4,9
TOR201309120,2013,20130912,TOR,ANA,TOR02,4,3,7
TOR201309130,2013,20130913,TOR,BAL,TOR02,5,3,8
TOR201309140,2013,20130914,TOR,BAL,TOR02,3,4,7
TOR201309150,2013,20130915,TOR,BAL,TOR02,3,1,4
TOR201309170,2013,20130917,TOR,NYA,TOR02,0,2,2
TOR201309180,2013,20130918,TOR,NYA,TOR02,4,3,7
TOR201309190,2013,20130919,TOR,NYA,TOR02,2,6,8
TOR201309270,2013,20130927,TOR,TBA,TOR02,3,6,9
TOR201309280,2013,20130928,TOR,TBA,TOR02,2,7,9
TOR201309290,2013,20130929,TOR,TBA,TOR02,7,6,13
WAS201004050,2010,100405,WAS,PHI,WAS11,11,1,12
WAS201004070,2010,100407,WAS,PHI,WAS11,8,4,12
WAS201004080,2010,100408,WAS,PHI,WAS11,5,6,11
WAS201004160,2010,100416,WAS,MIL,WAS11,3,5,8
WAS201004170,2010,100417,WAS,MIL,WAS11,0,8,8
WAS201004180,2010,100418,WAS,MIL,WAS11,11,7,18
WAS201004190,2010,100419,WAS,COL,WAS11,2,5,7
WAS201004200,2010,100420,WAS,COL,WAS11,10,4,14
WAS201004210,2010,100421,WAS,COL,WAS11,4,6,10
WAS201004220,2010,100422,WAS,COL,WAS11,2,0,2
WAS201004230,2010,100423,WAS,LAN,WAS11,1,5,6
WAS201004240,2010,100424,WAS,LAN,WAS11,4,3,7
WAS201004250,2010,100425,WAS,LAN,WAS11,0,1,1
WAS201005040,2010,100504,WAS,ATL,WAS11,3,6,9
WAS201005050,2010,100505,WAS,ATL,WAS11,7,6,13
WAS201005060,2010,100506,WAS,ATL,WAS11,2,3,5
WAS201005070,2010,100507,WAS,FLO,WAS11,4,2,6
WAS201005080,2010,100508,WAS,FLO,WAS11,4,5,9
WAS201005090,2010,100509,WAS,FLO,WAS11,2,3,5
WAS201005190,2010,100519,WAS,NYN,WAS11,3,5,8
WAS201005200,2010,100520,WAS,NYN,WAS11,10,7,17
WAS201005210,2010,100521,WAS,BAL,WAS11,5,3,8
WAS201005220,2010,100522,WAS,BAL,WAS11,6,7,13
WAS201005230,2010,100523,WAS,BAL,WAS11,3,4,7
WAS201006040,2010,100604,WAS,CIN,WAS11,2,4,6
WAS201006050,2010,100605,WAS,CIN,WAS11,5,1,6
WAS201006060,2010,100606,WAS,CIN,WAS11,5,4,9
WAS201006080,2010,100608,WAS,PIT,WAS11,2,5,7
WAS201006090,2010,100609,WAS,PIT,WAS11,5,7,12
WAS201006100,2010,100610,WAS,PIT,WAS11,2,4,6
WAS201006180,2010,100618,WAS,CHA,WAS11,2,1,3
WAS201006190,2010,100619,WAS,CHA,WAS11,1,0,1
WAS201006200,2010,100620,WAS,CHA,WAS11,6,3,9
WAS201006210,2010,100621,WAS,KCA,WAS11,1,2,3
WAS201006220,2010,100622,WAS,KCA,WAS11,3,4,7
WAS201006230,2010,100623,WAS,KCA,WAS11,1,0,1
WAS201007010,2010,100701,WAS,NYN,WAS11,1,2,3
WAS201007020,2010,100702,WAS,NYN,WAS11,5,3,8
WAS201007030,2010,100703,WAS,NYN,WAS11,5,6,11
WAS201007040,2010,100704,WAS,NYN,WAS11,9,5,14
WAS201007060,2010,100706,WAS,SDN,WAS11,5,6,11
WAS201007070,2010,100707,WAS,SDN,WAS11,6,7,13
WAS201007080,2010,100708,WAS,SDN,WAS11,7,1,8
WAS201007090,2010,100709,WAS,SFN,WAS11,1,8,9
WAS201007100,2010,100710,WAS,SFN,WAS11,10,5,15
WAS201007110,2010,100711,WAS,SFN,WAS11,6,2,8
WAS201007270,2010,100727,WAS,ATL,WAS11,0,3,3
WAS201007280,2010,100728,WAS,ATL,WAS11,3,1,4
WAS201007290,2010,100729,WAS,ATL,WAS11,3,5,8
WAS201007300,2010,100730,WAS,PHI,WAS11,1,8,9
WAS201007310,2010,100731,WAS,PHI,WAS11,5,7,12
WAS201008010,2010,100801,WAS,PHI,WAS11,6,4,10
WAS201008100,2010,100810,WAS,FLO,WAS11,8,2,10
WAS201008110,2010,100811,WAS,FLO,WAS11,9,5,14
WAS201008120,2010,100812,WAS,FLO,WAS11,5,0,5
WAS201008130,2010,100813,WAS,ARI,WAS11,2,4,6
WAS201008140,2010,100814,WAS,ARI,WAS11,9,2,11
WAS201008150,2010,100815,WAS,ARI,WAS11,3,5,8
WAS201008230,2010,100823,WAS,CHN,WAS11,9,1,10
WAS201008240,2010,100824,WAS,CHN,WAS11,5,4,9
WAS201008250,2010,100825,WAS,CHN,WAS11,4,0,4
WAS201008260,2010,100826,WAS,SLN,WAS11,10,11,21
WAS201008270,2010,100827,WAS,SLN,WAS11,4,2,6
WAS201008280,2010,100828,WAS,SLN,WAS11,5,14,19
WAS201008290,2010,100829,WAS,SLN,WAS11,2,4,6
WAS201009060,2010,100906,WAS,NYN,WAS11,3,13,16
WAS201009070,2010,100907,WAS,NYN,WAS11,4,1,5
WAS201009080,2010,100908,WAS,NYN,WAS11,3,2,5
WAS201009100,2010,100910,WAS,FLO,WAS11,3,1,4
WAS201009110,2010,100911,WAS,FLO,WAS11,4,1,5
WAS201009120,2010,100912,WAS,FLO,WAS11,6,5,11
WAS201009200,2010,100920,WAS,HOU,WAS11,8,2,10
WAS201009210,2010,100921,WAS,HOU,WAS11,4,8,12
WAS201009220,2010,100922,WAS,HOU,WAS11,3,4,7
WAS201009230,2010,100923,WAS,HOU,WAS11,2,7,9
WAS201009240,2010,100924,WAS,ATL,WAS11,3,8,11
WAS201009250,2010,100925,WAS,ATL,WAS11,5,0,5
WAS201009260,2010,100926,WAS,ATL,WAS11,2,4,6
WAS201009270,2010,100927,WAS,PHI,WAS11,8,0,8
WAS201009280,2010,100928,WAS,PHI,WAS11,1,2,3
WAS201009290,2010,100929,WAS,PHI,WAS11,7,1,8
WAS201103310,2011,20110331,WAS,ATL,WAS11,2,0,2
WAS201104020,2011,20110402,WAS,ATL,WAS11,3,6,9
WAS201104030,2011,20110403,WAS,ATL,WAS11,11,2,13
WAS201104120,2011,20110412,WAS,PHI,WAS11,4,7,11
WAS201104130,2011,20110413,WAS,PHI,WAS11,3,2,5
WAS201104140,2011,20110414,WAS,PHI,WAS11,4,0,4
WAS201104150,2011,20110415,WAS,MIL,WAS11,3,4,7
WAS201104171,2011,20110417,WAS,MIL,WAS11,4,8,12
WAS201104172,2011,20110417,WAS,MIL,WAS11,1,5,6
WAS201104260,2011,20110426,WAS,NYN,WAS11,6,4,10
WAS201104270,2011,20110427,WAS,NYN,WAS11,6,3,9
WAS201104280,2011,20110428,WAS,NYN,WAS11,3,4,7
WAS201104290,2011,20110429,WAS,SFN,WAS11,0,3,3
WAS201104300,2011,20110430,WAS,SFN,WAS11,2,1,3
WAS201105010,2011,20110501,WAS,SFN,WAS11,2,5,7
WAS201105020,2011,20110502,WAS,SFN,WAS11,0,2,2
WAS201105130,2011,20110513,WAS,FLO,WAS11,6,5,11
WAS201105140,2011,20110514,WAS,FLO,WAS11,1,0,1
WAS201105150,2011,20110515,WAS,FLO,WAS11,4,8,12
WAS201105160,2011,20110516,WAS,PIT,WAS11,2,4,6
WAS201105270,2011,20110527,WAS,SDN,WAS11,1,2,3
WAS201105280,2011,20110528,WAS,SDN,WAS11,2,1,3
WAS201105290,2011,20110529,WAS,SDN,WAS11,5,4,9
WAS201105300,2011,20110530,WAS,PHI,WAS11,5,4,9
WAS201105310,2011,20110531,WAS,PHI,WAS11,2,10,12
WAS201106010,2011,20110601,WAS,PHI,WAS11,1,2,3
WAS201106140,2011,20110614,WAS,SLN,WAS11,6,8,14
WAS201106150,2011,20110615,WAS,SLN,WAS11,0,10,10
WAS201106160,2011,20110616,WAS,SLN,WAS11,4,7,11
WAS201106170,2011,20110617,WAS,BAL,WAS11,4,8,12
WAS201106180,2011,20110618,WAS,BAL,WAS11,2,4,6
WAS201106190,2011,20110619,WAS,BAL,WAS11,7,4,11
WAS201106210,2011,20110621,WAS,SEA,WAS11,5,6,11
WAS201106220,2011,20110622,WAS,SEA,WAS11,1,2,3
WAS201106230,2011,20110623,WAS,SEA,WAS11,0,1,1
WAS201107010,2011,20110701,WAS,PIT,WAS11,1,2,3
WAS201107021,2011,20110702,WAS,PIT,WAS11,5,3,8
WAS201107022,2011,20110702,WAS,PIT,WAS11,3,4,7
WAS201107030,2011,20110703,WAS,PIT,WAS11,10,2,12
WAS201107040,2011,20110704,WAS,CHN,WAS11,4,5,9
WAS201107050,2011,20110705,WAS,CHN,WAS11,2,3,5
WAS201107060,2011,20110706,WAS,CHN,WAS11,4,5,9
WAS201107070,2011,20110707,WAS,CHN,WAS11,10,9,19
WAS201107080,2011,20110708,WAS,COL,WAS11,3,2,5
WAS201107090,2011,20110709,WAS,COL,WAS11,2,1,3
WAS201107100,2011,20110710,WAS,COL,WAS11,0,2,2
WAS201107260,2011,20110726,WAS,FLO,WAS11,11,2,13
WAS201107270,2011,20110727,WAS,FLO,WAS11,7,5,12
WAS201107280,2011,20110728,WAS,FLO,WAS11,5,2,7
WAS201107290,2011,20110729,WAS,NYN,WAS11,8,5,13
WAS201107300,2011,20110730,WAS,NYN,WAS11,0,3,3
WAS201107310,2011,20110731,WAS,NYN,WAS11,2,3,5
WAS201108010,2011,20110801,WAS,ATL,WAS11,3,5,8
WAS201108020,2011,20110802,WAS,ATL,WAS11,3,9,12
WAS201108030,2011,20110803,WAS,ATL,WAS11,6,4,10
WAS201108160,2011,20110816,WAS,CIN,WAS11,4,6,10
WAS201108170,2011,20110817,WAS,CIN,WAS11,2,1,3
WAS201108180,2011,20110818,WAS,CIN,WAS11,1,3,4
WAS201108190,2011,20110819,WAS,PHI,WAS11,4,8,12
WAS201108200,2011,20110820,WAS,PHI,WAS11,5,0,5
WAS201108210,2011,20110821,WAS,PHI,WAS11,4,5,9
WAS201108220,2011,20110822,WAS,ARI,WAS11,1,4,5
WAS201108230,2011,20110823,WAS,ARI,WAS11,2,0,2
WAS201108240,2011,20110824,WAS,ARI,WAS11,4,2,6
WAS201108250,2011,20110825,WAS,ARI,WAS11,8,1,9
WAS201109020,2011,20110902,WAS,NYN,WAS11,7,3,10
WAS201109030,2011,20110903,WAS,NYN,WAS11,7,8,15
WAS201109040,2011,20110904,WAS,NYN,WAS11,6,3,9
WAS201109050,2011,20110905,WAS,LAN,WAS11,2,7,9
WAS201109060,2011,20110906,WAS,LAN,WAS11,7,3,10
WAS201109080,2011,20110908,WAS,LAN,WAS11,7,4,11
WAS201109090,2011,20110909,WAS,HOU,WAS11,3,4,7
WAS201109100,2011,20110910,WAS,HOU,WAS11,9,3,12
WAS201109110,2011,20110911,WAS,HOU,WAS11,2,8,10
WAS201109160,2011,20110916,WAS,FLO,WAS11,3,0,3
WAS201109170,2011,20110917,WAS,FLO,WAS11,4,1,5
WAS201109180,2011,20110918,WAS,FLO,WAS11,3,4,7
WAS201109230,2011,20110923,WAS,ATL,WAS11,7,4,11
WAS201109240,2011,20110924,WAS,ATL,WAS11,1,4,5
WAS201109250,2011,20110925,WAS,ATL,WAS11,0,3,3
WAS201204120,2012,120412,WAS,CIN,WAS11,2,3,5
WAS201204130,2012,120413,WAS,CIN,WAS11,1,2,3
WAS201204140,2012,120414,WAS,CIN,WAS11,1,4,5
WAS201204150,2012,120415,WAS,CIN,WAS11,8,5,13
WAS201204160,2012,120416,WAS,HOU,WAS11,3,6,9
WAS201204170,2012,120417,WAS,HOU,WAS11,0,1,1
WAS201204180,2012,120418,WAS,HOU,WAS11,2,3,5
WAS201204190,2012,120419,WAS,HOU,WAS11,11,4,15
WAS201204200,2012,120420,WAS,MIA,WAS11,0,2,2
WAS201204210,2012,120421,WAS,MIA,WAS11,2,3,5
WAS201205010,2012,120501,WAS,ARI,WAS11,5,1,6
WAS201205020,2012,120502,WAS,ARI,WAS11,4,5,9
WAS201205030,2012,120503,WAS,ARI,WAS11,1,2,3
WAS201205040,2012,120504,WAS,PHI,WAS11,3,4,7
WAS201205050,2012,120505,WAS,PHI,WAS11,1,7,8
WAS201205060,2012,120506,WAS,PHI,WAS11,9,3,12
WAS201205140,2012,120514,WAS,SDN,WAS11,5,8,13
WAS201205150,2012,120515,WAS,SDN,WAS11,6,1,7
WAS201205160,2012,120516,WAS,PIT,WAS11,4,7,11
WAS201205170,2012,120517,WAS,PIT,WAS11,5,3,8
WAS201205180,2012,120518,WAS,BAL,WAS11,2,1,3
WAS201205190,2012,120519,WAS,BAL,WAS11,6,5,11
WAS201205200,2012,120520,WAS,BAL,WAS11,3,9,12
WAS201206020,2012,120602,WAS,ATL,WAS11,0,2,2
WAS201206030,2012,120603,WAS,ATL,WAS11,3,2,5
WAS201206050,2012,120605,WAS,NYN,WAS11,6,7,13
WAS201206060,2012,120606,WAS,NYN,WAS11,3,5,8
WAS201206070,2012,120607,WAS,NYN,WAS11,3,1,4
WAS201206150,2012,120615,WAS,NYA,WAS11,7,2,9
WAS201206160,2012,120616,WAS,NYA,WAS11,5,3,8
WAS201206170,2012,120617,WAS,NYA,WAS11,4,1,5
WAS201206190,2012,120619,WAS,TBA,WAS11,5,4,9
WAS201206200,2012,120620,WAS,TBA,WAS11,2,3,5
WAS201206210,2012,120621,WAS,TBA,WAS11,2,5,7
WAS201207030,2012,120703,WAS,SFN,WAS11,3,9,12
WAS201207040,2012,120704,WAS,SFN,WAS11,4,9,13
WAS201207050,2012,120705,WAS,SFN,WAS11,5,6,11
WAS201207060,2012,120706,WAS,COL,WAS11,5,1,6
WAS201207070,2012,120707,WAS,COL,WAS11,1,4,5
WAS201207080,2012,120708,WAS,COL,WAS11,4,3,7
WAS201207170,2012,120717,WAS,NYN,WAS11,4,5,9
WAS201207180,2012,120718,WAS,NYN,WAS11,3,4,7
WAS201207190,2012,120719,WAS,NYN,WAS11,9,5,14
WAS201207200,2012,120720,WAS,ATL,WAS11,11,10,21
WAS201207211,2012,120721,WAS,ATL,WAS11,4,0,4
WAS201207212,2012,120721,WAS,ATL,WAS11,2,5,7
WAS201207220,2012,120722,WAS,ATL,WAS11,2,9,11
WAS201207310,2012,120731,WAS,PHI,WAS11,8,0,8
WAS201208010,2012,120801,WAS,PHI,WAS11,3,2,5
WAS201208020,2012,120802,WAS,PHI,WAS11,0,3,3
WAS201208031,2012,120803,WAS,MIA,WAS11,4,7,11
WAS201208032,2012,120803,WAS,MIA,WAS11,5,2,7
WAS201208040,2012,120804,WAS,MIA,WAS11,7,10,17
WAS201208050,2012,120805,WAS,MIA,WAS11,1,4,5
WAS201208170,2012,120817,WAS,NYN,WAS11,4,6,10
WAS201208180,2012,120818,WAS,NYN,WAS11,2,0,2
WAS201208190,2012,120819,WAS,NYN,WAS11,2,5,7
WAS201208200,2012,120820,WAS,ATL,WAS11,4,5,9
WAS201208210,2012,120821,WAS,ATL,WAS11,1,4,5
WAS201208220,2012,120822,WAS,ATL,WAS11,5,1,6
WAS201208300,2012,120830,WAS,SLN,WAS11,1,8,9
WAS201208310,2012,120831,WAS,SLN,WAS11,0,10,10
WAS201209010,2012,120901,WAS,SLN,WAS11,10,9,19
WAS201209020,2012,120902,WAS,SLN,WAS11,3,4,7
WAS201209030,2012,120903,WAS,CHN,WAS11,1,2,3
WAS201209040,2012,120904,WAS,CHN,WAS11,5,11,16
WAS201209050,2012,120905,WAS,CHN,WAS11,1,9,10
WAS201209060,2012,120906,WAS,CHN,WAS11,2,9,11
WAS201209070,2012,120907,WAS,MIA,WAS11,9,7,16
WAS201209080,2012,120908,WAS,MIA,WAS11,6,7,13
WAS201209090,2012,120909,WAS,MIA,WAS11,8,0,8
WAS201209191,2012,120919,WAS,LAN,WAS11,1,3,4
WAS201209192,2012,120919,WAS,LAN,WAS11,7,6,13
WAS201209200,2012,120920,WAS,LAN,WAS11,1,4,5
WAS201209210,2012,120921,WAS,MIL,WAS11,4,2,6
WAS201209220,2012,120922,WAS,MIL,WAS11,4,10,14
WAS201209230,2012,120923,WAS,MIL,WAS11,6,2,8
WAS201209240,2012,120924,WAS,MIL,WAS11,2,12,14
WAS201210010,2012,121001,WAS,PHI,WAS11,2,0,2
WAS201210020,2012,121002,WAS,PHI,WAS11,2,4,6
WAS201210030,2012,121003,WAS,PHI,WAS11,1,5,6
WAS201210100,2012,121010,WAS,SLN,WAS11,8,0,8
WAS201210110,2012,121011,WAS,SLN,WAS11,1,2,3
WAS201210120,2012,121012,WAS,SLN,WAS11,9,7,16
WAS201304010,2013,20130401,WAS,MIA,WAS11,0,2,2
WAS201304030,2013,20130403,WAS,MIA,WAS11,0,3,3
WAS201304040,2013,20130404,WAS,MIA,WAS11,1,6,7
WAS201304090,2013,20130409,WAS,CHA,WAS11,7,8,15
WAS201304100,2013,20130410,WAS,CHA,WAS11,2,5,7
WAS201304110,2013,20130411,WAS,CHA,WAS11,4,7,11
WAS201304120,2013,20130412,WAS,ATL,WAS11,6,4,10
WAS201304130,2013,20130413,WAS,ATL,WAS11,3,1,4
WAS201304140,2013,20130414,WAS,ATL,WAS11,9,0,9
WAS201304220,2013,20130422,WAS,SLN,WAS11,3,2,5
WAS201304230,2013,20130423,WAS,SLN,WAS11,2,0,2
WAS201304240,2013,20130424,WAS,SLN,WAS11,4,2,6
WAS201304250,2013,20130425,WAS,CIN,WAS11,1,8,9
WAS201304260,2013,20130426,WAS,CIN,WAS11,0,1,1
WAS201304270,2013,20130427,WAS,CIN,WAS11,3,6,9
WAS201304280,2013,20130428,WAS,CIN,WAS11,5,2,7
WAS201305080,2013,20130508,WAS,DET,WAS11,1,3,4
WAS201305090,2013,20130509,WAS,DET,WAS11,4,5,9
WAS201305100,2013,20130510,WAS,CHN,WAS11,3,7,10
WAS201305110,2013,20130511,WAS,CHN,WAS11,8,2,10
WAS201305120,2013,20130512,WAS,CHN,WAS11,2,1,3
WAS201305240,2013,20130524,WAS,PHI,WAS11,2,5,7
WAS201305250,2013,20130525,WAS,PHI,WAS11,5,3,8
WAS201305260,2013,20130526,WAS,PHI,WAS11,1,6,7
WAS201305270,2013,20130527,WAS,BAL,WAS11,6,2,8
WAS201305280,2013,20130528,WAS,BAL,WAS11,3,9,12
WAS201306040,2013,20130604,WAS,NYN,WAS11,2,3,5
WAS201306050,2013,20130605,WAS,NYN,WAS11,10,1,11
WAS201306080,2013,20130608,WAS,MIN,WAS11,4,3,7
WAS201306091,2013,20130609,WAS,MIN,WAS11,0,7,7
WAS201306092,2013,20130609,WAS,MIN,WAS11,4,5,9
WAS201306200,2013,20130620,WAS,COL,WAS11,1,5,6
WAS201306210,2013,20130621,WAS,COL,WAS11,1,2,3
WAS201306220,2013,20130622,WAS,COL,WAS11,7,1,8
WAS201306230,2013,20130623,WAS,COL,WAS11,7,6,13
WAS201306250,2013,20130625,WAS,ARI,WAS11,5,7,12
WAS201306260,2013,20130626,WAS,ARI,WAS11,2,3,5
WAS201306270,2013,20130627,WAS,ARI,WAS11,3,2,5
WAS201307010,2013,20130701,WAS,MIL,WAS11,5,10,15
WAS201307020,2013,20130702,WAS,MIL,WAS11,4,0,4
WAS201307030,2013,20130703,WAS,MIL,WAS11,4,1,5
WAS201307040,2013,20130704,WAS,MIL,WAS11,5,8,13
WAS201307050,2013,20130705,WAS,SDN,WAS11,5,8,13
WAS201307060,2013,20130706,WAS,SDN,WAS11,4,5,9
WAS201307070,2013,20130707,WAS,SDN,WAS11,7,11,18
WAS201307190,2013,20130719,WAS,LAN,WAS11,3,2,5
WAS201307200,2013,20130720,WAS,LAN,WAS11,3,1,4
WAS201307210,2013,20130721,WAS,LAN,WAS11,9,2,11
WAS201307220,2013,20130722,WAS,PIT,WAS11,6,5,11
WAS201307230,2013,20130723,WAS,PIT,WAS11,5,1,6
WAS201307240,2013,20130724,WAS,PIT,WAS11,4,2,6
WAS201307250,2013,20130725,WAS,PIT,WAS11,7,9,16
WAS201307261,2013,20130726,WAS,NYN,WAS11,11,0,11
WAS201307262,2013,20130726,WAS,NYN,WAS11,1,2,3
WAS201307270,2013,20130727,WAS,NYN,WAS11,1,4,5
WAS201307280,2013,20130728,WAS,NYN,WAS11,1,14,15
WAS201308050,2013,20130805,WAS,ATL,WAS11,3,2,5
WAS201308060,2013,20130806,WAS,ATL,WAS11,2,1,3
WAS201308070,2013,20130807,WAS,ATL,WAS11,6,3,9
WAS201308090,2013,20130809,WAS,PHI,WAS11,2,9,11
WAS201308100,2013,20130810,WAS,PHI,WAS11,5,8,13
WAS201308110,2013,20130811,WAS,PHI,WAS11,0,6,6
WAS201308130,2013,20130813,WAS,SFN,WAS11,2,4,6
WAS201308140,2013,20130814,WAS,SFN,WAS11,5,6,11
WAS201308150,2013,20130815,WAS,SFN,WAS11,4,3,7
WAS201308270,2013,20130827,WAS,MIA,WAS11,1,2,3
WAS201308280,2013,20130828,WAS,MIA,WAS11,3,4,7
WAS201308290,2013,20130829,WAS,MIA,WAS11,0,9,9
WAS201308300,2013,20130830,WAS,NYN,WAS11,3,2,5
WAS201308310,2013,20130831,WAS,NYN,WAS11,11,3,14
WAS201309010,2013,20130901,WAS,NYN,WAS11,5,6,11
WAS201309130,2013,20130913,WAS,PHI,WAS11,1,6,7
WAS201309140,2013,20130914,WAS,PHI,WAS11,5,4,9
WAS201309150,2013,20130915,WAS,PHI,WAS11,2,11,13
WAS201309171,2013,20130917,WAS,ATL,WAS11,5,6,11
WAS201309172,2013,20130917,WAS,ATL,WAS11,0,4,4
WAS201309180,2013,20130918,WAS,ATL,WAS11,5,2,7
WAS201309190,2013,20130919,WAS,MIA,WAS11,2,3,5
WAS201309200,2013,20130920,WAS,MIA,WAS11,0,8,8
WAS201309221,2013,20130922,WAS,MIA,WAS11,4,2,6
WAS201309222,2013,20130922,WAS,MIA,WAS11,4,5,9
