game_id,year_id,game_dt,homeTeam,awayTeam,ballpark,awayScore,homeScore,totalRuns
ANA200004030,2000,403,ANA,NYA,ANA01,3,2,5
ANA200004040,2000,404,ANA,NYA,ANA01,5,3,8
ANA200004050,2000,405,ANA,NYA,ANA01,6,12,18
ANA200004070,2000,407,ANA,BOS,ANA01,3,7,10
ANA200004080,2000,408,ANA,BOS,ANA01,5,7,12
ANA200004090,2000,409,ANA,BOS,ANA01,5,2,7
ANA200004100,2000,410,ANA,TOR,ANA01,0,6,6
ANA200004110,2000,411,ANA,TOR,ANA01,4,5,9
ANA200004120,2000,412,ANA,TOR,ANA01,6,2,8
ANA200004240,2000,424,ANA,DET,ANA01,4,10,14
ANA200004250,2000,425,ANA,DET,ANA01,4,2,6
ANA200004260,2000,426,ANA,DET,ANA01,1,6,7
ANA200004270,2000,427,ANA,TBA,ANA01,7,3,10
ANA200004280,2000,428,ANA,TBA,ANA01,11,2,13
ANA200004290,2000,429,ANA,TBA,ANA01,6,7,13
ANA200004300,2000,430,ANA,TBA,ANA01,2,5,7
ANA200005080,2000,508,ANA,OAK,ANA01,8,9,17
ANA200005090,2000,509,ANA,OAK,ANA01,5,2,7
ANA200005100,2000,510,ANA,OAK,ANA01,7,4,11
ANA200005110,2000,511,ANA,TEX,ANA01,2,3,5
ANA200005120,2000,512,ANA,TEX,ANA01,13,11,24
ANA200005130,2000,513,ANA,TEX,ANA01,6,5,11
ANA200005140,2000,514,ANA,TEX,ANA01,6,7,13
ANA200005160,2000,516,ANA,BAL,ANA01,4,3,7
ANA200005170,2000,517,ANA,BAL,ANA01,7,8,15
ANA200005190,2000,519,ANA,KCA,ANA01,4,6,10
ANA200005200,2000,520,ANA,KCA,ANA01,8,9,17
ANA200005210,2000,521,ANA,KCA,ANA01,10,6,16
ANA200006020,2000,602,ANA,LAN,ANA01,5,12,17
ANA200006030,2000,603,ANA,LAN,ANA01,8,3,11
ANA200006040,2000,604,ANA,LAN,ANA01,7,8,15
ANA200006050,2000,605,ANA,SFN,ANA01,5,4,9
ANA200006060,2000,606,ANA,SFN,ANA01,5,6,11
ANA200006070,2000,607,ANA,SFN,ANA01,9,10,19
ANA200006200,2000,620,ANA,KCA,ANA01,8,6,14
ANA200006210,2000,621,ANA,KCA,ANA01,1,3,4
ANA200006220,2000,622,ANA,KCA,ANA01,3,4,7
ANA200006230,2000,623,ANA,MIN,ANA01,3,8,11
ANA200006240,2000,624,ANA,MIN,ANA01,11,5,16
ANA200006250,2000,625,ANA,MIN,ANA01,6,7,13
ANA200006260,2000,626,ANA,MIN,ANA01,10,6,16
ANA200006300,2000,630,ANA,OAK,ANA01,0,7,7
ANA200007010,2000,701,ANA,OAK,ANA01,2,7,9
ANA200007020,2000,702,ANA,OAK,ANA01,10,3,13
ANA200007030,2000,703,ANA,SEA,ANA01,8,6,14
ANA200007040,2000,704,ANA,SEA,ANA01,6,7,13
ANA200007050,2000,705,ANA,SEA,ANA01,6,4,10
ANA200007060,2000,706,ANA,SEA,ANA01,1,5,6
ANA200007070,2000,707,ANA,COL,ANA01,4,12,16
ANA200007080,2000,708,ANA,COL,ANA01,2,6,8
ANA200007090,2000,709,ANA,COL,ANA01,4,10,14
ANA200007190,2000,719,ANA,TEX,ANA01,3,2,5
ANA200007200,2000,720,ANA,TEX,ANA01,1,6,7
ANA200007270,2000,727,ANA,CHA,ANA01,6,5,11
ANA200007280,2000,728,ANA,CHA,ANA01,7,10,17
ANA200007290,2000,729,ANA,CHA,ANA01,5,6,11
ANA200007300,2000,730,ANA,CHA,ANA01,11,7,18
ANA200007310,2000,731,ANA,DET,ANA01,4,5,9
ANA200008010,2000,801,ANA,DET,ANA01,6,3,9
ANA200008020,2000,802,ANA,DET,ANA01,5,3,8
ANA200008070,2000,807,ANA,BOS,ANA01,1,4,5
ANA200008080,2000,808,ANA,BOS,ANA01,1,2,3
ANA200008090,2000,809,ANA,BOS,ANA01,4,2,6
ANA200008110,2000,811,ANA,NYA,ANA01,3,8,11
ANA200008120,2000,812,ANA,NYA,ANA01,6,9,15
ANA200008130,2000,813,ANA,NYA,ANA01,4,1,5
ANA200008250,2000,825,ANA,CLE,ANA01,1,4,5
ANA200008260,2000,826,ANA,CLE,ANA01,9,5,14
ANA200008270,2000,827,ANA,CLE,ANA01,9,10,19
ANA200008280,2000,828,ANA,TOR,ANA01,4,2,6
ANA200008290,2000,829,ANA,TOR,ANA01,4,9,13
ANA200008300,2000,830,ANA,TOR,ANA01,11,2,13
ANA200009080,2000,908,ANA,BAL,ANA01,1,2,3
ANA200009090,2000,909,ANA,BAL,ANA01,10,3,13
ANA200009100,2000,910,ANA,BAL,ANA01,1,2,3
ANA200009110,2000,911,ANA,BAL,ANA01,3,1,4
ANA200009120,2000,912,ANA,TBA,ANA01,2,5,7
ANA200009130,2000,913,ANA,TBA,ANA01,4,8,12
ANA200009290,2000,929,ANA,SEA,ANA01,3,9,12
ANA200009300,2000,930,ANA,SEA,ANA01,21,9,30
ANA200010010,2000,1001,ANA,SEA,ANA01,5,2,7
ANA200104100,2001,10410,ANA,TEX,ANA01,7,5,12
ANA200104110,2001,10411,ANA,TEX,ANA01,2,7,9
ANA200104120,2001,10412,ANA,TEX,ANA01,3,13,16
ANA200104130,2001,10413,ANA,SEA,ANA01,3,4,7
ANA200104140,2001,10414,ANA,SEA,ANA01,2,1,3
ANA200104150,2001,10415,ANA,SEA,ANA01,7,5,12
ANA200104160,2001,10416,ANA,OAK,ANA01,6,3,9
ANA200104170,2001,10417,ANA,OAK,ANA01,5,1,6
ANA200104180,2001,10418,ANA,OAK,ANA01,2,3,5
ANA200105010,2001,10501,ANA,CHA,ANA01,4,6,10
ANA200105020,2001,10502,ANA,CHA,ANA01,5,12,17
ANA200105030,2001,10503,ANA,CHA,ANA01,1,3,4
ANA200105040,2001,10504,ANA,DET,ANA01,5,7,12
ANA200105050,2001,10505,ANA,DET,ANA01,11,2,13
ANA200105060,2001,10506,ANA,DET,ANA01,2,3,5
ANA200105150,2001,10515,ANA,TOR,ANA01,9,3,12
ANA200105160,2001,10516,ANA,TOR,ANA01,1,3,4
ANA200105170,2001,10517,ANA,TOR,ANA01,2,4,6
ANA200105180,2001,10518,ANA,CLE,ANA01,7,2,9
ANA200105190,2001,10519,ANA,CLE,ANA01,4,3,7
ANA200105200,2001,10520,ANA,CLE,ANA01,6,9,15
ANA200105290,2001,10529,ANA,MIN,ANA01,6,5,11
ANA200105300,2001,10530,ANA,MIN,ANA01,3,0,3
ANA200105310,2001,10531,ANA,MIN,ANA01,4,5,9
ANA200106010,2001,10601,ANA,KCA,ANA01,1,7,8
ANA200106020,2001,10602,ANA,KCA,ANA01,2,3,5
ANA200106030,2001,10603,ANA,KCA,ANA01,2,7,9
ANA200106050,2001,10605,ANA,OAK,ANA01,3,7,10
ANA200106060,2001,10606,ANA,OAK,ANA01,4,1,5
ANA200106070,2001,10607,ANA,OAK,ANA01,4,6,10
ANA200106150,2001,10615,ANA,LAN,ANA01,6,2,8
ANA200106160,2001,10616,ANA,LAN,ANA01,5,6,11
ANA200106170,2001,10617,ANA,LAN,ANA01,4,6,10
ANA200106250,2001,10625,ANA,TEX,ANA01,7,11,18
ANA200106260,2001,10626,ANA,TEX,ANA01,8,1,9
ANA200106270,2001,10627,ANA,TEX,ANA01,2,4,6
ANA200106280,2001,10628,ANA,TEX,ANA01,6,3,9
ANA200106290,2001,10629,ANA,SEA,ANA01,9,5,14
ANA200106300,2001,10630,ANA,SEA,ANA01,5,3,8
ANA200107010,2001,10701,ANA,SEA,ANA01,5,0,5
ANA200107120,2001,10712,ANA,ARI,ANA01,1,4,5
ANA200107130,2001,10713,ANA,ARI,ANA01,6,2,8
ANA200107140,2001,10714,ANA,ARI,ANA01,7,5,12
ANA200107150,2001,10715,ANA,SDN,ANA01,5,1,6
ANA200107160,2001,10716,ANA,SDN,ANA01,5,7,12
ANA200107170,2001,10717,ANA,SDN,ANA01,7,8,15
ANA200107240,2001,10724,ANA,TBA,ANA01,6,9,15
ANA200107250,2001,10725,ANA,TBA,ANA01,3,1,4
ANA200107260,2001,10726,ANA,TBA,ANA01,3,5,8
ANA200107270,2001,10727,ANA,BAL,ANA01,4,3,7
ANA200107280,2001,10728,ANA,BAL,ANA01,4,6,10
ANA200107290,2001,10729,ANA,BAL,ANA01,1,0,1
ANA200108070,2001,10807,ANA,CHA,ANA01,3,9,12
ANA200108080,2001,10808,ANA,CHA,ANA01,15,1,16
ANA200108090,2001,10809,ANA,CHA,ANA01,2,3,5
ANA200108100,2001,10810,ANA,TOR,ANA01,7,8,15
ANA200108110,2001,10811,ANA,TOR,ANA01,7,6,13
ANA200108120,2001,10812,ANA,TOR,ANA01,5,6,11
ANA200108200,2001,10820,ANA,BOS,ANA01,6,1,7
ANA200108210,2001,10821,ANA,BOS,ANA01,8,5,13
ANA200108220,2001,10822,ANA,BOS,ANA01,2,4,6
ANA200108230,2001,10823,ANA,BOS,ANA01,7,6,13
ANA200108240,2001,10824,ANA,NYA,ANA01,2,6,8
ANA200108250,2001,10825,ANA,NYA,ANA01,7,5,12
ANA200108260,2001,10826,ANA,NYA,ANA01,6,7,13
ANA200109040,2001,10904,ANA,KCA,ANA01,4,1,5
ANA200109050,2001,10905,ANA,KCA,ANA01,1,4,5
ANA200109060,2001,10906,ANA,KCA,ANA01,6,7,13
ANA200109070,2001,10907,ANA,MIN,ANA01,3,7,10
ANA200109080,2001,10908,ANA,MIN,ANA01,6,4,10
ANA200109090,2001,10909,ANA,MIN,ANA01,3,0,3
ANA200109100,2001,10910,ANA,SEA,ANA01,5,1,6
ANA200109280,2001,10928,ANA,TEX,ANA01,11,2,13
ANA200109290,2001,10929,ANA,TEX,ANA01,2,13,15
ANA200109300,2001,10930,ANA,TEX,ANA01,8,6,14
ANA200110020,2001,11002,ANA,SEA,ANA01,14,5,19
ANA200110030,2001,11003,ANA,SEA,ANA01,4,3,7
ANA200110040,2001,11004,ANA,OAK,ANA01,5,1,6
ANA200110050,2001,11005,ANA,OAK,ANA01,6,2,8
ANA200110060,2001,11006,ANA,OAK,ANA01,6,3,9
ANA200110070,2001,11007,ANA,OAK,ANA01,6,2,8
ANA200203310,2002,20331,ANA,CLE,ANA01,6,0,6
ANA200204020,2002,20402,ANA,CLE,ANA01,5,7,12
ANA200204030,2002,20403,ANA,CLE,ANA01,6,5,11
ANA200204080,2002,20408,ANA,SEA,ANA01,5,4,9
ANA200204090,2002,20409,ANA,SEA,ANA01,5,1,6
ANA200204100,2002,20410,ANA,SEA,ANA01,8,1,9
ANA200204110,2002,20411,ANA,SEA,ANA01,8,4,12
ANA200204120,2002,20412,ANA,OAK,ANA01,5,1,6
ANA200204130,2002,20413,ANA,OAK,ANA01,7,2,9
ANA200204140,2002,20414,ANA,OAK,ANA01,1,4,5
ANA200204160,2002,20416,ANA,TEX,ANA01,5,6,11
ANA200204170,2002,20417,ANA,TEX,ANA01,4,1,5
ANA200204260,2002,20426,ANA,TOR,ANA01,0,4,4
ANA200204270,2002,20427,ANA,TOR,ANA01,4,11,15
ANA200204280,2002,20428,ANA,TOR,ANA01,5,8,13
ANA200205070,2002,20507,ANA,DET,ANA01,3,0,3
ANA200205080,2002,20508,ANA,DET,ANA01,2,3,5
ANA200205090,2002,20509,ANA,DET,ANA01,6,7,13
ANA200205100,2002,20510,ANA,CHA,ANA01,0,19,19
ANA200205110,2002,20511,ANA,CHA,ANA01,3,6,9
ANA200205120,2002,20512,ANA,CHA,ANA01,4,5,9
ANA200205200,2002,20520,ANA,KCA,ANA01,3,6,9
ANA200205210,2002,20521,ANA,KCA,ANA01,1,5,6
ANA200205220,2002,20522,ANA,KCA,ANA01,6,7,13
ANA200205240,2002,20524,ANA,MIN,ANA01,5,1,6
ANA200205250,2002,20525,ANA,MIN,ANA01,3,4,7
ANA200205260,2002,20526,ANA,MIN,ANA01,5,2,7
ANA200206030,2002,20603,ANA,TEX,ANA01,2,5,7
ANA200206040,2002,20604,ANA,TEX,ANA01,0,3,3
ANA200206050,2002,20605,ANA,TEX,ANA01,5,7,12
ANA200206060,2002,20606,ANA,TEX,ANA01,9,8,17
ANA200206070,2002,20607,ANA,CIN,ANA01,3,4,7
ANA200206080,2002,20608,ANA,CIN,ANA01,4,3,7
ANA200206090,2002,20609,ANA,CIN,ANA01,4,7,11
ANA200206100,2002,20610,ANA,PIT,ANA01,3,4,7
ANA200206110,2002,20611,ANA,PIT,ANA01,7,3,10
ANA200206120,2002,20612,ANA,PIT,ANA01,5,8,13
ANA200206280,2002,20628,ANA,LAN,ANA01,7,5,12
ANA200206290,2002,20629,ANA,LAN,ANA01,0,7,7
ANA200206300,2002,20630,ANA,LAN,ANA01,1,5,6
ANA200207020,2002,20702,ANA,BAL,ANA01,3,0,3
ANA200207030,2002,20703,ANA,BAL,ANA01,0,1,1
ANA200207040,2002,20704,ANA,BAL,ANA01,7,2,9
ANA200207050,2002,20705,ANA,TBA,ANA01,5,6,11
ANA200207060,2002,20706,ANA,TBA,ANA01,3,4,7
ANA200207070,2002,20707,ANA,TBA,ANA01,1,2,3
ANA200207190,2002,20719,ANA,SEA,ANA01,3,15,18
ANA200207200,2002,20720,ANA,SEA,ANA01,6,7,13
ANA200207210,2002,20721,ANA,SEA,ANA01,5,7,12
ANA200207230,2002,20723,ANA,OAK,ANA01,2,1,3
ANA200207240,2002,20724,ANA,OAK,ANA01,1,5,6
ANA200207250,2002,20725,ANA,OAK,ANA01,4,5,9
ANA200207290,2002,20729,ANA,BOS,ANA01,4,5,9
ANA200207300,2002,20730,ANA,BOS,ANA01,6,0,6
ANA200207310,2002,20731,ANA,BOS,ANA01,2,1,3
ANA200208010,2002,20801,ANA,NYA,ANA01,1,2,3
ANA200208020,2002,20802,ANA,NYA,ANA01,4,0,4
ANA200208030,2002,20803,ANA,NYA,ANA01,4,5,9
ANA200208040,2002,20804,ANA,NYA,ANA01,7,5,12
ANA200208120,2002,20812,ANA,DET,ANA01,0,7,7
ANA200208130,2002,20813,ANA,DET,ANA01,6,7,13
ANA200208140,2002,20814,ANA,DET,ANA01,4,5,9
ANA200208160,2002,20816,ANA,CLE,ANA01,4,5,9
ANA200208170,2002,20817,ANA,CLE,ANA01,9,4,13
ANA200208180,2002,20818,ANA,CLE,ANA01,1,4,5
ANA200208270,2002,20827,ANA,TBA,ANA01,3,7,10
ANA200208280,2002,20828,ANA,TBA,ANA01,8,5,13
ANA200208290,2002,20829,ANA,TBA,ANA01,1,6,7
ANA200208300,2002,20830,ANA,BAL,ANA01,2,6,8
ANA200208310,2002,20831,ANA,BAL,ANA01,0,9,9
ANA200209010,2002,20901,ANA,BAL,ANA01,3,9,12
ANA200209090,2002,20909,ANA,OAK,ANA01,2,1,3
ANA200209100,2002,20910,ANA,OAK,ANA01,2,5,7
ANA200209110,2002,20911,ANA,OAK,ANA01,5,6,11
ANA200209120,2002,20912,ANA,OAK,ANA01,6,7,13
ANA200209130,2002,20913,ANA,TEX,ANA01,2,3,5
ANA200209140,2002,20914,ANA,TEX,ANA01,6,8,14
ANA200209150,2002,20915,ANA,TEX,ANA01,4,13,17
ANA200209270,2002,20927,ANA,SEA,ANA01,7,6,13
ANA200209280,2002,20928,ANA,SEA,ANA01,4,8,12
ANA200209290,2002,20929,ANA,SEA,ANA01,6,7,13
ANA200210040,2002,21004,ANA,NYA,ANA01,6,9,15
ANA200210050,2002,21005,ANA,NYA,ANA01,5,9,14
ANA200210110,2002,21011,ANA,MIN,ANA01,1,2,3
ANA200210120,2002,21012,ANA,MIN,ANA01,1,7,8
ANA200210130,2002,21013,ANA,MIN,ANA01,5,13,18
ANA200210190,2002,21019,ANA,SFN,ANA01,4,3,7
ANA200210200,2002,21020,ANA,SFN,ANA01,10,11,21
ANA200210260,2002,21026,ANA,SFN,ANA01,5,6,11
ANA200210270,2002,21027,ANA,SFN,ANA01,1,4,5
ANA200303300,2003,30330,ANA,TEX,ANA01,6,3,9
ANA200304010,2003,30401,ANA,TEX,ANA01,0,10,10
ANA200304020,2003,30402,ANA,TEX,ANA01,5,11,16
ANA200304110,2003,30411,ANA,OAK,ANA01,5,9,14
ANA200304120,2003,30412,ANA,OAK,ANA01,4,9,13
ANA200304130,2003,30413,ANA,OAK,ANA01,2,8,10
ANA200304180,2003,30418,ANA,SEA,ANA01,8,2,10
ANA200304190,2003,30419,ANA,SEA,ANA01,6,7,13
ANA200304200,2003,30420,ANA,SEA,ANA01,7,6,13
ANA200304220,2003,30422,ANA,NYA,ANA01,8,3,11
ANA200304230,2003,30423,ANA,NYA,ANA01,9,2,11
ANA200304240,2003,30424,ANA,NYA,ANA01,2,6,8
ANA200304250,2003,30425,ANA,BOS,ANA01,5,2,7
ANA200304260,2003,30426,ANA,BOS,ANA01,1,3,4
ANA200304270,2003,30427,ANA,BOS,ANA01,6,4,10
ANA200305060,2003,30506,ANA,CLE,ANA01,1,6,7
ANA200305070,2003,30507,ANA,CLE,ANA01,5,6,11
ANA200305080,2003,30508,ANA,CLE,ANA01,1,7,8
ANA200305090,2003,30509,ANA,TOR,ANA01,1,6,7
ANA200305100,2003,30510,ANA,TOR,ANA01,7,4,11
ANA200305110,2003,30511,ANA,TOR,ANA01,4,2,6
ANA200305200,2003,30520,ANA,BAL,ANA01,6,7,13
ANA200305210,2003,30521,ANA,BAL,ANA01,7,6,13
ANA200305220,2003,30522,ANA,BAL,ANA01,7,4,11
ANA200305230,2003,30523,ANA,TBA,ANA01,3,1,4
ANA200305240,2003,30524,ANA,TBA,ANA01,2,7,9
ANA200305250,2003,30525,ANA,TBA,ANA01,1,6,7
ANA200306090,2003,30609,ANA,PHI,ANA01,3,0,3
ANA200306100,2003,30610,ANA,PHI,ANA01,1,2,3
ANA200306110,2003,30611,ANA,PHI,ANA01,3,5,8
ANA200306130,2003,30613,ANA,NYN,ANA01,7,3,10
ANA200306140,2003,30614,ANA,NYN,ANA01,3,13,16
ANA200306150,2003,30615,ANA,NYN,ANA01,8,0,8
ANA200306240,2003,30624,ANA,SEA,ANA01,6,4,10
ANA200306250,2003,30625,ANA,SEA,ANA01,3,6,9
ANA200306260,2003,30626,ANA,SEA,ANA01,10,6,16
ANA200306270,2003,30627,ANA,LAN,ANA01,0,3,3
ANA200306280,2003,30628,ANA,LAN,ANA01,1,3,4
ANA200306290,2003,30629,ANA,LAN,ANA01,1,3,4
ANA200306300,2003,30630,ANA,TEX,ANA01,6,3,9
ANA200307010,2003,30701,ANA,TEX,ANA01,5,7,12
ANA200307020,2003,30702,ANA,TEX,ANA01,0,5,5
ANA200307030,2003,30703,ANA,TEX,ANA01,6,5,11
ANA200307080,2003,30708,ANA,KCA,ANA01,4,0,4
ANA200307090,2003,30709,ANA,KCA,ANA01,3,5,8
ANA200307100,2003,30710,ANA,KCA,ANA01,1,7,8
ANA200307110,2003,30711,ANA,MIN,ANA01,0,5,5
ANA200307120,2003,30712,ANA,MIN,ANA01,1,6,7
ANA200307130,2003,30713,ANA,MIN,ANA01,3,8,11
ANA200307250,2003,30725,ANA,OAK,ANA01,3,2,5
ANA200307260,2003,30726,ANA,OAK,ANA01,8,1,9
ANA200307270,2003,30727,ANA,OAK,ANA01,10,1,11
ANA200307280,2003,30728,ANA,OAK,ANA01,1,2,3
ANA200307290,2003,30729,ANA,NYA,ANA01,6,2,8
ANA200307300,2003,30730,ANA,NYA,ANA01,8,0,8
ANA200307310,2003,30731,ANA,NYA,ANA01,2,1,3
ANA200308010,2003,30801,ANA,TOR,ANA01,0,5,5
ANA200308020,2003,30802,ANA,TOR,ANA01,6,1,7
ANA200308030,2003,30803,ANA,TOR,ANA01,4,0,4
ANA200308110,2003,30811,ANA,CHA,ANA01,8,10,18
ANA200308120,2003,30812,ANA,CHA,ANA01,10,4,14
ANA200308130,2003,30813,ANA,CHA,ANA01,1,2,3
ANA200308140,2003,30814,ANA,CHA,ANA01,1,5,6
ANA200308150,2003,30815,ANA,DET,ANA01,1,3,4
ANA200308160,2003,30816,ANA,DET,ANA01,7,11,18
ANA200308170,2003,30817,ANA,DET,ANA01,6,11,17
ANA200308260,2003,30826,ANA,MIN,ANA01,3,0,3
ANA200308270,2003,30827,ANA,MIN,ANA01,4,5,9
ANA200308280,2003,30828,ANA,MIN,ANA01,6,1,7
ANA200309050,2003,30905,ANA,KCA,ANA01,5,0,5
ANA200309061,2003,30906,ANA,KCA,ANA01,5,6,11
ANA200309062,2003,30906,ANA,KCA,ANA01,1,3,4
ANA200309070,2003,30907,ANA,KCA,ANA01,3,0,3
ANA200309150,2003,30915,ANA,OAK,ANA01,7,4,11
ANA200309160,2003,30916,ANA,OAK,ANA01,5,6,11
ANA200309170,2003,30917,ANA,OAK,ANA01,2,1,3
ANA200309220,2003,30922,ANA,SEA,ANA01,5,1,6
ANA200309230,2003,30923,ANA,SEA,ANA01,1,2,3
ANA200309240,2003,30924,ANA,SEA,ANA01,0,4,4
ANA200309260,2003,30926,ANA,TEX,ANA01,3,5,8
ANA200309270,2003,30927,ANA,TEX,ANA01,12,3,15
ANA200309280,2003,30928,ANA,TEX,ANA01,1,4,5
ANA200404130,2004,40413,ANA,SEA,ANA01,5,7,12
ANA200404140,2004,40414,ANA,SEA,ANA01,5,6,11
ANA200404150,2004,40415,ANA,SEA,ANA01,6,2,8
ANA200404160,2004,40416,ANA,OAK,ANA01,3,0,3
ANA200404170,2004,40417,ANA,OAK,ANA01,3,6,9
ANA200404180,2004,40418,ANA,OAK,ANA01,7,1,8
ANA200404200,2004,40420,ANA,TEX,ANA01,6,3,9
ANA200404210,2004,40421,ANA,TEX,ANA01,4,1,5
ANA200404220,2004,40422,ANA,TEX,ANA01,5,7,12
ANA200405030,2004,40503,ANA,DET,ANA01,9,11,20
ANA200405040,2004,40504,ANA,DET,ANA01,4,11,15
ANA200405050,2004,40505,ANA,DET,ANA01,3,6,9
ANA200405060,2004,40506,ANA,TBA,ANA01,3,7,10
ANA200405070,2004,40507,ANA,TBA,ANA01,0,1,1
ANA200405080,2004,40508,ANA,TBA,ANA01,2,7,9
ANA200405090,2004,40509,ANA,TBA,ANA01,4,8,12
ANA200405180,2004,40518,ANA,NYA,ANA01,0,1,1
ANA200405190,2004,40519,ANA,NYA,ANA01,4,2,6
ANA200405200,2004,40520,ANA,NYA,ANA01,6,2,8
ANA200405210,2004,40521,ANA,BAL,ANA01,3,5,8
ANA200405220,2004,40522,ANA,BAL,ANA01,2,3,5
ANA200405230,2004,40523,ANA,BAL,ANA01,3,8,11
ANA200406010,2004,40601,ANA,BOS,ANA01,6,7,13
ANA200406020,2004,40602,ANA,BOS,ANA01,7,10,17
ANA200406030,2004,40603,ANA,CLE,ANA01,2,5,7
ANA200406040,2004,40604,ANA,CLE,ANA01,9,6,15
ANA200406050,2004,40605,ANA,CLE,ANA01,3,2,5
ANA200406060,2004,40606,ANA,CLE,ANA01,7,0,7
ANA200406080,2004,40608,ANA,MIL,ANA01,1,0,1
ANA200406090,2004,40609,ANA,MIL,ANA01,12,2,14
ANA200406100,2004,40610,ANA,MIL,ANA01,4,5,9
ANA200406110,2004,40611,ANA,CHN,ANA01,2,3,5
ANA200406120,2004,40612,ANA,CHN,ANA01,10,5,15
ANA200406130,2004,40613,ANA,CHN,ANA01,6,5,11
ANA200406210,2004,40621,ANA,OAK,ANA01,3,10,13
ANA200406220,2004,40622,ANA,OAK,ANA01,1,6,7
ANA200406230,2004,40623,ANA,OAK,ANA01,7,1,8
ANA200406240,2004,40624,ANA,OAK,ANA01,2,1,3
ANA200407020,2004,40702,ANA,LAN,ANA01,3,7,10
ANA200407030,2004,40703,ANA,LAN,ANA01,8,5,13
ANA200407040,2004,40704,ANA,LAN,ANA01,6,2,8
ANA200407150,2004,40715,ANA,BOS,ANA01,1,8,9
ANA200407160,2004,40716,ANA,BOS,ANA01,4,2,6
ANA200407170,2004,40717,ANA,BOS,ANA01,3,8,11
ANA200407180,2004,40718,ANA,BOS,ANA01,6,2,8
ANA200407190,2004,40719,ANA,CLE,ANA01,8,5,13
ANA200407200,2004,40720,ANA,CLE,ANA01,14,5,19
ANA200407260,2004,40726,ANA,TEX,ANA01,6,1,7
ANA200407270,2004,40727,ANA,TEX,ANA01,0,2,2
ANA200407280,2004,40728,ANA,TEX,ANA01,0,2,2
ANA200407290,2004,40729,ANA,SEA,ANA01,6,5,11
ANA200407300,2004,40730,ANA,SEA,ANA01,5,6,11
ANA200407310,2004,40731,ANA,SEA,ANA01,8,9,17
ANA200408010,2004,40801,ANA,SEA,ANA01,2,3,5
ANA200408100,2004,40810,ANA,BAL,ANA01,11,3,14
ANA200408110,2004,40811,ANA,BAL,ANA01,2,4,6
ANA200408120,2004,40812,ANA,BAL,ANA01,6,1,7
ANA200408130,2004,40813,ANA,DET,ANA01,5,3,8
ANA200408140,2004,40814,ANA,DET,ANA01,8,11,19
ANA200408150,2004,40815,ANA,DET,ANA01,2,3,5
ANA200408230,2004,40823,ANA,KCA,ANA01,4,9,13
ANA200408240,2004,40824,ANA,KCA,ANA01,5,7,12
ANA200408250,2004,40825,ANA,KCA,ANA01,6,21,27
ANA200408270,2004,40827,ANA,MIN,ANA01,6,9,15
ANA200408280,2004,40828,ANA,MIN,ANA01,7,1,8
ANA200408290,2004,40829,ANA,MIN,ANA01,2,4,6
ANA200409070,2004,40907,ANA,TOR,ANA01,2,5,7
ANA200409080,2004,40908,ANA,TOR,ANA01,1,0,1
ANA200409090,2004,40909,ANA,TOR,ANA01,5,4,9
ANA200409100,2004,40910,ANA,CHA,ANA01,5,7,12
ANA200409110,2004,40911,ANA,CHA,ANA01,13,6,19
ANA200409120,2004,40912,ANA,CHA,ANA01,0,11,11
ANA200409170,2004,40917,ANA,TEX,ANA01,5,9,14
ANA200409180,2004,40918,ANA,TEX,ANA01,2,0,2
ANA200409190,2004,40919,ANA,TEX,ANA01,1,0,1
ANA200409200,2004,40920,ANA,SEA,ANA01,2,5,7
ANA200409210,2004,40921,ANA,SEA,ANA01,7,3,10
ANA200409220,2004,40922,ANA,SEA,ANA01,16,6,22
ANA200409240,2004,40924,ANA,OAK,ANA01,6,3,9
ANA200409250,2004,40925,ANA,OAK,ANA01,3,5,8
ANA200409260,2004,40926,ANA,OAK,ANA01,2,6,8
ANA200410050,2004,41005,ANA,BOS,ANA01,9,3,12
ANA200410060,2004,41006,ANA,BOS,ANA01,8,3,11
ANA200504050,2005,50405,ANA,TEX,ANA01,2,3,5
ANA200504060,2005,50406,ANA,TEX,ANA01,3,2,5
ANA200504070,2005,50407,ANA,TEX,ANA01,6,7,13
ANA200504080,2005,50408,ANA,KCA,ANA01,6,2,8
ANA200504090,2005,50409,ANA,KCA,ANA01,3,8,11
ANA200504100,2005,50410,ANA,KCA,ANA01,8,3,11
ANA200504180,2005,50418,ANA,SEA,ANA01,1,6,7
ANA200504190,2005,50419,ANA,SEA,ANA01,5,3,8
ANA200504200,2005,50420,ANA,CLE,ANA01,0,2,2
ANA200504210,2005,50421,ANA,CLE,ANA01,5,6,11
ANA200504220,2005,50422,ANA,OAK,ANA01,4,3,7
ANA200504230,2005,50423,ANA,OAK,ANA01,5,9,14
ANA200504240,2005,50424,ANA,OAK,ANA01,0,1,1
ANA200505060,2005,50506,ANA,DET,ANA01,3,4,7
ANA200505070,2005,50507,ANA,DET,ANA01,2,1,3
ANA200505080,2005,50508,ANA,DET,ANA01,10,1,11
ANA200505090,2005,50509,ANA,CLE,ANA01,3,0,3
ANA200505100,2005,50510,ANA,CLE,ANA01,4,5,9
ANA200505110,2005,50511,ANA,CLE,ANA01,9,3,12
ANA200505230,2005,50523,ANA,CHA,ANA01,0,4,4
ANA200505240,2005,50524,ANA,CHA,ANA01,2,1,3
ANA200505250,2005,50525,ANA,CHA,ANA01,4,2,6
ANA200505260,2005,50526,ANA,CHA,ANA01,2,3,5
ANA200505270,2005,50527,ANA,KCA,ANA01,8,9,17
ANA200505280,2005,50528,ANA,KCA,ANA01,1,14,15
ANA200505290,2005,50529,ANA,KCA,ANA01,6,7,13
ANA200506130,2005,50613,ANA,WAS,ANA01,1,11,12
ANA200506140,2005,50614,ANA,WAS,ANA01,6,3,9
ANA200506150,2005,50615,ANA,WAS,ANA01,1,0,1
ANA200506170,2005,50617,ANA,FLO,ANA01,2,3,5
ANA200506180,2005,50618,ANA,FLO,ANA01,1,2,3
ANA200506190,2005,50619,ANA,FLO,ANA01,7,5,12
ANA200506200,2005,50620,ANA,TEX,ANA01,1,5,6
ANA200506210,2005,50621,ANA,TEX,ANA01,6,8,14
ANA200506220,2005,50622,ANA,TEX,ANA01,0,6,6
ANA200506240,2005,50624,ANA,LAN,ANA01,0,7,7
ANA200506250,2005,50625,ANA,LAN,ANA01,1,3,4
ANA200506260,2005,50626,ANA,LAN,ANA01,3,5,8
ANA200507040,2005,50704,ANA,MIN,ANA01,7,5,12
ANA200507050,2005,50705,ANA,MIN,ANA01,1,2,3
ANA200507060,2005,50706,ANA,MIN,ANA01,6,7,13
ANA200507070,2005,50707,ANA,SEA,ANA01,10,2,12
ANA200507080,2005,50708,ANA,SEA,ANA01,10,4,14
ANA200507090,2005,50709,ANA,SEA,ANA01,6,3,9
ANA200507100,2005,50710,ANA,SEA,ANA01,7,4,11
ANA200507180,2005,50718,ANA,OAK,ANA01,2,5,7
ANA200507190,2005,50719,ANA,OAK,ANA01,3,1,4
ANA200507200,2005,50720,ANA,OAK,ANA01,3,0,3
ANA200507210,2005,50721,ANA,NYA,ANA01,5,6,11
ANA200507220,2005,50722,ANA,NYA,ANA01,3,6,9
ANA200507230,2005,50723,ANA,NYA,ANA01,6,8,14
ANA200507240,2005,50724,ANA,NYA,ANA01,4,1,5
ANA200508020,2005,50802,ANA,BAL,ANA01,1,10,11
ANA200508030,2005,50803,ANA,BAL,ANA01,4,8,12
ANA200508040,2005,50804,ANA,BAL,ANA01,4,1,5
ANA200508050,2005,50805,ANA,TBA,ANA01,4,5,9
ANA200508060,2005,50806,ANA,TBA,ANA01,6,4,10
ANA200508070,2005,50807,ANA,TBA,ANA01,4,10,14
ANA200508150,2005,50815,ANA,TOR,ANA01,4,5,9
ANA200508160,2005,50816,ANA,TOR,ANA01,4,3,7
ANA200508170,2005,50817,ANA,TOR,ANA01,4,1,5
ANA200508180,2005,50818,ANA,BOS,ANA01,4,13,17
ANA200508190,2005,50819,ANA,BOS,ANA01,4,3,7
ANA200508200,2005,50820,ANA,BOS,ANA01,2,4,6
ANA200508210,2005,50821,ANA,BOS,ANA01,5,1,6
ANA200508300,2005,50830,ANA,OAK,ANA01,2,1,3
ANA200508310,2005,50831,ANA,OAK,ANA01,1,2,3
ANA200509010,2005,50901,ANA,OAK,ANA01,0,3,3
ANA200509020,2005,50902,ANA,SEA,ANA01,1,4,5
ANA200509030,2005,50903,ANA,SEA,ANA01,6,3,9
ANA200509040,2005,50904,ANA,SEA,ANA01,3,5,8
ANA200509150,2005,50915,ANA,DET,ANA01,8,6,14
ANA200509160,2005,50916,ANA,DET,ANA01,6,7,13
ANA200509170,2005,50917,ANA,DET,ANA01,1,3,4
ANA200509180,2005,50918,ANA,DET,ANA01,3,5,8
ANA200509200,2005,50920,ANA,TEX,ANA01,1,2,3
ANA200509210,2005,50921,ANA,TEX,ANA01,5,6,11
ANA200509220,2005,50922,ANA,TEX,ANA01,4,7,11
ANA200509230,2005,50923,ANA,TBA,ANA01,5,7,12
ANA200509240,2005,50924,ANA,TBA,ANA01,3,7,10
ANA200509250,2005,50925,ANA,TBA,ANA01,8,4,12
ANA200510040,2005,51004,ANA,NYA,ANA01,4,2,6
ANA200510050,2005,51005,ANA,NYA,ANA01,3,5,8
ANA200510100,2005,51010,ANA,NYA,ANA01,3,5,8
ANA200510140,2005,51014,ANA,CHA,ANA01,5,2,7
ANA200510150,2005,51015,ANA,CHA,ANA01,8,2,10
ANA200510160,2005,51016,ANA,CHA,ANA01,6,3,9
ANA200604070,2006,60407,ANA,NYA,ANA01,1,4,5
ANA200604080,2006,60408,ANA,NYA,ANA01,2,3,5
ANA200604090,2006,60409,ANA,NYA,ANA01,10,1,11
ANA200604100,2006,60410,ANA,TEX,ANA01,2,5,7
ANA200604110,2006,60411,ANA,TEX,ANA01,4,5,9
ANA200604120,2006,60412,ANA,TEX,ANA01,11,3,14
ANA200604240,2006,60424,ANA,DET,ANA01,0,3,3
ANA200604250,2006,60425,ANA,DET,ANA01,5,2,7
ANA200604260,2006,60426,ANA,DET,ANA01,0,4,4
ANA200604280,2006,60428,ANA,CHA,ANA01,8,5,13
ANA200604290,2006,60429,ANA,CHA,ANA01,2,1,3
ANA200604300,2006,60430,ANA,CHA,ANA01,6,5,11
ANA200605010,2006,60501,ANA,OAK,ANA01,1,0,1
ANA200605020,2006,60502,ANA,OAK,ANA01,10,3,13
ANA200605120,2006,60512,ANA,SEA,ANA01,7,12,19
ANA200605130,2006,60513,ANA,SEA,ANA01,5,4,9
ANA200605140,2006,60514,ANA,SEA,ANA01,9,4,13
ANA200605160,2006,60516,ANA,TOR,ANA01,3,8,11
ANA200605170,2006,60517,ANA,TOR,ANA01,3,0,3
ANA200605180,2006,60518,ANA,TOR,ANA01,8,4,12
ANA200605260,2006,60526,ANA,BAL,ANA01,2,5,7
ANA200605270,2006,60527,ANA,BAL,ANA01,1,10,11
ANA200605280,2006,60528,ANA,BAL,ANA01,7,6,13
ANA200605290,2006,60529,ANA,MIN,ANA01,3,4,7
ANA200605300,2006,60530,ANA,MIN,ANA01,3,6,9
ANA200605310,2006,60531,ANA,MIN,ANA01,7,1,8
ANA200606090,2006,60609,ANA,SEA,ANA01,4,1,5
ANA200606100,2006,60610,ANA,SEA,ANA01,12,6,18
ANA200606110,2006,60611,ANA,SEA,ANA01,6,2,8
ANA200606120,2006,60612,ANA,KCA,ANA01,3,4,7
ANA200606130,2006,60613,ANA,KCA,ANA01,1,4,5
ANA200606140,2006,60614,ANA,KCA,ANA01,4,3,7
ANA200606150,2006,60615,ANA,KCA,ANA01,2,3,5
ANA200606160,2006,60616,ANA,SDN,ANA01,5,4,9
ANA200606170,2006,60617,ANA,SDN,ANA01,2,3,5
ANA200606180,2006,60618,ANA,SDN,ANA01,7,3,10
ANA200606260,2006,60626,ANA,COL,ANA01,4,5,9
ANA200606270,2006,60627,ANA,COL,ANA01,12,4,16
ANA200606280,2006,60628,ANA,COL,ANA01,6,2,8
ANA200606300,2006,60630,ANA,LAN,ANA01,6,1,7
ANA200607010,2006,60701,ANA,LAN,ANA01,2,9,11
ANA200607020,2006,60702,ANA,LAN,ANA01,0,4,4
ANA200607140,2006,60714,ANA,TBA,ANA01,0,4,4
ANA200607150,2006,60715,ANA,TBA,ANA01,2,9,11
ANA200607160,2006,60716,ANA,TBA,ANA01,5,7,12
ANA200607170,2006,60717,ANA,CLE,ANA01,5,10,15
ANA200607180,2006,60718,ANA,CLE,ANA01,5,7,12
ANA200607190,2006,60719,ANA,CLE,ANA01,6,4,10
ANA200607310,2006,60731,ANA,OAK,ANA01,3,1,4
ANA200608010,2006,60801,ANA,OAK,ANA01,2,3,5
ANA200608020,2006,60802,ANA,OAK,ANA01,3,2,5
ANA200608030,2006,60803,ANA,TEX,ANA01,7,6,13
ANA200608040,2006,60804,ANA,TEX,ANA01,7,3,10
ANA200608050,2006,60805,ANA,TEX,ANA01,3,10,13
ANA200608060,2006,60806,ANA,TEX,ANA01,1,9,10
ANA200608170,2006,60817,ANA,SEA,ANA01,2,5,7
ANA200608180,2006,60818,ANA,SEA,ANA01,0,3,3
ANA200608190,2006,60819,ANA,SEA,ANA01,7,9,16
ANA200608200,2006,60820,ANA,SEA,ANA01,2,3,5
ANA200608220,2006,60822,ANA,BOS,ANA01,3,4,7
ANA200608230,2006,60823,ANA,BOS,ANA01,5,4,9
ANA200608240,2006,60824,ANA,BOS,ANA01,2,1,3
ANA200608250,2006,60825,ANA,NYA,ANA01,5,6,11
ANA200608260,2006,60826,ANA,NYA,ANA01,7,12,19
ANA200608270,2006,60827,ANA,NYA,ANA01,11,8,19
ANA200609040,2006,60904,ANA,BAL,ANA01,0,1,1
ANA200609050,2006,60905,ANA,BAL,ANA01,2,5,7
ANA200609060,2006,60906,ANA,BAL,ANA01,4,8,12
ANA200609080,2006,60908,ANA,TOR,ANA01,1,4,5
ANA200609090,2006,60909,ANA,TOR,ANA01,2,1,3
ANA200609100,2006,60910,ANA,TOR,ANA01,3,4,7
ANA200609110,2006,60911,ANA,CHA,ANA01,3,2,5
ANA200609120,2006,60912,ANA,CHA,ANA01,3,4,7
ANA200609130,2006,60913,ANA,CHA,ANA01,9,0,9
ANA200609250,2006,60925,ANA,TEX,ANA01,3,8,11
ANA200609260,2006,60926,ANA,TEX,ANA01,5,2,7
ANA200609270,2006,60927,ANA,TEX,ANA01,5,6,11
ANA200609280,2006,60928,ANA,OAK,ANA01,0,2,2
ANA200609290,2006,60929,ANA,OAK,ANA01,0,6,6
ANA200609300,2006,60930,ANA,OAK,ANA01,6,7,13
ANA200610010,2006,61001,ANA,OAK,ANA01,11,10,21
ANA200704020,2007,70402,ANA,TEX,ANA01,1,4,5
ANA200704030,2007,70403,ANA,TEX,ANA01,3,8,11
ANA200704040,2007,70404,ANA,TEX,ANA01,3,5,8
ANA200704050,2007,70405,ANA,OAK,ANA01,4,3,7
ANA200704060,2007,70406,ANA,OAK,ANA01,2,5,7
ANA200704070,2007,70407,ANA,OAK,ANA01,1,2,3
ANA200704080,2007,70408,ANA,OAK,ANA01,2,1,3
ANA200704200,2007,70420,ANA,SEA,ANA01,4,8,12
ANA200704210,2007,70421,ANA,SEA,ANA01,6,7,13
ANA200704220,2007,70422,ANA,SEA,ANA01,1,6,7
ANA200704230,2007,70423,ANA,DET,ANA01,9,5,14
ANA200704240,2007,70424,ANA,DET,ANA01,8,9,17
ANA200704250,2007,70425,ANA,TBA,ANA01,1,9,10
ANA200704260,2007,70426,ANA,TBA,ANA01,3,11,14
ANA200705040,2007,70504,ANA,CHA,ANA01,1,5,6
ANA200705050,2007,70505,ANA,CHA,ANA01,6,3,9
ANA200705060,2007,70506,ANA,CHA,ANA01,4,3,7
ANA200705080,2007,70508,ANA,CLE,ANA01,5,1,6
ANA200705090,2007,70509,ANA,CLE,ANA01,2,3,5
ANA200705100,2007,70510,ANA,CLE,ANA01,0,8,8
ANA200705180,2007,70518,ANA,LAN,ANA01,1,9,10
ANA200705190,2007,70519,ANA,LAN,ANA01,2,6,8
ANA200705200,2007,70520,ANA,LAN,ANA01,1,4,5
ANA200705280,2007,70528,ANA,SEA,ANA01,12,5,17
ANA200705290,2007,70529,ANA,SEA,ANA01,1,4,5
ANA200705300,2007,70530,ANA,SEA,ANA01,6,8,14
ANA200705310,2007,70531,ANA,BAL,ANA01,6,2,8
ANA200706010,2007,70601,ANA,BAL,ANA01,2,3,5
ANA200706020,2007,70602,ANA,BAL,ANA01,4,7,11
ANA200706030,2007,70603,ANA,BAL,ANA01,3,4,7
ANA200706040,2007,70604,ANA,MIN,ANA01,3,16,19
ANA200706050,2007,70605,ANA,MIN,ANA01,1,5,6
ANA200706060,2007,70606,ANA,MIN,ANA01,8,5,13
ANA200706180,2007,70618,ANA,HOU,ANA01,9,10,19
ANA200706190,2007,70619,ANA,HOU,ANA01,9,5,14
ANA200706200,2007,70620,ANA,HOU,ANA01,4,8,12
ANA200706220,2007,70622,ANA,PIT,ANA01,4,5,9
ANA200706230,2007,70623,ANA,PIT,ANA01,1,10,11
ANA200706240,2007,70624,ANA,PIT,ANA01,3,4,7
ANA200706250,2007,70625,ANA,KCA,ANA01,5,3,8
ANA200706260,2007,70626,ANA,KCA,ANA01,12,4,16
ANA200706270,2007,70627,ANA,KCA,ANA01,1,0,1
ANA200707130,2007,70713,ANA,TEX,ANA01,1,2,3
ANA200707140,2007,70714,ANA,TEX,ANA01,5,9,14
ANA200707150,2007,70715,ANA,TEX,ANA01,5,4,9
ANA200707230,2007,70723,ANA,OAK,ANA01,12,6,18
ANA200707240,2007,70724,ANA,OAK,ANA01,4,3,7
ANA200707250,2007,70725,ANA,OAK,ANA01,6,7,13
ANA200707270,2007,70727,ANA,DET,ANA01,6,11,17
ANA200707280,2007,70728,ANA,DET,ANA01,3,10,13
ANA200707290,2007,70729,ANA,DET,ANA01,4,13,17
ANA200708060,2007,70806,ANA,BOS,ANA01,2,4,6
ANA200708070,2007,70807,ANA,BOS,ANA01,4,10,14
ANA200708080,2007,70808,ANA,BOS,ANA01,9,6,15
ANA200708100,2007,70810,ANA,MIN,ANA01,1,10,11
ANA200708110,2007,70811,ANA,MIN,ANA01,3,4,7
ANA200708120,2007,70812,ANA,MIN,ANA01,2,6,8
ANA200708200,2007,70820,ANA,NYA,ANA01,6,7,13
ANA200708210,2007,70821,ANA,NYA,ANA01,9,18,27
ANA200708220,2007,70822,ANA,NYA,ANA01,8,2,10
ANA200708230,2007,70823,ANA,TOR,ANA01,5,4,9
ANA200708240,2007,70824,ANA,TOR,ANA01,0,3,3
ANA200708250,2007,70825,ANA,TOR,ANA01,9,2,11
ANA200708260,2007,70826,ANA,TOR,ANA01,1,3,4
ANA200708310,2007,70831,ANA,TEX,ANA01,6,7,13
ANA200709010,2007,70901,ANA,TEX,ANA01,7,6,13
ANA200709020,2007,70902,ANA,TEX,ANA01,8,7,15
ANA200709030,2007,70903,ANA,OAK,ANA01,5,9,14
ANA200709040,2007,70904,ANA,OAK,ANA01,3,4,7
ANA200709050,2007,70905,ANA,OAK,ANA01,6,2,8
ANA200709060,2007,70906,ANA,CLE,ANA01,3,10,13
ANA200709070,2007,70907,ANA,CLE,ANA01,2,3,5
ANA200709080,2007,70908,ANA,CLE,ANA01,6,1,7
ANA200709090,2007,70909,ANA,CLE,ANA01,6,2,8
ANA200709170,2007,70917,ANA,TBA,ANA01,7,10,17
ANA200709180,2007,70918,ANA,TBA,ANA01,1,2,3
ANA200709190,2007,70919,ANA,TBA,ANA01,1,2,3
ANA200709200,2007,70920,ANA,SEA,ANA01,5,9,14
ANA200709210,2007,70921,ANA,SEA,ANA01,6,0,6
ANA200709220,2007,70922,ANA,SEA,ANA01,3,2,5
ANA200709230,2007,70923,ANA,SEA,ANA01,4,7,11
ANA200710070,2007,71007,ANA,BOS,ANA01,9,1,10
ANA200804040,2008,80404,ANA,TEX,ANA01,11,6,17
ANA200804050,2008,80405,ANA,TEX,ANA01,1,2,3
ANA200804060,2008,80406,ANA,TEX,ANA01,10,4,14
ANA200804070,2008,80407,ANA,CLE,ANA01,4,6,10
ANA200804080,2008,80408,ANA,CLE,ANA01,4,3,7
ANA200804090,2008,80409,ANA,CLE,ANA01,5,9,14
ANA200804160,2008,80416,ANA,KCA,ANA01,3,2,5
ANA200804170,2008,80417,ANA,KCA,ANA01,3,5,8
ANA200804180,2008,80418,ANA,SEA,ANA01,4,5,9
ANA200804190,2008,80419,ANA,SEA,ANA01,1,4,5
ANA200804200,2008,80420,ANA,SEA,ANA01,4,2,6
ANA200804280,2008,80428,ANA,OAK,ANA01,14,2,16
ANA200804290,2008,80429,ANA,OAK,ANA01,0,2,2
ANA200804300,2008,80430,ANA,OAK,ANA01,1,6,7
ANA200805010,2008,80501,ANA,OAK,ANA01,15,8,23
ANA200805020,2008,80502,ANA,BAL,ANA01,4,3,7
ANA200805030,2008,80503,ANA,BAL,ANA01,1,3,4
ANA200805040,2008,80504,ANA,BAL,ANA01,5,6,11
ANA200805120,2008,80512,ANA,CHA,ANA01,7,10,17
ANA200805130,2008,80513,ANA,CHA,ANA01,0,2,2
ANA200805140,2008,80514,ANA,CHA,ANA01,6,1,7
ANA200805150,2008,80515,ANA,CHA,ANA01,4,3,7
ANA200805160,2008,80516,ANA,LAN,ANA01,2,4,6
ANA200805170,2008,80517,ANA,LAN,ANA01,6,3,9
ANA200805180,2008,80518,ANA,LAN,ANA01,2,10,12
ANA200805260,2008,80526,ANA,DET,ANA01,0,1,1
ANA200805270,2008,80527,ANA,DET,ANA01,2,3,5
ANA200805280,2008,80528,ANA,DET,ANA01,6,2,8
ANA200805300,2008,80530,ANA,TOR,ANA01,10,4,14
ANA200805310,2008,80531,ANA,TOR,ANA01,2,3,5
ANA200806010,2008,80601,ANA,TOR,ANA01,3,4,7
ANA200806090,2008,80609,ANA,TBA,ANA01,13,4,17
ANA200806100,2008,80610,ANA,TBA,ANA01,1,6,7
ANA200806110,2008,80611,ANA,TBA,ANA01,2,4,6
ANA200806130,2008,80613,ANA,ATL,ANA01,5,2,7
ANA200806140,2008,80614,ANA,ATL,ANA01,9,4,13
ANA200806150,2008,80615,ANA,ATL,ANA01,0,2,2
ANA200806160,2008,80616,ANA,NYN,ANA01,9,6,15
ANA200806170,2008,80617,ANA,NYN,ANA01,1,6,7
ANA200806180,2008,80618,ANA,NYN,ANA01,5,4,9
ANA200806300,2008,80630,ANA,OAK,ANA01,6,1,7
ANA200807010,2008,80701,ANA,OAK,ANA01,3,5,8
ANA200807020,2008,80702,ANA,OAK,ANA01,4,7,11
ANA200807040,2008,80704,ANA,TOR,ANA01,2,8,10
ANA200807050,2008,80705,ANA,TOR,ANA01,7,5,12
ANA200807060,2008,80706,ANA,TOR,ANA01,1,7,8
ANA200807180,2008,80718,ANA,BOS,ANA01,3,11,14
ANA200807190,2008,80719,ANA,BOS,ANA01,2,4,6
ANA200807200,2008,80720,ANA,BOS,ANA01,3,5,8
ANA200807210,2008,80721,ANA,CLE,ANA01,5,2,7
ANA200807220,2008,80722,ANA,CLE,ANA01,2,3,5
ANA200807230,2008,80723,ANA,CLE,ANA01,11,14,25
ANA200808040,2008,80804,ANA,BAL,ANA01,5,6,11
ANA200808050,2008,80805,ANA,BAL,ANA01,3,0,3
ANA200808060,2008,80806,ANA,BAL,ANA01,4,9,13
ANA200808080,2008,80808,ANA,NYA,ANA01,5,10,15
ANA200808090,2008,80809,ANA,NYA,ANA01,4,11,15
ANA200808100,2008,80810,ANA,NYA,ANA01,3,4,7
ANA200808120,2008,80812,ANA,SEA,ANA01,3,7,10
ANA200808130,2008,80813,ANA,SEA,ANA01,10,7,17
ANA200808210,2008,80821,ANA,MIN,ANA01,2,1,3
ANA200808220,2008,80822,ANA,MIN,ANA01,9,0,9
ANA200808230,2008,80823,ANA,MIN,ANA01,5,7,12
ANA200808240,2008,80824,ANA,MIN,ANA01,3,5,8
ANA200808250,2008,80825,ANA,OAK,ANA01,2,1,3
ANA200808260,2008,80826,ANA,OAK,ANA01,1,5,6
ANA200808270,2008,80827,ANA,OAK,ANA01,6,5,11
ANA200808280,2008,80828,ANA,TEX,ANA01,5,7,12
ANA200808290,2008,80829,ANA,TEX,ANA01,1,3,4
ANA200808300,2008,80830,ANA,TEX,ANA01,3,4,7
ANA200808310,2008,80831,ANA,TEX,ANA01,4,3,7
ANA200809080,2008,80908,ANA,NYA,ANA01,1,12,13
ANA200809090,2008,80909,ANA,NYA,ANA01,7,1,8
ANA200809100,2008,80910,ANA,NYA,ANA01,2,4,6
ANA200809110,2008,80911,ANA,SEA,ANA01,4,7,11
ANA200809120,2008,80912,ANA,SEA,ANA01,3,5,8
ANA200809130,2008,80913,ANA,SEA,ANA01,2,5,7
ANA200809140,2008,80914,ANA,SEA,ANA01,3,4,7
ANA200809260,2008,80926,ANA,TEX,ANA01,12,1,13
ANA200809270,2008,80927,ANA,TEX,ANA01,8,4,12
ANA200809280,2008,80928,ANA,TEX,ANA01,0,7,7
ANA200810010,2008,81001,ANA,BOS,ANA01,4,1,5
ANA200810030,2008,81003,ANA,BOS,ANA01,7,5,12
ANA200904060,2009,90406,ANA,OAK,ANA01,0,3,3
ANA200904070,2009,90407,ANA,OAK,ANA01,6,4,10
ANA200904080,2009,90408,ANA,OAK,ANA01,6,4,10
ANA200904100,2009,90410,ANA,BOS,ANA01,3,6,9
ANA200904110,2009,90411,ANA,BOS,ANA01,5,4,9
ANA200904120,2009,90412,ANA,BOS,ANA01,4,5,9
ANA200904210,2009,90421,ANA,DET,ANA01,3,4,7
ANA200904220,2009,90422,ANA,DET,ANA01,12,10,22
ANA200904230,2009,90423,ANA,DET,ANA01,5,10,15
ANA200904240,2009,90424,ANA,SEA,ANA01,8,3,11
ANA200904250,2009,90425,ANA,SEA,ANA01,9,8,17
ANA200904260,2009,90426,ANA,SEA,ANA01,0,8,8
ANA200905060,2009,90506,ANA,TOR,ANA01,13,1,14
ANA200905070,2009,90507,ANA,TOR,ANA01,1,6,7
ANA200905080,2009,90508,ANA,KCA,ANA01,1,4,5
ANA200905090,2009,90509,ANA,KCA,ANA01,0,1,1
ANA200905100,2009,90510,ANA,KCA,ANA01,3,4,7
ANA200905120,2009,90512,ANA,BOS,ANA01,4,3,7
ANA200905130,2009,90513,ANA,BOS,ANA01,4,8,12
ANA200905140,2009,90514,ANA,BOS,ANA01,4,5,9
ANA200905250,2009,90525,ANA,CHA,ANA01,17,3,20
ANA200905260,2009,90526,ANA,CHA,ANA01,4,2,6
ANA200905270,2009,90527,ANA,CHA,ANA01,1,3,4
ANA200905290,2009,90529,ANA,SEA,ANA01,5,2,7
ANA200905300,2009,90530,ANA,SEA,ANA01,4,3,7
ANA200905310,2009,90531,ANA,SEA,ANA01,8,9,17
ANA200906120,2009,90612,ANA,SDN,ANA01,6,11,17
ANA200906130,2009,90613,ANA,SDN,ANA01,1,9,10
ANA200906140,2009,90614,ANA,SDN,ANA01,0,6,6
ANA200906190,2009,90619,ANA,LAN,ANA01,4,5,9
ANA200906200,2009,90620,ANA,LAN,ANA01,6,4,10
ANA200906210,2009,90621,ANA,LAN,ANA01,5,3,8
ANA200906220,2009,90622,ANA,COL,ANA01,11,1,12
ANA200906230,2009,90623,ANA,COL,ANA01,3,4,7
ANA200906240,2009,90624,ANA,COL,ANA01,3,11,14
ANA200907020,2009,90702,ANA,BAL,ANA01,2,5,7
ANA200907030,2009,90703,ANA,BAL,ANA01,6,4,10
ANA200907040,2009,90704,ANA,BAL,ANA01,4,11,15
ANA200907050,2009,90705,ANA,BAL,ANA01,6,9,15
ANA200907060,2009,90706,ANA,TEX,ANA01,4,9,13
ANA200907070,2009,90707,ANA,TEX,ANA01,8,5,13
ANA200907080,2009,90708,ANA,TEX,ANA01,8,1,9
ANA200907100,2009,90710,ANA,NYA,ANA01,6,10,16
ANA200907110,2009,90711,ANA,NYA,ANA01,8,14,22
ANA200907120,2009,90712,ANA,NYA,ANA01,4,5,9
ANA200907230,2009,90723,ANA,MIN,ANA01,5,6,11
ANA200907240,2009,90724,ANA,MIN,ANA01,3,6,9
ANA200907250,2009,90725,ANA,MIN,ANA01,5,11,16
ANA200907260,2009,90726,ANA,MIN,ANA01,10,1,11
ANA200907270,2009,90727,ANA,CLE,ANA01,8,6,14
ANA200907280,2009,90728,ANA,CLE,ANA01,6,7,13
ANA200907290,2009,90729,ANA,CLE,ANA01,3,9,12
ANA200908070,2009,90807,ANA,TEX,ANA01,11,6,17
ANA200908080,2009,90808,ANA,TEX,ANA01,2,3,5
ANA200908090,2009,90809,ANA,TEX,ANA01,7,0,7
ANA200908100,2009,90810,ANA,TBA,ANA01,7,8,15
ANA200908110,2009,90811,ANA,TBA,ANA01,0,6,6
ANA200908120,2009,90812,ANA,TBA,ANA01,5,10,15
ANA200908240,2009,90824,ANA,DET,ANA01,10,7,17
ANA200908250,2009,90825,ANA,DET,ANA01,5,3,8
ANA200908260,2009,90826,ANA,DET,ANA01,2,4,6
ANA200908270,2009,90827,ANA,OAK,ANA01,2,0,2
ANA200908280,2009,90828,ANA,OAK,ANA01,7,11,18
ANA200908290,2009,90829,ANA,OAK,ANA01,4,3,7
ANA200908300,2009,90830,ANA,OAK,ANA01,1,9,10
ANA200909080,2009,90908,ANA,SEA,ANA01,2,3,5
ANA200909090,2009,90909,ANA,SEA,ANA01,3,6,9
ANA200909100,2009,90910,ANA,SEA,ANA01,0,3,3
ANA200909110,2009,90911,ANA,CHA,ANA01,1,7,8
ANA200909120,2009,90912,ANA,CHA,ANA01,4,3,7
ANA200909130,2009,90913,ANA,CHA,ANA01,2,3,5
ANA200909210,2009,90921,ANA,NYA,ANA01,2,5,7
ANA200909220,2009,90922,ANA,NYA,ANA01,6,5,11
ANA200909230,2009,90923,ANA,NYA,ANA01,3,2,5
ANA200909250,2009,90925,ANA,OAK,ANA01,3,0,3
ANA200909260,2009,90926,ANA,OAK,ANA01,15,10,25
ANA200909270,2009,90927,ANA,OAK,ANA01,4,7,11
ANA200909280,2009,90928,ANA,TEX,ANA01,0,11,11
ANA200909290,2009,90929,ANA,TEX,ANA01,2,5,7
ANA200909300,2009,90930,ANA,TEX,ANA01,0,5,5
ANA200910010,2009,91001,ANA,TEX,ANA01,11,3,14
ANA200910080,2009,91008,ANA,BOS,ANA01,0,5,5
ANA200910090,2009,91009,ANA,BOS,ANA01,1,4,5
ANA200910190,2009,91019,ANA,NYA,ANA01,4,5,9
ANA200910200,2009,91020,ANA,NYA,ANA01,10,1,11
ANA200910220,2009,91022,ANA,NYA,ANA01,6,7,13
ARI200004040,2000,404,ARI,PHI,PHO01,4,6,10
ARI200004050,2000,405,ARI,PHI,PHO01,3,11,14
ARI200004060,2000,406,ARI,PHI,PHO01,2,3,5
ARI200004070,2000,407,ARI,PIT,PHO01,7,2,9
ARI200004080,2000,408,ARI,PIT,PHO01,5,6,11
ARI200004090,2000,409,ARI,PIT,PHO01,0,1,1
ARI200004170,2000,417,ARI,COL,PHO01,9,1,10
ARI200004180,2000,418,ARI,COL,PHO01,1,7,8
ARI200004190,2000,419,ARI,COL,PHO01,7,8,15
ARI200004200,2000,420,ARI,COL,PHO01,0,3,3
ARI200004210,2000,421,ARI,SFN,PHO01,11,5,16
ARI200004220,2000,422,ARI,SFN,PHO01,8,6,14
ARI200004230,2000,423,ARI,SFN,PHO01,12,7,19
ARI200005050,2000,505,ARI,SDN,PHO01,3,5,8
ARI200005060,2000,506,ARI,SDN,PHO01,5,10,15
ARI200005070,2000,507,ARI,SDN,PHO01,1,8,9
ARI200005080,2000,508,ARI,LAN,PHO01,7,15,22
ARI200005090,2000,509,ARI,LAN,PHO01,7,11,18
ARI200005100,2000,510,ARI,LAN,PHO01,1,2,3
ARI200005230,2000,523,ARI,PIT,PHO01,1,6,7
ARI200005240,2000,524,ARI,PIT,PHO01,5,6,11
ARI200005250,2000,525,ARI,PIT,PHO01,5,7,12
ARI200005260,2000,526,ARI,MIL,PHO01,2,9,11
ARI200005270,2000,527,ARI,MIL,PHO01,3,7,10
ARI200005280,2000,528,ARI,MIL,PHO01,4,3,7
ARI200005290,2000,529,ARI,SLN,PHO01,3,0,3
ARI200005300,2000,530,ARI,SLN,PHO01,6,1,7
ARI200005310,2000,531,ARI,SLN,PHO01,2,6,8
ARI200006010,2000,601,ARI,SLN,PHO01,0,4,4
ARI200006090,2000,609,ARI,ANA,PHO01,1,4,5
ARI200006100,2000,610,ARI,ANA,PHO01,10,3,13
ARI200006110,2000,611,ARI,ANA,PHO01,2,3,5
ARI200006190,2000,619,ARI,SDN,PHO01,2,3,5
ARI200006200,2000,620,ARI,SDN,PHO01,3,1,4
ARI200006210,2000,621,ARI,SDN,PHO01,8,11,19
ARI200006230,2000,623,ARI,COL,PHO01,0,2,2
ARI200006240,2000,624,ARI,COL,PHO01,4,0,4
ARI200006250,2000,625,ARI,COL,PHO01,3,8,11
ARI200006260,2000,626,ARI,HOU,PHO01,1,6,7
ARI200006270,2000,627,ARI,HOU,PHO01,12,4,16
ARI200006280,2000,628,ARI,HOU,PHO01,2,6,8
ARI200006290,2000,629,ARI,HOU,PHO01,1,7,8
ARI200006300,2000,630,ARI,CIN,PHO01,5,4,9
ARI200007010,2000,701,ARI,CIN,PHO01,6,9,15
ARI200007020,2000,702,ARI,CIN,PHO01,14,2,16
ARI200007030,2000,703,ARI,CIN,PHO01,3,2,5
ARI200007130,2000,713,ARI,TEX,PHO01,6,4,10
ARI200007140,2000,714,ARI,TEX,PHO01,1,6,7
ARI200007150,2000,715,ARI,TEX,PHO01,6,5,11
ARI200007160,2000,716,ARI,SEA,PHO01,6,3,9
ARI200007170,2000,717,ARI,SEA,PHO01,0,7,7
ARI200007180,2000,718,ARI,SEA,PHO01,5,2,7
ARI200007190,2000,719,ARI,SLN,PHO01,3,4,7
ARI200007200,2000,720,ARI,SLN,PHO01,2,3,5
ARI200008010,2000,801,ARI,ATL,PHO01,4,2,6
ARI200008020,2000,802,ARI,ATL,PHO01,0,2,2
ARI200008030,2000,803,ARI,ATL,PHO01,4,8,12
ARI200008040,2000,804,ARI,NYN,PHO01,6,1,7
ARI200008050,2000,805,ARI,NYN,PHO01,6,2,8
ARI200008060,2000,806,ARI,NYN,PHO01,5,9,14
ARI200008070,2000,807,ARI,MON,PHO01,2,5,7
ARI200008080,2000,808,ARI,MON,PHO01,9,3,12
ARI200008090,2000,809,ARI,MON,PHO01,4,3,7
ARI200008180,2000,818,ARI,CHN,PHO01,2,11,13
ARI200008190,2000,819,ARI,CHN,PHO01,3,11,14
ARI200008200,2000,820,ARI,CHN,PHO01,4,5,9
ARI200008210,2000,821,ARI,MIL,PHO01,16,8,24
ARI200008220,2000,822,ARI,MIL,PHO01,4,3,7
ARI200008230,2000,823,ARI,MIL,PHO01,8,5,13
ARI200009010,2000,901,ARI,FLO,PHO01,8,7,15
ARI200009020,2000,902,ARI,FLO,PHO01,10,1,11
ARI200009030,2000,903,ARI,FLO,PHO01,5,10,15
ARI200009110,2000,911,ARI,LAN,PHO01,6,3,9
ARI200009120,2000,912,ARI,LAN,PHO01,4,5,9
ARI200009130,2000,913,ARI,LAN,PHO01,2,3,5
ARI200009150,2000,915,ARI,ATL,PHO01,1,2,3
ARI200009160,2000,916,ARI,ATL,PHO01,12,10,22
ARI200009170,2000,917,ARI,ATL,PHO01,7,1,8
ARI200009290,2000,929,ARI,SFN,PHO01,4,3,7
ARI200009300,2000,930,ARI,SFN,PHO01,1,5,6
ARI200010010,2000,1001,ARI,SFN,PHO01,11,4,15
ARI200104060,2001,10406,ARI,SLN,PHO01,12,9,21
ARI200104070,2001,10407,ARI,SLN,PHO01,8,4,12
ARI200104080,2001,10408,ARI,SLN,PHO01,9,4,13
ARI200104100,2001,10410,ARI,LAN,PHO01,0,2,2
ARI200104110,2001,10411,ARI,LAN,PHO01,11,5,16
ARI200104120,2001,10412,ARI,LAN,PHO01,5,4,9
ARI200104200,2001,10420,ARI,COL,PHO01,2,3,5
ARI200104210,2001,10421,ARI,COL,PHO01,5,10,15
ARI200104220,2001,10422,ARI,COL,PHO01,2,1,3
ARI200104230,2001,10423,ARI,FLO,PHO01,0,9,9
ARI200104240,2001,10424,ARI,FLO,PHO01,8,9,17
ARI200104250,2001,10425,ARI,FLO,PHO01,7,10,17
ARI200104260,2001,10426,ARI,ATL,PHO01,6,13,19
ARI200104270,2001,10427,ARI,ATL,PHO01,9,0,9
ARI200104280,2001,10428,ARI,ATL,PHO01,3,1,4
ARI200104290,2001,10429,ARI,ATL,PHO01,5,7,12
ARI200105070,2001,10507,ARI,CIN,PHO01,5,4,9
ARI200105080,2001,10508,ARI,CIN,PHO01,3,4,7
ARI200105090,2001,10509,ARI,CIN,PHO01,2,5,7
ARI200105110,2001,10511,ARI,PHI,PHO01,5,1,6
ARI200105120,2001,10512,ARI,PHI,PHO01,6,5,11
ARI200105130,2001,10513,ARI,PHI,PHO01,1,6,7
ARI200105210,2001,10521,ARI,SFN,PHO01,2,4,6
ARI200105220,2001,10522,ARI,SFN,PHO01,8,12,20
ARI200105230,2001,10523,ARI,SFN,PHO01,5,1,6
ARI200106010,2001,10601,ARI,SDN,PHO01,2,4,6
ARI200106020,2001,10602,ARI,SDN,PHO01,1,2,3
ARI200106030,2001,10603,ARI,SDN,PHO01,4,8,12
ARI200106040,2001,10604,ARI,LAN,PHO01,8,4,12
ARI200106050,2001,10605,ARI,LAN,PHO01,6,5,11
ARI200106060,2001,10606,ARI,LAN,PHO01,1,4,5
ARI200106070,2001,10607,ARI,LAN,PHO01,9,13,22
ARI200106120,2001,10612,ARI,CHN,PHO01,6,2,8
ARI200106130,2001,10613,ARI,CHN,PHO01,3,13,16
ARI200106140,2001,10614,ARI,CHN,PHO01,2,3,5
ARI200106150,2001,10615,ARI,DET,PHO01,5,2,7
ARI200106160,2001,10616,ARI,DET,PHO01,1,3,4
ARI200106170,2001,10617,ARI,DET,PHO01,3,8,11
ARI200106250,2001,10625,ARI,HOU,PHO01,6,0,6
ARI200106260,2001,10626,ARI,HOU,PHO01,10,7,17
ARI200106270,2001,10627,ARI,HOU,PHO01,5,7,12
ARI200106290,2001,10629,ARI,COL,PHO01,3,5,8
ARI200106300,2001,10630,ARI,COL,PHO01,5,6,11
ARI200107010,2001,10701,ARI,COL,PHO01,4,5,9
ARI200107060,2001,10706,ARI,OAK,PHO01,3,0,3
ARI200107070,2001,10707,ARI,OAK,PHO01,5,1,6
ARI200107080,2001,10708,ARI,OAK,PHO01,2,1,3
ARI200107230,2001,10723,ARI,SDN,PHO01,4,2,6
ARI200107240,2001,10724,ARI,SDN,PHO01,0,11,11
ARI200107250,2001,10725,ARI,SDN,PHO01,6,9,15
ARI200107260,2001,10726,ARI,SFN,PHO01,11,3,14
ARI200107270,2001,10727,ARI,SFN,PHO01,9,5,14
ARI200107280,2001,10728,ARI,SFN,PHO01,11,4,15
ARI200107290,2001,10729,ARI,SFN,PHO01,4,3,7
ARI200107310,2001,10731,ARI,MON,PHO01,1,3,4
ARI200108010,2001,10801,ARI,MON,PHO01,8,5,13
ARI200108020,2001,10802,ARI,MON,PHO01,1,0,1
ARI200108030,2001,10803,ARI,NYN,PHO01,0,7,7
ARI200108040,2001,10804,ARI,NYN,PHO01,4,2,6
ARI200108050,2001,10805,ARI,NYN,PHO01,1,2,3
ARI200108130,2001,10813,ARI,PIT,PHO01,0,3,3
ARI200108140,2001,10814,ARI,PIT,PHO01,3,4,7
ARI200108150,2001,10815,ARI,PIT,PHO01,2,5,7
ARI200108170,2001,10817,ARI,CHN,PHO01,2,7,9
ARI200108180,2001,10818,ARI,CHN,PHO01,3,5,8
ARI200108190,2001,10819,ARI,CHN,PHO01,6,13,19
ARI200108280,2001,10828,ARI,SFN,PHO01,1,4,5
ARI200108290,2001,10829,ARI,SFN,PHO01,0,2,2
ARI200108300,2001,10830,ARI,SFN,PHO01,13,5,18
ARI200109070,2001,10907,ARI,SDN,PHO01,4,3,7
ARI200109080,2001,10908,ARI,SDN,PHO01,6,8,14
ARI200109090,2001,10909,ARI,SDN,PHO01,2,8,10
ARI200109250,2001,10925,ARI,MIL,PHO01,9,4,13
ARI200109260,2001,10926,ARI,MIL,PHO01,9,15,24
ARI200109270,2001,10927,ARI,MIL,PHO01,11,13,24
ARI200109280,2001,10928,ARI,LAN,PHO01,3,4,7
ARI200109290,2001,10929,ARI,LAN,PHO01,1,8,9
ARI200109300,2001,10930,ARI,LAN,PHO01,2,1,3
ARI200110020,2001,11002,ARI,COL,PHO01,1,10,11
ARI200110030,2001,11003,ARI,COL,PHO01,3,4,7
ARI200110040,2001,11004,ARI,COL,PHO01,4,5,9
ARI200110090,2001,11009,ARI,SLN,PHO01,0,1,1
ARI200110100,2001,11010,ARI,SLN,PHO01,4,1,5
ARI200110140,2001,11014,ARI,SLN,PHO01,1,2,3
ARI200110160,2001,11016,ARI,ATL,PHO01,0,2,2
ARI200110170,2001,11017,ARI,ATL,PHO01,8,1,9
ARI200110270,2001,11027,ARI,NYA,PHO01,1,9,10
ARI200110280,2001,11028,ARI,NYA,PHO01,0,4,4
ARI200111030,2001,11103,ARI,NYA,PHO01,2,15,17
ARI200111040,2001,11104,ARI,NYA,PHO01,2,3,5
ARI200204010,2002,20401,ARI,SDN,PHO01,0,2,2
ARI200204020,2002,20402,ARI,SDN,PHO01,0,9,9
ARI200204030,2002,20403,ARI,SDN,PHO01,8,7,15
ARI200204150,2002,20415,ARI,SLN,PHO01,5,14,19
ARI200204160,2002,20416,ARI,SLN,PHO01,3,5,8
ARI200204170,2002,20417,ARI,SLN,PHO01,8,4,12
ARI200204190,2002,20419,ARI,COL,PHO01,8,6,14
ARI200204200,2002,20420,ARI,COL,PHO01,8,9,17
ARI200204210,2002,20421,ARI,COL,PHO01,1,7,8
ARI200204300,2002,20430,ARI,NYN,PHO01,10,1,11
ARI200205010,2002,20501,ARI,NYN,PHO01,7,1,8
ARI200205020,2002,20502,ARI,NYN,PHO01,3,7,10
ARI200205030,2002,20503,ARI,MON,PHO01,3,6,9
ARI200205040,2002,20504,ARI,MON,PHO01,5,6,11
ARI200205050,2002,20505,ARI,MON,PHO01,2,5,7
ARI200205060,2002,20506,ARI,PIT,PHO01,3,2,5
ARI200205070,2002,20507,ARI,PIT,PHO01,6,7,13
ARI200205080,2002,20508,ARI,PIT,PHO01,3,4,7
ARI200205160,2002,20516,ARI,PHI,PHO01,2,4,6
ARI200205170,2002,20517,ARI,PHI,PHO01,9,12,21
ARI200205180,2002,20518,ARI,PHI,PHO01,4,5,9
ARI200205190,2002,20519,ARI,PHI,PHO01,4,3,7
ARI200205210,2002,20521,ARI,SFN,PHO01,4,9,13
ARI200205220,2002,20522,ARI,SFN,PHO01,12,5,17
ARI200205240,2002,20524,ARI,LAN,PHO01,3,14,17
ARI200205250,2002,20525,ARI,LAN,PHO01,10,5,15
ARI200205260,2002,20526,ARI,LAN,PHO01,9,10,19
ARI200206030,2002,20603,ARI,HOU,PHO01,4,10,14
ARI200206040,2002,20604,ARI,HOU,PHO01,6,4,10
ARI200206050,2002,20605,ARI,HOU,PHO01,4,5,9
ARI200206140,2002,20614,ARI,DET,PHO01,6,3,9
ARI200206150,2002,20615,ARI,DET,PHO01,1,3,4
ARI200206160,2002,20616,ARI,DET,PHO01,2,11,13
ARI200206180,2002,20618,ARI,BAL,PHO01,3,6,9
ARI200206190,2002,20619,ARI,BAL,PHO01,6,1,7
ARI200206200,2002,20620,ARI,BAL,PHO01,1,5,6
ARI200206210,2002,20621,ARI,TOR,PHO01,3,4,7
ARI200206220,2002,20622,ARI,TOR,PHO01,6,3,9
ARI200206230,2002,20623,ARI,TOR,PHO01,9,3,12
ARI200207010,2002,20701,ARI,LAN,PHO01,4,0,4
ARI200207020,2002,20702,ARI,LAN,PHO01,8,0,8
ARI200207030,2002,20703,ARI,LAN,PHO01,3,5,8
ARI200207040,2002,20704,ARI,SFN,PHO01,3,6,9
ARI200207050,2002,20705,ARI,SFN,PHO01,1,2,3
ARI200207060,2002,20706,ARI,SFN,PHO01,3,2,5
ARI200207070,2002,20707,ARI,SFN,PHO01,5,2,7
ARI200207220,2002,20722,ARI,COL,PHO01,1,5,6
ARI200207230,2002,20723,ARI,COL,PHO01,5,8,13
ARI200207240,2002,20724,ARI,COL,PHO01,1,7,8
ARI200207250,2002,20725,ARI,SDN,PHO01,0,10,10
ARI200207260,2002,20726,ARI,SDN,PHO01,0,12,12
ARI200207270,2002,20727,ARI,SDN,PHO01,3,4,7
ARI200207280,2002,20728,ARI,SDN,PHO01,4,5,9
ARI200208060,2002,20806,ARI,ATL,PHO01,4,3,7
ARI200208070,2002,20807,ARI,ATL,PHO01,3,6,9
ARI200208080,2002,20808,ARI,ATL,PHO01,4,1,5
ARI200208090,2002,20809,ARI,FLO,PHO01,1,2,3
ARI200208100,2002,20810,ARI,FLO,PHO01,2,9,11
ARI200208110,2002,20811,ARI,FLO,PHO01,2,9,11
ARI200208200,2002,20820,ARI,CIN,PHO01,3,5,8
ARI200208210,2002,20821,ARI,CIN,PHO01,3,11,14
ARI200208220,2002,20822,ARI,CIN,PHO01,3,6,9
ARI200208230,2002,20823,ARI,CHN,PHO01,2,3,5
ARI200208240,2002,20824,ARI,CHN,PHO01,4,0,4
ARI200208250,2002,20825,ARI,CHN,PHO01,0,7,7
ARI200208300,2002,20830,ARI,SFN,PHO01,7,6,13
ARI200208310,2002,20831,ARI,SFN,PHO01,5,0,5
ARI200209010,2002,20901,ARI,SFN,PHO01,6,7,13
ARI200209020,2002,20902,ARI,LAN,PHO01,19,1,20
ARI200209030,2002,20903,ARI,LAN,PHO01,3,2,5
ARI200209040,2002,20904,ARI,LAN,PHO01,1,7,8
ARI200209090,2002,20909,ARI,SDN,PHO01,2,5,7
ARI200209100,2002,20910,ARI,SDN,PHO01,2,8,10
ARI200209110,2002,20911,ARI,SDN,PHO01,5,6,11
ARI200209130,2002,20913,ARI,MIL,PHO01,8,4,12
ARI200209140,2002,20914,ARI,MIL,PHO01,0,5,5
ARI200209150,2002,20915,ARI,MIL,PHO01,5,6,11
ARI200209260,2002,20926,ARI,COL,PHO01,2,4,6
ARI200209270,2002,20927,ARI,COL,PHO01,6,8,14
ARI200209280,2002,20928,ARI,COL,PHO01,8,17,25
ARI200209290,2002,20929,ARI,COL,PHO01,8,11,19
ARI200210010,2002,21001,ARI,SLN,PHO01,12,2,14
ARI200210030,2002,21003,ARI,SLN,PHO01,2,1,3
ARI200303310,2003,30331,ARI,LAN,PHO01,8,0,8
ARI200304010,2003,30401,ARI,LAN,PHO01,4,5,9
ARI200304020,2003,30402,ARI,LAN,PHO01,5,0,5
ARI200304110,2003,30411,ARI,MIL,PHO01,11,7,18
ARI200304120,2003,30412,ARI,MIL,PHO01,3,2,5
ARI200304130,2003,30413,ARI,MIL,PHO01,3,9,12
ARI200304140,2003,30414,ARI,COL,PHO01,5,3,8
ARI200304150,2003,30415,ARI,COL,PHO01,12,1,13
ARI200304160,2003,30416,ARI,COL,PHO01,3,4,7
ARI200304170,2003,30417,ARI,COL,PHO01,2,11,13
ARI200304280,2003,30428,ARI,FLO,PHO01,1,7,8
ARI200304290,2003,30429,ARI,FLO,PHO01,7,5,12
ARI200304300,2003,30430,ARI,FLO,PHO01,3,7,10
ARI200305010,2003,30501,ARI,FLO,PHO01,4,3,7
ARI200305020,2003,30502,ARI,ATL,PHO01,4,2,6
ARI200305030,2003,30503,ARI,ATL,PHO01,6,7,13
ARI200305040,2003,30504,ARI,ATL,PHO01,7,4,11
ARI200305050,2003,30505,ARI,PHI,PHO01,1,10,11
ARI200305060,2003,30506,ARI,PHI,PHO01,5,6,11
ARI200305070,2003,30507,ARI,PHI,PHO01,5,2,7
ARI200305160,2003,30516,ARI,PIT,PHO01,8,5,13
ARI200305170,2003,30517,ARI,PIT,PHO01,8,5,13
ARI200305180,2003,30518,ARI,PIT,PHO01,6,8,14
ARI200305190,2003,30519,ARI,SFN,PHO01,3,4,7
ARI200305200,2003,30520,ARI,SFN,PHO01,6,5,11
ARI200305210,2003,30521,ARI,SFN,PHO01,6,0,6
ARI200305230,2003,30523,ARI,SDN,PHO01,3,5,8
ARI200305240,2003,30524,ARI,SDN,PHO01,5,1,6
ARI200305250,2003,30525,ARI,SDN,PHO01,5,9,14
ARI200305260,2003,30526,ARI,SDN,PHO01,4,8,12
ARI200306030,2003,30603,ARI,CHA,PHO01,1,2,3
ARI200306040,2003,30604,ARI,CHA,PHO01,6,8,14
ARI200306050,2003,30605,ARI,CHA,PHO01,3,2,5
ARI200306060,2003,30606,ARI,CLE,PHO01,6,3,9
ARI200306070,2003,30607,ARI,CLE,PHO01,3,5,8
ARI200306080,2003,30608,ARI,CLE,PHO01,3,13,16
ARI200306200,2003,30620,ARI,CIN,PHO01,5,6,11
ARI200306210,2003,30621,ARI,CIN,PHO01,3,5,8
ARI200306220,2003,30622,ARI,CIN,PHO01,5,6,11
ARI200306230,2003,30623,ARI,HOU,PHO01,6,7,13
ARI200306240,2003,30624,ARI,HOU,PHO01,5,12,17
ARI200306250,2003,30625,ARI,HOU,PHO01,2,3,5
ARI200307070,2003,30707,ARI,COL,PHO01,6,14,20
ARI200307080,2003,30708,ARI,COL,PHO01,3,9,12
ARI200307090,2003,30709,ARI,SDN,PHO01,3,8,11
ARI200307100,2003,30710,ARI,SDN,PHO01,14,2,16
ARI200307110,2003,30711,ARI,SFN,PHO01,10,7,17
ARI200307120,2003,30712,ARI,SFN,PHO01,8,1,9
ARI200307130,2003,30713,ARI,SFN,PHO01,4,7,11
ARI200307250,2003,30725,ARI,LAN,PHO01,1,2,3
ARI200307260,2003,30726,ARI,LAN,PHO01,0,1,1
ARI200307270,2003,30727,ARI,LAN,PHO01,1,0,1
ARI200308050,2003,30805,ARI,MON,PHO01,5,8,13
ARI200308060,2003,30806,ARI,MON,PHO01,2,3,5
ARI200308070,2003,30807,ARI,MON,PHO01,4,5,9
ARI200308080,2003,30808,ARI,NYN,PHO01,3,1,4
ARI200308090,2003,30809,ARI,NYN,PHO01,1,2,3
ARI200308100,2003,30810,ARI,NYN,PHO01,4,7,11
ARI200308190,2003,30819,ARI,CIN,PHO01,1,6,7
ARI200308200,2003,30820,ARI,CIN,PHO01,2,0,2
ARI200308210,2003,30821,ARI,CIN,PHO01,3,9,12
ARI200308220,2003,30822,ARI,CHN,PHO01,4,1,5
ARI200308230,2003,30823,ARI,CHN,PHO01,2,13,15
ARI200308240,2003,30824,ARI,CHN,PHO01,5,3,8
ARI200308250,2003,30825,ARI,SDN,PHO01,8,11,19
ARI200308260,2003,30826,ARI,SDN,PHO01,5,4,9
ARI200308270,2003,30827,ARI,SDN,PHO01,10,2,12
ARI200308290,2003,30829,ARI,SFN,PHO01,4,5,9
ARI200308300,2003,30830,ARI,SFN,PHO01,2,1,3
ARI200308310,2003,30831,ARI,SFN,PHO01,3,1,4
ARI200309010,2003,30901,ARI,SFN,PHO01,2,0,2
ARI200309080,2003,30908,ARI,LAN,PHO01,10,3,13
ARI200309090,2003,30909,ARI,LAN,PHO01,4,1,5
ARI200309100,2003,30910,ARI,LAN,PHO01,4,5,9
ARI200309110,2003,30911,ARI,LAN,PHO01,0,2,2
ARI200309120,2003,30912,ARI,COL,PHO01,8,2,10
ARI200309130,2003,30913,ARI,COL,PHO01,6,16,22
ARI200309140,2003,30914,ARI,COL,PHO01,0,5,5
ARI200309260,2003,30926,ARI,SLN,PHO01,6,7,13
ARI200309270,2003,30927,ARI,SLN,PHO01,3,2,5
ARI200309280,2003,30928,ARI,SLN,PHO01,9,5,14
ARI200404060,2004,40406,ARI,COL,PHO01,6,2,8
ARI200404070,2004,40407,ARI,COL,PHO01,5,9,14
ARI200404080,2004,40408,ARI,COL,PHO01,5,6,11
ARI200404090,2004,40409,ARI,SLN,PHO01,13,6,19
ARI200404100,2004,40410,ARI,SLN,PHO01,10,2,12
ARI200404110,2004,40411,ARI,SLN,PHO01,6,5,11
ARI200404230,2004,40423,ARI,SDN,PHO01,2,5,7
ARI200404240,2004,40424,ARI,SDN,PHO01,4,2,6
ARI200404250,2004,40425,ARI,SDN,PHO01,7,12,19
ARI200404260,2004,40426,ARI,CHN,PHO01,0,9,9
ARI200404270,2004,40427,ARI,CHN,PHO01,1,10,11
ARI200404280,2004,40428,ARI,CHN,PHO01,4,3,7
ARI200405070,2004,40507,ARI,PHI,PHO01,4,1,5
ARI200405080,2004,40508,ARI,PHI,PHO01,8,7,15
ARI200405090,2004,40509,ARI,PHI,PHO01,7,1,8
ARI200405100,2004,40510,ARI,NYN,PHO01,8,12,20
ARI200405110,2004,40511,ARI,NYN,PHO01,5,9,14
ARI200405120,2004,40512,ARI,NYN,PHO01,1,0,1
ARI200405130,2004,40513,ARI,NYN,PHO01,7,4,11
ARI200405140,2004,40514,ARI,MON,PHO01,4,3,7
ARI200405150,2004,40515,ARI,MON,PHO01,5,0,5
ARI200405160,2004,40516,ARI,MON,PHO01,6,1,7
ARI200405310,2004,40531,ARI,SFN,PHO01,8,4,12
ARI200406010,2004,40601,ARI,SFN,PHO01,5,6,11
ARI200406020,2004,40602,ARI,SFN,PHO01,6,8,14
ARI200406030,2004,40603,ARI,SFN,PHO01,5,11,16
ARI200406040,2004,40604,ARI,LAN,PHO01,7,3,10
ARI200406050,2004,40605,ARI,LAN,PHO01,10,3,13
ARI200406060,2004,40606,ARI,LAN,PHO01,5,6,11
ARI200406150,2004,40615,ARI,NYA,PHO01,4,2,6
ARI200406160,2004,40616,ARI,NYA,PHO01,9,4,13
ARI200406170,2004,40617,ARI,NYA,PHO01,1,6,7
ARI200406180,2004,40618,ARI,TBA,PHO01,6,2,8
ARI200406190,2004,40619,ARI,TBA,PHO01,11,4,15
ARI200406200,2004,40620,ARI,TBA,PHO01,2,1,3
ARI200406280,2004,40628,ARI,SDN,PHO01,10,5,15
ARI200406290,2004,40629,ARI,SDN,PHO01,3,2,5
ARI200406300,2004,40630,ARI,SDN,PHO01,5,8,13
ARI200407010,2004,40701,ARI,SDN,PHO01,5,7,12
ARI200407020,2004,40702,ARI,MIN,PHO01,6,5,11
ARI200407030,2004,40703,ARI,MIN,PHO01,8,4,12
ARI200407040,2004,40704,ARI,MIN,PHO01,2,6,8
ARI200407150,2004,40715,ARI,LAN,PHO01,4,3,7
ARI200407160,2004,40716,ARI,LAN,PHO01,6,2,8
ARI200407170,2004,40717,ARI,LAN,PHO01,7,6,13
ARI200407180,2004,40718,ARI,LAN,PHO01,10,3,13
ARI200407190,2004,40719,ARI,SFN,PHO01,6,1,7
ARI200407200,2004,40720,ARI,SFN,PHO01,3,1,4
ARI200407210,2004,40721,ARI,HOU,PHO01,5,2,7
ARI200407220,2004,40722,ARI,HOU,PHO01,10,3,13
ARI200407230,2004,40723,ARI,COL,PHO01,8,2,10
ARI200407240,2004,40724,ARI,COL,PHO01,8,2,10
ARI200407250,2004,40725,ARI,COL,PHO01,3,2,5
ARI200408030,2004,40803,ARI,FLO,PHO01,3,5,8
ARI200408040,2004,40804,ARI,FLO,PHO01,6,11,17
ARI200408050,2004,40805,ARI,FLO,PHO01,11,5,16
ARI200408060,2004,40806,ARI,ATL,PHO01,4,2,6
ARI200408070,2004,40807,ARI,ATL,PHO01,6,2,8
ARI200408080,2004,40808,ARI,ATL,PHO01,11,4,15
ARI200408160,2004,40816,ARI,PIT,PHO01,8,7,15
ARI200408170,2004,40817,ARI,PIT,PHO01,7,1,8
ARI200408180,2004,40818,ARI,PIT,PHO01,3,6,9
ARI200408200,2004,40820,ARI,CIN,PHO01,2,0,2
ARI200408210,2004,40821,ARI,CIN,PHO01,1,2,3
ARI200408220,2004,40822,ARI,CIN,PHO01,11,1,12
ARI200408310,2004,40831,ARI,LAN,PHO01,4,1,5
ARI200409010,2004,40901,ARI,LAN,PHO01,1,3,4
ARI200409020,2004,40902,ARI,LAN,PHO01,8,4,12
ARI200409100,2004,40910,ARI,SFN,PHO01,1,2,3
ARI200409110,2004,40911,ARI,SFN,PHO01,5,3,8
ARI200409120,2004,40912,ARI,SFN,PHO01,5,2,7
ARI200409130,2004,40913,ARI,COL,PHO01,9,2,11
ARI200409140,2004,40914,ARI,COL,PHO01,3,4,7
ARI200409150,2004,40915,ARI,COL,PHO01,2,3,5
ARI200409160,2004,40916,ARI,COL,PHO01,5,8,13
ARI200409270,2004,40927,ARI,MIL,PHO01,1,3,4
ARI200409280,2004,40928,ARI,MIL,PHO01,8,9,17
ARI200409290,2004,40929,ARI,MIL,PHO01,4,1,5
ARI200410010,2004,41001,ARI,SDN,PHO01,3,2,5
ARI200410020,2004,41002,ARI,SDN,PHO01,6,7,13
ARI200410030,2004,41003,ARI,SDN,PHO01,1,4,5
ARI200504040,2005,50404,ARI,CHN,PHO01,16,6,22
ARI200504050,2005,50405,ARI,CHN,PHO01,4,5,9
ARI200504060,2005,50406,ARI,CHN,PHO01,3,8,11
ARI200504080,2005,50408,ARI,LAN,PHO01,8,7,15
ARI200504090,2005,50409,ARI,LAN,PHO01,12,10,22
ARI200504100,2005,50410,ARI,LAN,PHO01,4,5,9
ARI200504110,2005,50411,ARI,COL,PHO01,0,2,2
ARI200504120,2005,50412,ARI,COL,PHO01,2,4,6
ARI200504130,2005,50413,ARI,COL,PHO01,2,5,7
ARI200504220,2005,50422,ARI,SDN,PHO01,3,5,8
ARI200504230,2005,50423,ARI,SDN,PHO01,1,2,3
ARI200504240,2005,50424,ARI,SDN,PHO01,6,8,14
ARI200505020,2005,50502,ARI,SFN,PHO01,9,8,17
ARI200505030,2005,50503,ARI,SFN,PHO01,2,3,5
ARI200505040,2005,50504,ARI,SFN,PHO01,2,6,8
ARI200505050,2005,50505,ARI,PIT,PHO01,6,2,8
ARI200505060,2005,50506,ARI,PIT,PHO01,4,8,12
ARI200505070,2005,50507,ARI,PIT,PHO01,3,2,5
ARI200505080,2005,50508,ARI,PIT,PHO01,16,2,18
ARI200505090,2005,50509,ARI,WAS,PHO01,4,3,7
ARI200505100,2005,50510,ARI,WAS,PHO01,2,3,5
ARI200505110,2005,50511,ARI,WAS,PHO01,2,3,5
ARI200505240,2005,50524,ARI,SDN,PHO01,9,5,14
ARI200505250,2005,50525,ARI,SDN,PHO01,11,12,23
ARI200505260,2005,50526,ARI,SDN,PHO01,10,0,10
ARI200505270,2005,50527,ARI,LAN,PHO01,7,4,11
ARI200505280,2005,50528,ARI,LAN,PHO01,4,5,9
ARI200505290,2005,50529,ARI,LAN,PHO01,6,3,9
ARI200506070,2005,50607,ARI,MIN,PHO01,9,8,17
ARI200506080,2005,50608,ARI,MIN,PHO01,10,0,10
ARI200506090,2005,50609,ARI,MIN,PHO01,3,4,7
ARI200506100,2005,50610,ARI,KCA,PHO01,11,12,23
ARI200506110,2005,50611,ARI,KCA,PHO01,8,5,13
ARI200506120,2005,50612,ARI,KCA,PHO01,9,4,13
ARI200506240,2005,50624,ARI,DET,PHO01,1,2,3
ARI200506250,2005,50625,ARI,DET,PHO01,5,1,6
ARI200506260,2005,50626,ARI,DET,PHO01,7,13,20
ARI200506280,2005,50628,ARI,SFN,PHO01,11,3,14
ARI200506290,2005,50629,ARI,SFN,PHO01,4,2,6
ARI200506300,2005,50630,ARI,SFN,PHO01,9,2,11
ARI200507040,2005,50704,ARI,SLN,PHO01,10,3,13
ARI200507050,2005,50705,ARI,SLN,PHO01,7,1,8
ARI200507060,2005,50706,ARI,SLN,PHO01,2,1,3
ARI200507070,2005,50707,ARI,SLN,PHO01,1,2,3
ARI200507080,2005,50708,ARI,CIN,PHO01,4,3,7
ARI200507090,2005,50709,ARI,CIN,PHO01,6,2,8
ARI200507100,2005,50710,ARI,CIN,PHO01,0,2,2
ARI200507180,2005,50718,ARI,FLO,PHO01,7,8,15
ARI200507190,2005,50719,ARI,FLO,PHO01,6,3,9
ARI200507200,2005,50720,ARI,FLO,PHO01,9,2,11
ARI200507220,2005,50722,ARI,ATL,PHO01,5,6,11
ARI200507230,2005,50723,ARI,ATL,PHO01,3,2,5
ARI200507240,2005,50724,ARI,ATL,PHO01,2,3,5
ARI200508020,2005,50802,ARI,HOU,PHO01,3,1,4
ARI200508030,2005,50803,ARI,HOU,PHO01,7,0,7
ARI200508040,2005,50804,ARI,HOU,PHO01,3,7,10
ARI200508050,2005,50805,ARI,COL,PHO01,6,4,10
ARI200508060,2005,50806,ARI,COL,PHO01,14,7,21
ARI200508070,2005,50807,ARI,COL,PHO01,4,9,13
ARI200508220,2005,50822,ARI,NYN,PHO01,4,1,5
ARI200508230,2005,50823,ARI,NYN,PHO01,14,1,15
ARI200508240,2005,50824,ARI,NYN,PHO01,18,4,22
ARI200508250,2005,50825,ARI,NYN,PHO01,3,1,4
ARI200508260,2005,50826,ARI,PHI,PHO01,11,3,14
ARI200508270,2005,50827,ARI,PHI,PHO01,0,2,2
ARI200508280,2005,50828,ARI,PHI,PHO01,5,10,15
ARI200509020,2005,50902,ARI,SFN,PHO01,6,3,9
ARI200509030,2005,50903,ARI,SFN,PHO01,9,4,13
ARI200509040,2005,50904,ARI,SFN,PHO01,3,2,5
ARI200509130,2005,50913,ARI,MIL,PHO01,3,1,4
ARI200509140,2005,50914,ARI,MIL,PHO01,1,2,3
ARI200509150,2005,50915,ARI,MIL,PHO01,14,2,16
ARI200509160,2005,50916,ARI,COL,PHO01,6,5,11
ARI200509170,2005,50917,ARI,COL,PHO01,5,6,11
ARI200509180,2005,50918,ARI,COL,PHO01,7,1,8
ARI200509200,2005,50920,ARI,LAN,PHO01,1,4,5
ARI200509210,2005,50921,ARI,LAN,PHO01,2,3,5
ARI200509220,2005,50922,ARI,LAN,PHO01,4,7,11
ARI200509230,2005,50923,ARI,SDN,PHO01,5,3,8
ARI200509240,2005,50924,ARI,SDN,PHO01,5,8,13
ARI200509250,2005,50925,ARI,SDN,PHO01,3,4,7
ARI200604110,2006,60411,ARI,COL,PHO01,6,5,11
ARI200604120,2006,60412,ARI,COL,PHO01,4,5,9
ARI200604130,2006,60413,ARI,COL,PHO01,5,3,8
ARI200604140,2006,60414,ARI,HOU,PHO01,1,5,6
ARI200604150,2006,60415,ARI,HOU,PHO01,10,0,10
ARI200604160,2006,60416,ARI,HOU,PHO01,8,5,13
ARI200604170,2006,60417,ARI,SFN,PHO01,10,9,19
ARI200604180,2006,60418,ARI,SFN,PHO01,4,7,11
ARI200604190,2006,60419,ARI,SFN,PHO01,3,10,13
ARI200604200,2006,60420,ARI,SFN,PHO01,9,7,16
ARI200605010,2006,60501,ARI,LAN,PHO01,2,3,5
ARI200605020,2006,60502,ARI,LAN,PHO01,8,10,18
ARI200605030,2006,60503,ARI,CHN,PHO01,1,5,6
ARI200605040,2006,60504,ARI,CHN,PHO01,0,6,6
ARI200605050,2006,60505,ARI,CIN,PHO01,1,7,8
ARI200605060,2006,60506,ARI,CIN,PHO01,1,3,4
ARI200605070,2006,60507,ARI,CIN,PHO01,9,8,17
ARI200605150,2006,60515,ARI,SDN,PHO01,5,6,11
ARI200605160,2006,60516,ARI,SDN,PHO01,2,5,7
ARI200605170,2006,60517,ARI,SDN,PHO01,14,10,24
ARI200605190,2006,60519,ARI,ATL,PHO01,9,10,19
ARI200605200,2006,60520,ARI,ATL,PHO01,0,13,13
ARI200605210,2006,60521,ARI,ATL,PHO01,2,1,3
ARI200605220,2006,60522,ARI,PIT,PHO01,3,4,7
ARI200605230,2006,60523,ARI,PIT,PHO01,3,7,10
ARI200605240,2006,60524,ARI,PIT,PHO01,7,8,15
ARI200606050,2006,60605,ARI,PHI,PHO01,4,3,7
ARI200606060,2006,60606,ARI,PHI,PHO01,10,1,11
ARI200606070,2006,60607,ARI,PHI,PHO01,7,3,10
ARI200606080,2006,60608,ARI,NYN,PHO01,7,1,8
ARI200606090,2006,60609,ARI,NYN,PHO01,10,6,16
ARI200606100,2006,60610,ARI,NYN,PHO01,5,0,5
ARI200606110,2006,60611,ARI,NYN,PHO01,15,2,17
ARI200606130,2006,60613,ARI,SFN,PHO01,1,2,3
ARI200606140,2006,60614,ARI,SFN,PHO01,11,4,15
ARI200606150,2006,60615,ARI,SFN,PHO01,8,2,10
ARI200606230,2006,60623,ARI,ANA,PHO01,8,2,10
ARI200606240,2006,60624,ARI,ANA,PHO01,6,4,10
ARI200606250,2006,60625,ARI,ANA,PHO01,7,9,16
ARI200606270,2006,60627,ARI,SEA,PHO01,11,7,18
ARI200606280,2006,60628,ARI,SEA,PHO01,10,3,13
ARI200606290,2006,60629,ARI,SEA,PHO01,3,2,5
ARI200607140,2006,60714,ARI,MIL,PHO01,3,4,7
ARI200607150,2006,60715,ARI,MIL,PHO01,1,8,9
ARI200607160,2006,60716,ARI,MIL,PHO01,10,5,15
ARI200607170,2006,60717,ARI,LAN,PHO01,3,8,11
ARI200607180,2006,60718,ARI,LAN,PHO01,4,1,5
ARI200607190,2006,60719,ARI,LAN,PHO01,0,8,8
ARI200607200,2006,60720,ARI,LAN,PHO01,2,5,7
ARI200607210,2006,60721,ARI,COL,PHO01,2,6,8
ARI200607220,2006,60722,ARI,COL,PHO01,3,4,7
ARI200607230,2006,60723,ARI,COL,PHO01,9,7,16
ARI200608040,2006,60804,ARI,HOU,PHO01,8,7,15
ARI200608050,2006,60805,ARI,HOU,PHO01,9,3,12
ARI200608060,2006,60806,ARI,HOU,PHO01,3,4,7
ARI200608070,2006,60807,ARI,SFN,PHO01,8,4,12
ARI200608080,2006,60808,ARI,SFN,PHO01,1,5,6
ARI200608090,2006,60809,ARI,SFN,PHO01,3,5,8
ARI200608110,2006,60811,ARI,FLO,PHO01,4,1,5
ARI200608120,2006,60812,ARI,FLO,PHO01,3,6,9
ARI200608130,2006,60813,ARI,FLO,PHO01,6,5,11
ARI200608250,2006,60825,ARI,LAN,PHO01,7,9,16
ARI200608260,2006,60826,ARI,LAN,PHO01,4,3,7
ARI200608270,2006,60827,ARI,LAN,PHO01,6,3,9
ARI200608280,2006,60828,ARI,SDN,PHO01,4,7,11
ARI200608290,2006,60829,ARI,SDN,PHO01,8,3,11
ARI200608300,2006,60830,ARI,SDN,PHO01,4,1,5
ARI200609070,2006,60907,ARI,SLN,PHO01,6,2,8
ARI200609080,2006,60908,ARI,SLN,PHO01,1,13,14
ARI200609090,2006,60909,ARI,SLN,PHO01,0,3,3
ARI200609100,2006,60910,ARI,SLN,PHO01,7,9,16
ARI200609110,2006,60911,ARI,WAS,PHO01,7,6,13
ARI200609120,2006,60912,ARI,WAS,PHO01,5,4,9
ARI200609130,2006,60913,ARI,WAS,PHO01,2,4,6
ARI200609150,2006,60915,ARI,COL,PHO01,1,5,6
ARI200609160,2006,60916,ARI,COL,PHO01,6,7,13
ARI200609170,2006,60917,ARI,COL,PHO01,6,1,7
ARI200609280,2006,60928,ARI,SDN,PHO01,12,4,16
ARI200609290,2006,60929,ARI,SDN,PHO01,1,3,4
ARI200609300,2006,60930,ARI,SDN,PHO01,3,1,4
ARI200610010,2006,61001,ARI,SDN,PHO01,7,6,13
ARI200704090,2007,70409,ARI,CIN,PHO01,2,3,5
ARI200704100,2007,70410,ARI,CIN,PHO01,4,5,9
ARI200704110,2007,70411,ARI,CIN,PHO01,3,2,5
ARI200704130,2007,70413,ARI,COL,PHO01,6,3,9
ARI200704140,2007,70414,ARI,COL,PHO01,4,5,9
ARI200704150,2007,70415,ARI,COL,PHO01,4,6,10
ARI200704160,2007,70416,ARI,LAN,PHO01,5,1,6
ARI200704170,2007,70417,ARI,LAN,PHO01,6,4,10
ARI200704240,2007,70424,ARI,SDN,PHO01,10,5,15
ARI200704250,2007,70425,ARI,SDN,PHO01,2,3,5
ARI200704260,2007,70426,ARI,SDN,PHO01,4,7,11
ARI200704270,2007,70427,ARI,SFN,PHO01,2,3,5
ARI200704280,2007,70428,ARI,SFN,PHO01,4,5,9
ARI200704290,2007,70429,ARI,SFN,PHO01,4,5,9
ARI200705030,2007,70503,ARI,NYN,PHO01,9,4,13
ARI200705040,2007,70504,ARI,NYN,PHO01,5,3,8
ARI200705050,2007,70505,ARI,NYN,PHO01,6,2,8
ARI200705060,2007,70506,ARI,NYN,PHO01,1,3,4
ARI200705070,2007,70507,ARI,PHI,PHO01,3,4,7
ARI200705080,2007,70508,ARI,PHI,PHO01,2,3,5
ARI200705090,2007,70509,ARI,PHI,PHO01,9,3,12
ARI200705210,2007,70521,ARI,COL,PHO01,5,6,11
ARI200705220,2007,70522,ARI,COL,PHO01,3,1,4
ARI200705230,2007,70523,ARI,COL,PHO01,2,0,2
ARI200705240,2007,70524,ARI,HOU,PHO01,1,9,10
ARI200705250,2007,70525,ARI,HOU,PHO01,3,13,16
ARI200705260,2007,70526,ARI,HOU,PHO01,4,5,9
ARI200705270,2007,70527,ARI,HOU,PHO01,4,8,12
ARI200706050,2007,70605,ARI,SFN,PHO01,3,4,7
ARI200706060,2007,70606,ARI,SFN,PHO01,0,1,1
ARI200706070,2007,70607,ARI,SFN,PHO01,5,4,9
ARI200706080,2007,70608,ARI,BOS,PHO01,10,3,13
ARI200706090,2007,70609,ARI,BOS,PHO01,4,3,7
ARI200706100,2007,70610,ARI,BOS,PHO01,1,5,6
ARI200706180,2007,70618,ARI,TBA,PHO01,10,2,12
ARI200706190,2007,70619,ARI,TBA,PHO01,8,10,18
ARI200706200,2007,70620,ARI,TBA,PHO01,4,7,11
ARI200706220,2007,70622,ARI,BAL,PHO01,7,1,8
ARI200706230,2007,70623,ARI,BAL,PHO01,4,7,11
ARI200706240,2007,70624,ARI,BAL,PHO01,3,8,11
ARI200706250,2007,70625,ARI,LAN,PHO01,8,1,9
ARI200706260,2007,70626,ARI,LAN,PHO01,6,5,11
ARI200706270,2007,70627,ARI,LAN,PHO01,0,2,2
ARI200706280,2007,70628,ARI,LAN,PHO01,9,5,14
ARI200707130,2007,70713,ARI,SDN,PHO01,3,8,11
ARI200707140,2007,70714,ARI,SDN,PHO01,4,5,9
ARI200707150,2007,70715,ARI,SDN,PHO01,4,0,4
ARI200707230,2007,70723,ARI,FLO,PHO01,3,4,7
ARI200707240,2007,70724,ARI,FLO,PHO01,3,9,12
ARI200707250,2007,70725,ARI,FLO,PHO01,0,7,7
ARI200707260,2007,70726,ARI,FLO,PHO01,4,7,11
ARI200707270,2007,70727,ARI,ATL,PHO01,7,8,15
ARI200707280,2007,70728,ARI,ATL,PHO01,3,4,7
ARI200707290,2007,70729,ARI,ATL,PHO01,14,0,14
ARI200708070,2007,70807,ARI,PIT,PHO01,8,3,11
ARI200708080,2007,70808,ARI,PIT,PHO01,6,10,16
ARI200708090,2007,70809,ARI,PIT,PHO01,2,4,6
ARI200708100,2007,70810,ARI,WAS,PHO01,4,11,15
ARI200708110,2007,70811,ARI,WAS,PHO01,0,1,1
ARI200708120,2007,70812,ARI,WAS,PHO01,7,6,13
ARI200708200,2007,70820,ARI,MIL,PHO01,9,0,9
ARI200708210,2007,70821,ARI,MIL,PHO01,7,4,11
ARI200708220,2007,70822,ARI,MIL,PHO01,2,3,5
ARI200708240,2007,70824,ARI,CHN,PHO01,6,2,8
ARI200708250,2007,70825,ARI,CHN,PHO01,1,3,4
ARI200708260,2007,70826,ARI,CHN,PHO01,4,5,9
ARI200708310,2007,70831,ARI,COL,PHO01,7,3,10
ARI200709010,2007,70901,ARI,COL,PHO01,7,13,20
ARI200709020,2007,70902,ARI,COL,PHO01,4,3,7
ARI200709030,2007,70903,ARI,SDN,PHO01,10,2,12
ARI200709040,2007,70904,ARI,SDN,PHO01,1,9,10
ARI200709050,2007,70905,ARI,SDN,PHO01,6,9,15
ARI200709070,2007,70907,ARI,SLN,PHO01,2,4,6
ARI200709080,2007,70908,ARI,SLN,PHO01,8,9,17
ARI200709090,2007,70909,ARI,SLN,PHO01,5,6,11
ARI200709170,2007,70917,ARI,SFN,PHO01,8,5,13
ARI200709180,2007,70918,ARI,SFN,PHO01,0,5,5
ARI200709190,2007,70919,ARI,SFN,PHO01,4,6,10
ARI200709210,2007,70921,ARI,LAN,PHO01,3,12,15
ARI200709220,2007,70922,ARI,LAN,PHO01,2,6,8
ARI200709230,2007,70923,ARI,LAN,PHO01,7,1,8
ARI200710030,2007,71003,ARI,CHN,PHO01,1,3,4
ARI200710040,2007,71004,ARI,CHN,PHO01,4,8,12
ARI200710110,2007,71011,ARI,COL,PHO01,5,1,6
ARI200710120,2007,71012,ARI,COL,PHO01,3,2,5
ARI200804070,2008,80407,ARI,LAN,PHO01,3,9,12
ARI200804080,2008,80408,ARI,LAN,PHO01,5,10,15
ARI200804090,2008,80409,ARI,LAN,PHO01,3,4,7
ARI200804110,2008,80411,ARI,COL,PHO01,2,8,10
ARI200804120,2008,80412,ARI,COL,PHO01,3,10,13
ARI200804130,2008,80413,ARI,COL,PHO01,13,5,18
ARI200804180,2008,80418,ARI,SDN,PHO01,0,9,9
ARI200804190,2008,80419,ARI,SDN,PHO01,3,10,13
ARI200804200,2008,80420,ARI,SDN,PHO01,9,4,13
ARI200804210,2008,80421,ARI,SFN,PHO01,2,4,6
ARI200804220,2008,80422,ARI,SFN,PHO01,4,5,9
ARI200804280,2008,80428,ARI,HOU,PHO01,3,5,8
ARI200804290,2008,80429,ARI,HOU,PHO01,6,4,10
ARI200804300,2008,80430,ARI,HOU,PHO01,7,8,15
ARI200805020,2008,80502,ARI,NYN,PHO01,7,2,9
ARI200805030,2008,80503,ARI,NYN,PHO01,4,10,14
ARI200805040,2008,80504,ARI,NYN,PHO01,5,2,7
ARI200805050,2008,80505,ARI,PHI,PHO01,11,4,15
ARI200805060,2008,80506,ARI,PHI,PHO01,4,6,10
ARI200805070,2008,80507,ARI,PHI,PHO01,5,4,9
ARI200805080,2008,80508,ARI,PHI,PHO01,3,8,11
ARI200805130,2008,80513,ARI,COL,PHO01,4,8,12
ARI200805140,2008,80514,ARI,COL,PHO01,3,4,7
ARI200805150,2008,80515,ARI,COL,PHO01,5,8,13
ARI200805160,2008,80516,ARI,DET,PHO01,3,4,7
ARI200805170,2008,80517,ARI,DET,PHO01,3,2,5
ARI200805180,2008,80518,ARI,DET,PHO01,0,4,4
ARI200805270,2008,80527,ARI,SFN,PHO01,6,3,9
ARI200805280,2008,80528,ARI,SFN,PHO01,11,3,14
ARI200805290,2008,80529,ARI,SFN,PHO01,4,3,7
ARI200805300,2008,80530,ARI,WAS,PHO01,7,4,11
ARI200805310,2008,80531,ARI,WAS,PHO01,0,4,4
ARI200806010,2008,80601,ARI,WAS,PHO01,0,5,5
ARI200806130,2008,80613,ARI,KCA,PHO01,0,1,1
ARI200806140,2008,80614,ARI,KCA,PHO01,12,3,15
ARI200806150,2008,80615,ARI,KCA,PHO01,8,3,11
ARI200806170,2008,80617,ARI,OAK,PHO01,15,1,16
ARI200806180,2008,80618,ARI,OAK,PHO01,1,11,12
ARI200806190,2008,80619,ARI,OAK,PHO01,1,2,3
ARI200806300,2008,80630,ARI,MIL,PHO01,3,6,9
ARI200807010,2008,80701,ARI,MIL,PHO01,8,6,14
ARI200807020,2008,80702,ARI,MIL,PHO01,4,3,7
ARI200807030,2008,80703,ARI,MIL,PHO01,5,6,11
ARI200807040,2008,80704,ARI,SDN,PHO01,5,1,6
ARI200807050,2008,80705,ARI,SDN,PHO01,4,2,6
ARI200807060,2008,80706,ARI,SDN,PHO01,2,3,5
ARI200807180,2008,80718,ARI,LAN,PHO01,8,7,15
ARI200807190,2008,80719,ARI,LAN,PHO01,2,3,5
ARI200807200,2008,80720,ARI,LAN,PHO01,6,5,11
ARI200807210,2008,80721,ARI,CHN,PHO01,0,2,2
ARI200807220,2008,80722,ARI,CHN,PHO01,2,9,11
ARI200807230,2008,80723,ARI,CHN,PHO01,10,6,16
ARI200808040,2008,80804,ARI,PIT,PHO01,7,13,20
ARI200808050,2008,80805,ARI,PIT,PHO01,1,3,4
ARI200808060,2008,80806,ARI,PIT,PHO01,2,0,2
ARI200808070,2008,80807,ARI,ATL,PHO01,6,4,10
ARI200808080,2008,80808,ARI,ATL,PHO01,11,6,17
ARI200808090,2008,80809,ARI,ATL,PHO01,11,4,15
ARI200808100,2008,80810,ARI,ATL,PHO01,1,6,7
ARI200808190,2008,80819,ARI,SDN,PHO01,6,7,13
ARI200808200,2008,80820,ARI,SDN,PHO01,6,8,14
ARI200808210,2008,80821,ARI,SDN,PHO01,1,4,5
ARI200808220,2008,80822,ARI,FLO,PHO01,5,4,9
ARI200808230,2008,80823,ARI,FLO,PHO01,1,7,8
ARI200808240,2008,80824,ARI,FLO,PHO01,5,2,7
ARI200808290,2008,80829,ARI,LAN,PHO01,3,9,12
ARI200808300,2008,80830,ARI,LAN,PHO01,6,2,8
ARI200808310,2008,80831,ARI,LAN,PHO01,8,1,9
ARI200809010,2008,80901,ARI,SLN,PHO01,6,8,14
ARI200809020,2008,80902,ARI,SLN,PHO01,8,2,10
ARI200809030,2008,80903,ARI,SLN,PHO01,3,4,7
ARI200809120,2008,80912,ARI,CIN,PHO01,2,3,5
ARI200809130,2008,80913,ARI,CIN,PHO01,3,2,5
ARI200809140,2008,80914,ARI,CIN,PHO01,2,1,3
ARI200809150,2008,80915,ARI,SFN,PHO01,1,3,4
ARI200809160,2008,80916,ARI,SFN,PHO01,0,2,2
ARI200809170,2008,80917,ARI,SFN,PHO01,6,7,13
ARI200809180,2008,80918,ARI,SFN,PHO01,2,3,5
ARI200809260,2008,80926,ARI,COL,PHO01,4,6,10
ARI200809270,2008,80927,ARI,COL,PHO01,4,6,10
ARI200809280,2008,80928,ARI,COL,PHO01,1,2,3
ARI200904060,2009,90406,ARI,COL,PHO01,8,9,17
ARI200904070,2009,90407,ARI,COL,PHO01,3,0,3
ARI200904080,2009,90408,ARI,COL,PHO01,9,2,11
ARI200904100,2009,90410,ARI,LAN,PHO01,4,9,13
ARI200904110,2009,90411,ARI,LAN,PHO01,11,2,13
ARI200904120,2009,90412,ARI,LAN,PHO01,3,1,4
ARI200904130,2009,90413,ARI,SLN,PHO01,2,1,3
ARI200904140,2009,90414,ARI,SLN,PHO01,6,7,13
ARI200904150,2009,90415,ARI,SLN,PHO01,12,7,19
ARI200904200,2009,90420,ARI,COL,PHO01,3,6,9
ARI200904210,2009,90421,ARI,COL,PHO01,9,6,15
ARI200904220,2009,90422,ARI,COL,PHO01,0,2,2
ARI200904240,2009,90424,ARI,SFN,PHO01,5,1,6
ARI200904250,2009,90425,ARI,SFN,PHO01,5,3,8
ARI200904260,2009,90426,ARI,SFN,PHO01,4,5,9
ARI200904270,2009,90427,ARI,CHN,PHO01,2,7,9
ARI200904280,2009,90428,ARI,CHN,PHO01,11,3,14
ARI200904290,2009,90429,ARI,CHN,PHO01,0,10,10
ARI200905080,2009,90508,ARI,WAS,PHO01,5,4,9
ARI200905090,2009,90509,ARI,WAS,PHO01,2,1,3
ARI200905100,2009,90510,ARI,WAS,PHO01,8,10,18
ARI200905110,2009,90511,ARI,CIN,PHO01,13,5,18
ARI200905120,2009,90512,ARI,CIN,PHO01,3,1,4
ARI200905130,2009,90513,ARI,CIN,PHO01,10,3,13
ARI200905250,2009,90525,ARI,SDN,PHO01,9,7,16
ARI200905260,2009,90526,ARI,SDN,PHO01,5,6,11
ARI200905270,2009,90527,ARI,SDN,PHO01,8,5,13
ARI200905280,2009,90528,ARI,ATL,PHO01,2,5,7
ARI200905290,2009,90529,ARI,ATL,PHO01,10,6,16
ARI200905300,2009,90530,ARI,ATL,PHO01,2,3,5
ARI200905310,2009,90531,ARI,ATL,PHO01,9,3,12
ARI200906090,2009,90609,ARI,SFN,PHO01,9,4,13
ARI200906100,2009,90610,ARI,SFN,PHO01,6,4,10
ARI200906110,2009,90611,ARI,SFN,PHO01,1,2,3
ARI200906120,2009,90612,ARI,HOU,PHO01,1,8,9
ARI200906130,2009,90613,ARI,HOU,PHO01,6,4,10
ARI200906140,2009,90614,ARI,HOU,PHO01,8,3,11
ARI200906230,2009,90623,ARI,TEX,PHO01,2,8,10
ARI200906240,2009,90624,ARI,TEX,PHO01,2,1,3
ARI200906250,2009,90625,ARI,TEX,PHO01,9,8,17
ARI200906260,2009,90626,ARI,ANA,PHO01,12,3,15
ARI200906270,2009,90627,ARI,ANA,PHO01,2,1,3
ARI200906280,2009,90628,ARI,ANA,PHO01,12,8,20
ARI200907060,2009,90706,ARI,SDN,PHO01,5,6,11
ARI200907070,2009,90707,ARI,SDN,PHO01,3,4,7
ARI200907080,2009,90708,ARI,SDN,PHO01,2,6,8
ARI200907090,2009,90709,ARI,FLO,PHO01,14,7,21
ARI200907100,2009,90710,ARI,FLO,PHO01,0,8,8
ARI200907110,2009,90711,ARI,FLO,PHO01,1,5,6
ARI200907120,2009,90712,ARI,FLO,PHO01,8,1,9
ARI200907230,2009,90723,ARI,PIT,PHO01,4,11,15
ARI200907240,2009,90724,ARI,PIT,PHO01,10,3,13
ARI200907250,2009,90725,ARI,PIT,PHO01,0,7,7
ARI200907260,2009,90726,ARI,PIT,PHO01,0,9,9
ARI200907270,2009,90727,ARI,PHI,PHO01,6,2,8
ARI200907280,2009,90728,ARI,PHI,PHO01,4,3,7
ARI200907290,2009,90729,ARI,PHI,PHO01,0,4,4
ARI200908100,2009,90810,ARI,NYN,PHO01,4,7,11
ARI200908110,2009,90811,ARI,NYN,PHO01,2,6,8
ARI200908120,2009,90812,ARI,NYN,PHO01,6,4,10
ARI200908140,2009,90814,ARI,LAN,PHO01,1,4,5
ARI200908150,2009,90815,ARI,LAN,PHO01,3,4,7
ARI200908160,2009,90816,ARI,LAN,PHO01,9,3,12
ARI200908280,2009,90828,ARI,HOU,PHO01,7,14,21
ARI200908290,2009,90829,ARI,HOU,PHO01,0,9,9
ARI200908300,2009,90830,ARI,HOU,PHO01,3,4,7
ARI200909070,2009,90907,ARI,LAN,PHO01,7,2,9
ARI200909080,2009,90908,ARI,LAN,PHO01,5,4,9
ARI200909090,2009,90909,ARI,LAN,PHO01,3,4,7
ARI200909110,2009,90911,ARI,MIL,PHO01,6,3,9
ARI200909120,2009,90912,ARI,MIL,PHO01,9,2,11
ARI200909130,2009,90913,ARI,MIL,PHO01,5,3,8
ARI200909180,2009,90918,ARI,COL,PHO01,5,7,12
ARI200909190,2009,90919,ARI,COL,PHO01,10,4,14
ARI200909200,2009,90920,ARI,COL,PHO01,5,1,6
ARI200909210,2009,90921,ARI,SFN,PHO01,5,4,9
ARI200909220,2009,90922,ARI,SFN,PHO01,8,10,18
ARI200909230,2009,90923,ARI,SFN,PHO01,5,2,7
ARI200909250,2009,90925,ARI,SDN,PHO01,4,0,4
ARI200909260,2009,90926,ARI,SDN,PHO01,5,8,13
ARI200909270,2009,90927,ARI,SDN,PHO01,4,7,11
ATL200004030,2000,403,ATL,COL,ATL02,0,2,2
ATL200004040,2000,404,ATL,COL,ATL02,5,3,8
ATL200004050,2000,405,ATL,COL,ATL02,6,9,15
ATL200004070,2000,407,ATL,SFN,ATL02,6,2,8
ATL200004080,2000,408,ATL,SFN,ATL02,5,7,12
ATL200004090,2000,409,ATL,SFN,ATL02,3,9,12
ATL200004180,2000,418,ATL,PHI,ATL02,3,4,7
ATL200004190,2000,419,ATL,PHI,ATL02,1,10,11
ATL200004200,2000,420,ATL,PHI,ATL02,4,6,10
ATL200004210,2000,421,ATL,PIT,ATL02,2,6,8
ATL200004220,2000,422,ATL,PIT,ATL02,2,4,6
ATL200004230,2000,423,ATL,PIT,ATL02,3,5,8
ATL200004250,2000,425,ATL,LAN,ATL02,0,1,1
ATL200004260,2000,426,ATL,LAN,ATL02,1,5,6
ATL200004270,2000,427,ATL,LAN,ATL02,3,6,9
ATL200005050,2000,505,ATL,PHI,ATL02,5,6,11
ATL200005060,2000,506,ATL,PHI,ATL02,6,0,6
ATL200005070,2000,507,ATL,PHI,ATL02,7,4,11
ATL200005160,2000,516,ATL,SFN,ATL02,7,9,16
ATL200005170,2000,517,ATL,SFN,ATL02,4,5,9
ATL200005180,2000,518,ATL,SFN,ATL02,2,3,5
ATL200005190,2000,519,ATL,SDN,ATL02,11,7,18
ATL200005200,2000,520,ATL,SDN,ATL02,6,10,16
ATL200005210,2000,521,ATL,SDN,ATL02,6,12,18
ATL200006020,2000,602,ATL,NYA,ATL02,5,2,7
ATL200006030,2000,603,ATL,NYA,ATL02,7,11,18
ATL200006040,2000,604,ATL,NYA,ATL02,7,6,13
ATL200006050,2000,605,ATL,TOR,ATL02,9,3,12
ATL200006060,2000,606,ATL,TOR,ATL02,6,7,13
ATL200006070,2000,607,ATL,TOR,ATL02,12,8,20
ATL200006090,2000,609,ATL,BOS,ATL02,4,6,10
ATL200006100,2000,610,ATL,BOS,ATL02,0,6,6
ATL200006110,2000,611,ATL,BOS,ATL02,5,3,8
ATL200006200,2000,620,ATL,CHN,ATL02,4,11,15
ATL200006210,2000,621,ATL,CHN,ATL02,8,1,9
ATL200006220,2000,622,ATL,CHN,ATL02,4,6,10
ATL200006230,2000,623,ATL,MIL,ATL02,2,3,5
ATL200006240,2000,624,ATL,MIL,ATL02,2,1,3
ATL200006250,2000,625,ATL,MIL,ATL02,4,5,9
ATL200007030,2000,703,ATL,MON,ATL02,17,1,18
ATL200007040,2000,704,ATL,MON,ATL02,3,7,10
ATL200007050,2000,705,ATL,MON,ATL02,6,5,11
ATL200007060,2000,706,ATL,MON,ATL02,4,2,6
ATL200007210,2000,721,ATL,NYN,ATL02,3,6,9
ATL200007220,2000,722,ATL,NYN,ATL02,4,0,4
ATL200007230,2000,723,ATL,NYN,ATL02,0,1,1
ATL200007250,2000,725,ATL,FLO,ATL02,5,6,11
ATL200007260,2000,726,ATL,FLO,ATL02,3,6,9
ATL200007270,2000,727,ATL,FLO,ATL02,12,4,16
ATL200007280,2000,728,ATL,HOU,ATL02,2,5,7
ATL200007290,2000,729,ATL,HOU,ATL02,5,13,18
ATL200007300,2000,730,ATL,HOU,ATL02,3,6,9
ATL200008110,2000,811,ATL,LAN,ATL02,2,7,9
ATL200008120,2000,812,ATL,LAN,ATL02,1,4,5
ATL200008130,2000,813,ATL,LAN,ATL02,7,2,9
ATL200008140,2000,814,ATL,SDN,ATL02,2,9,11
ATL200008150,2000,815,ATL,SDN,ATL02,1,3,4
ATL200008160,2000,816,ATL,SDN,ATL02,1,4,5
ATL200008240,2000,824,ATL,SLN,ATL02,12,5,17
ATL200008250,2000,825,ATL,SLN,ATL02,4,7,11
ATL200008260,2000,826,ATL,SLN,ATL02,6,3,9
ATL200008270,2000,827,ATL,SLN,ATL02,7,2,9
ATL200008280,2000,828,ATL,CIN,ATL02,6,3,9
ATL200008290,2000,829,ATL,CIN,ATL02,4,2,6
ATL200008300,2000,830,ATL,CIN,ATL02,2,5,7
ATL200008310,2000,831,ATL,CIN,ATL02,4,3,7
ATL200009050,2000,905,ATL,ARI,ATL02,2,5,7
ATL200009060,2000,906,ATL,ARI,ATL02,1,7,8
ATL200009070,2000,907,ATL,ARI,ATL02,0,4,4
ATL200009080,2000,908,ATL,MON,ATL02,2,3,5
ATL200009090,2000,909,ATL,MON,ATL02,7,5,12
ATL200009100,2000,910,ATL,MON,ATL02,4,0,4
ATL200009120,2000,912,ATL,FLO,ATL02,5,4,9
ATL200009130,2000,913,ATL,FLO,ATL02,0,4,4
ATL200009140,2000,914,ATL,FLO,ATL02,3,5,8
ATL200009180,2000,918,ATL,NYN,ATL02,3,6,9
ATL200009190,2000,919,ATL,NYN,ATL02,4,12,16
ATL200009200,2000,920,ATL,NYN,ATL02,6,3,9
ATL200009290,2000,929,ATL,COL,ATL02,4,2,6
ATL200009300,2000,930,ATL,COL,ATL02,2,5,7
ATL200010010,2000,1001,ATL,COL,ATL02,10,5,15
ATL200010070,2000,1007,ATL,SLN,ATL02,7,1,8
ATL200104030,2001,10403,ATL,NYN,ATL02,6,4,10
ATL200104040,2001,10404,ATL,NYN,ATL02,2,3,5
ATL200104050,2001,10405,ATL,NYN,ATL02,7,1,8
ATL200104130,2001,10413,ATL,PHI,ATL02,2,4,6
ATL200104140,2001,10414,ATL,PHI,ATL02,2,1,3
ATL200104150,2001,10415,ATL,PHI,ATL02,0,3,3
ATL200104160,2001,10416,ATL,FLO,ATL02,3,4,7
ATL200104170,2001,10417,ATL,FLO,ATL02,3,2,5
ATL200104180,2001,10418,ATL,FLO,ATL02,0,1,1
ATL200105010,2001,10501,ATL,MIL,ATL02,5,3,8
ATL200105020,2001,10502,ATL,MIL,ATL02,0,1,1
ATL200105030,2001,10503,ATL,MIL,ATL02,5,0,5
ATL200105040,2001,10504,ATL,SLN,ATL02,4,2,6
ATL200105050,2001,10505,ATL,SLN,ATL02,5,6,11
ATL200105060,2001,10506,ATL,SLN,ATL02,5,7,12
ATL200105150,2001,10515,ATL,COL,ATL02,3,5,8
ATL200105160,2001,10516,ATL,COL,ATL02,4,6,10
ATL200105170,2001,10517,ATL,COL,ATL02,8,3,11
ATL200105180,2001,10518,ATL,SFN,ATL02,5,6,11
ATL200105190,2001,10519,ATL,SFN,ATL02,6,3,9
ATL200105200,2001,10520,ATL,SFN,ATL02,6,11,17
ATL200105250,2001,10525,ATL,PIT,ATL02,0,1,1
ATL200105260,2001,10526,ATL,PIT,ATL02,3,9,12
ATL200105270,2001,10527,ATL,PIT,ATL02,6,3,9
ATL200105280,2001,10528,ATL,MON,ATL02,3,5,8
ATL200105290,2001,10529,ATL,MON,ATL02,4,7,11
ATL200105300,2001,10530,ATL,MON,ATL02,4,3,7
ATL200106150,2001,10615,ATL,BOS,ATL02,9,5,14
ATL200106160,2001,10616,ATL,BOS,ATL02,0,8,8
ATL200106170,2001,10617,ATL,BOS,ATL02,4,3,7
ATL200106180,2001,10618,ATL,FLO,ATL02,7,6,13
ATL200106190,2001,10619,ATL,FLO,ATL02,12,2,14
ATL200106200,2001,10620,ATL,FLO,ATL02,2,7,9
ATL200106210,2001,10621,ATL,FLO,ATL02,3,2,5
ATL200106280,2001,10628,ATL,NYN,ATL02,2,6,8
ATL200106290,2001,10629,ATL,NYN,ATL02,3,1,4
ATL200106300,2001,10630,ATL,NYN,ATL02,2,5,7
ATL200107010,2001,10701,ATL,NYN,ATL02,2,1,3
ATL200107030,2001,10703,ATL,PHI,ATL02,7,14,21
ATL200107040,2001,10704,ATL,PHI,ATL02,4,1,5
ATL200107050,2001,10705,ATL,PHI,ATL02,5,9,14
ATL200107120,2001,10712,ATL,BAL,ATL02,5,6,11
ATL200107130,2001,10713,ATL,BAL,ATL02,1,7,8
ATL200107140,2001,10714,ATL,BAL,ATL02,4,1,5
ATL200107150,2001,10715,ATL,TBA,ATL02,9,1,10
ATL200107160,2001,10716,ATL,TBA,ATL02,6,5,11
ATL200107170,2001,10717,ATL,TBA,ATL02,0,4,4
ATL200107200,2001,10720,ATL,MON,ATL02,6,3,9
ATL200107210,2001,10721,ATL,MON,ATL02,1,2,3
ATL200107220,2001,10722,ATL,MON,ATL02,2,8,10
ATL200107230,2001,10723,ATL,CIN,ATL02,5,4,9
ATL200107240,2001,10724,ATL,CIN,ATL02,11,3,14
ATL200107250,2001,10725,ATL,CIN,ATL02,3,11,14
ATL200108070,2001,10807,ATL,HOU,ATL02,5,6,11
ATL200108080,2001,10808,ATL,HOU,ATL02,2,1,3
ATL200108090,2001,10809,ATL,HOU,ATL02,6,5,11
ATL200108100,2001,10810,ATL,ARI,ATL02,7,0,7
ATL200108110,2001,10811,ATL,ARI,ATL02,3,1,4
ATL200108120,2001,10812,ATL,ARI,ATL02,9,1,10
ATL200108210,2001,10821,ATL,SDN,ATL02,3,1,4
ATL200108220,2001,10822,ATL,SDN,ATL02,3,6,9
ATL200108230,2001,10823,ATL,SDN,ATL02,2,3,5
ATL200108240,2001,10824,ATL,LAN,ATL02,4,1,5
ATL200108250,2001,10825,ATL,LAN,ATL02,8,7,15
ATL200108260,2001,10826,ATL,LAN,ATL02,2,9,11
ATL200108270,2001,10827,ATL,LAN,ATL02,4,2,6
ATL200108280,2001,10828,ATL,MON,ATL02,7,0,7
ATL200108290,2001,10829,ATL,MON,ATL02,3,5,8
ATL200108300,2001,10830,ATL,MON,ATL02,4,2,6
ATL200108310,2001,10831,ATL,CHN,ATL02,8,2,10
ATL200109010,2001,10901,ATL,CHN,ATL02,5,3,8
ATL200109020,2001,10902,ATL,CHN,ATL02,4,7,11
ATL200109280,2001,10928,ATL,NYN,ATL02,3,5,8
ATL200109290,2001,10929,ATL,NYN,ATL02,5,8,13
ATL200109300,2001,10930,ATL,NYN,ATL02,9,6,15
ATL200110020,2001,11002,ATL,PHI,ATL02,3,1,4
ATL200110030,2001,11003,ATL,PHI,ATL02,3,8,11
ATL200110040,2001,11004,ATL,PHI,ATL02,2,6,8
ATL200110050,2001,11005,ATL,FLO,ATL02,3,20,23
ATL200110060,2001,11006,ATL,FLO,ATL02,3,7,10
ATL200110070,2001,11007,ATL,FLO,ATL02,4,2,6
ATL200110120,2001,11012,ATL,HOU,ATL02,2,6,8
ATL200110190,2001,11019,ATL,ARI,ATL02,5,1,6
ATL200110200,2001,11020,ATL,ARI,ATL02,11,4,15
ATL200110210,2001,11021,ATL,ARI,ATL02,3,2,5
ATL200204010,2002,20401,ATL,PHI,ATL02,2,7,9
ATL200204030,2002,20403,ATL,PHI,ATL02,3,1,4
ATL200204040,2002,20404,ATL,PHI,ATL02,2,11,13
ATL200204050,2002,20405,ATL,NYN,ATL02,9,3,12
ATL200204060,2002,20406,ATL,NYN,ATL02,11,2,13
ATL200204070,2002,20407,ATL,NYN,ATL02,2,5,7
ATL200204190,2002,20419,ATL,FLO,ATL02,2,3,5
ATL200204200,2002,20420,ATL,FLO,ATL02,1,3,4
ATL200204210,2002,20421,ATL,FLO,ATL02,2,4,6
ATL200204220,2002,20422,ATL,FLO,ATL02,8,3,11
ATL200204230,2002,20423,ATL,ARI,ATL02,5,2,7
ATL200204240,2002,20424,ATL,ARI,ATL02,3,4,7
ATL200204250,2002,20425,ATL,ARI,ATL02,11,5,16
ATL200204260,2002,20426,ATL,HOU,ATL02,0,9,9
ATL200204270,2002,20427,ATL,HOU,ATL02,6,3,9
ATL200204280,2002,20428,ATL,HOU,ATL02,7,1,8
ATL200205070,2002,20507,ATL,LAN,ATL02,6,5,11
ATL200205080,2002,20508,ATL,LAN,ATL02,3,1,4
ATL200205090,2002,20509,ATL,LAN,ATL02,2,6,8
ATL200205100,2002,20510,ATL,SDN,ATL02,3,7,10
ATL200205110,2002,20511,ATL,SDN,ATL02,1,6,7
ATL200205120,2002,20512,ATL,SDN,ATL02,6,5,11
ATL200205240,2002,20524,ATL,CIN,ATL02,2,11,13
ATL200205250,2002,20525,ATL,CIN,ATL02,6,4,10
ATL200205260,2002,20526,ATL,CIN,ATL02,5,7,12
ATL200205270,2002,20527,ATL,MON,ATL02,1,5,6
ATL200205280,2002,20528,ATL,MON,ATL02,2,5,7
ATL200205290,2002,20529,ATL,MON,ATL02,4,3,7
ATL200205300,2002,20530,ATL,MON,ATL02,2,5,7
ATL200206030,2002,20603,ATL,NYN,ATL02,4,5,9
ATL200206050,2002,20605,ATL,NYN,ATL02,4,6,10
ATL200206060,2002,20606,ATL,NYN,ATL02,2,3,5
ATL200206140,2002,20614,ATL,BOS,ATL02,1,2,3
ATL200206150,2002,20615,ATL,BOS,ATL02,2,4,6
ATL200206160,2002,20616,ATL,BOS,ATL02,6,1,7
ATL200206180,2002,20618,ATL,DET,ATL02,6,0,6
ATL200206190,2002,20619,ATL,DET,ATL02,1,4,5
ATL200206200,2002,20620,ATL,DET,ATL02,2,3,5
ATL200206210,2002,20621,ATL,CHA,ATL02,2,3,5
ATL200206220,2002,20622,ATL,CHA,ATL02,2,15,17
ATL200206230,2002,20623,ATL,CHA,ATL02,1,9,10
ATL200207010,2002,20701,ATL,MON,ATL02,5,7,12
ATL200207020,2002,20702,ATL,MON,ATL02,5,2,7
ATL200207030,2002,20703,ATL,MON,ATL02,5,6,11
ATL200207040,2002,20704,ATL,CHN,ATL02,1,5,6
ATL200207050,2002,20705,ATL,CHN,ATL02,3,4,7
ATL200207060,2002,20706,ATL,CHN,ATL02,7,3,10
ATL200207070,2002,20707,ATL,CHN,ATL02,0,2,2
ATL200207170,2002,20717,ATL,FLO,ATL02,0,10,10
ATL200207180,2002,20718,ATL,FLO,ATL02,1,3,4
ATL200207260,2002,20726,ATL,PHI,ATL02,3,2,5
ATL200207270,2002,20727,ATL,PHI,ATL02,3,5,8
ATL200207280,2002,20728,ATL,PHI,ATL02,7,1,8
ATL200207300,2002,20730,ATL,MIL,ATL02,2,3,5
ATL200207310,2002,20731,ATL,MIL,ATL02,1,9,10
ATL200208010,2002,20801,ATL,MIL,ATL02,0,4,4
ATL200208020,2002,20802,ATL,SLN,ATL02,5,11,16
ATL200208030,2002,20803,ATL,SLN,ATL02,1,6,7
ATL200208040,2002,20804,ATL,SLN,ATL02,1,2,3
ATL200208130,2002,20813,ATL,SFN,ATL02,7,2,9
ATL200208140,2002,20814,ATL,SFN,ATL02,0,1,1
ATL200208150,2002,20815,ATL,SFN,ATL02,3,3,6
ATL200208160,2002,20816,ATL,COL,ATL02,1,4,5
ATL200208170,2002,20817,ATL,COL,ATL02,10,3,13
ATL200208180,2002,20818,ATL,COL,ATL02,6,3,9
ATL200208190,2002,20819,ATL,COL,ATL02,6,7,13
ATL200209020,2002,20902,ATL,PIT,ATL02,1,5,6
ATL200209030,2002,20903,ATL,PIT,ATL02,3,0,3
ATL200209040,2002,20904,ATL,PIT,ATL02,0,6,6
ATL200209060,2002,20906,ATL,MON,ATL02,0,5,5
ATL200209070,2002,20907,ATL,MON,ATL02,0,4,4
ATL200209080,2002,20908,ATL,MON,ATL02,7,0,7
ATL200209100,2002,20910,ATL,NYN,ATL02,6,12,18
ATL200209111,2002,20911,ATL,NYN,ATL02,5,8,13
ATL200209112,2002,20911,ATL,NYN,ATL02,5,0,5
ATL200209170,2002,20917,ATL,PHI,ATL02,1,2,3
ATL200209180,2002,20918,ATL,PHI,ATL02,6,5,11
ATL200209190,2002,20919,ATL,PHI,ATL02,0,6,6
ATL200209200,2002,20920,ATL,FLO,ATL02,6,2,8
ATL200209210,2002,20921,ATL,FLO,ATL02,6,4,10
ATL200209220,2002,20922,ATL,FLO,ATL02,1,4,5
ATL200210020,2002,21002,ATL,SFN,ATL02,8,5,13
ATL200210030,2002,21003,ATL,SFN,ATL02,3,7,10
ATL200210070,2002,21007,ATL,SFN,ATL02,3,1,4
ATL200303310,2003,30331,ATL,MON,ATL02,10,2,12
ATL200304020,2003,30402,ATL,MON,ATL02,3,0,3
ATL200304030,2003,30403,ATL,MON,ATL02,4,0,4
ATL200304040,2003,30404,ATL,FLO,ATL02,7,12,19
ATL200304050,2003,30405,ATL,FLO,ATL02,17,1,18
ATL200304060,2003,30406,ATL,FLO,ATL02,4,13,17
ATL200304070,2003,30407,ATL,FLO,ATL02,0,3,3
ATL200304180,2003,30418,ATL,PHI,ATL02,4,5,9
ATL200304190,2003,30419,ATL,PHI,ATL02,4,0,4
ATL200304200,2003,30420,ATL,PHI,ATL02,1,8,9
ATL200304220,2003,30422,ATL,SLN,ATL02,3,5,8
ATL200304230,2003,30423,ATL,SLN,ATL02,2,4,6
ATL200304240,2003,30424,ATL,SLN,ATL02,3,4,7
ATL200304250,2003,30425,ATL,MIL,ATL02,12,5,17
ATL200304260,2003,30426,ATL,MIL,ATL02,2,3,5
ATL200304270,2003,30427,ATL,MIL,ATL02,1,7,8
ATL200305060,2003,30506,ATL,COL,ATL02,2,3,5
ATL200305081,2003,30508,ATL,COL,ATL02,6,12,18
ATL200305082,2003,30508,ATL,COL,ATL02,2,5,7
ATL200305090,2003,30509,ATL,SFN,ATL02,9,2,11
ATL200305100,2003,30510,ATL,SFN,ATL02,3,6,9
ATL200305110,2003,30511,ATL,SFN,ATL02,3,7,10
ATL200305230,2003,30523,ATL,NYN,ATL02,6,5,11
ATL200305240,2003,30524,ATL,NYN,ATL02,4,10,14
ATL200305250,2003,30525,ATL,NYN,ATL02,1,3,4
ATL200305260,2003,30526,ATL,CIN,ATL02,7,6,13
ATL200305270,2003,30527,ATL,CIN,ATL02,2,3,5
ATL200305280,2003,30528,ATL,CIN,ATL02,3,15,18
ATL200306030,2003,30603,ATL,TEX,ATL02,5,6,11
ATL200306040,2003,30604,ATL,TEX,ATL02,2,5,7
ATL200306050,2003,30605,ATL,TEX,ATL02,4,8,12
ATL200306070,2003,30607,ATL,PIT,ATL02,6,8,14
ATL200306080,2003,30608,ATL,PIT,ATL02,5,6,11
ATL200306200,2003,30620,ATL,BAL,ATL02,3,6,9
ATL200306210,2003,30621,ATL,BAL,ATL02,2,10,12
ATL200306220,2003,30622,ATL,BAL,ATL02,9,3,12
ATL200306240,2003,30624,ATL,PHI,ATL02,3,5,8
ATL200306250,2003,30625,ATL,PHI,ATL02,8,1,9
ATL200306260,2003,30626,ATL,PHI,ATL02,8,1,9
ATL200307030,2003,30703,ATL,MON,ATL02,5,4,9
ATL200307040,2003,30704,ATL,MON,ATL02,6,8,14
ATL200307050,2003,30705,ATL,MON,ATL02,2,3,5
ATL200307060,2003,30706,ATL,MON,ATL02,5,7,12
ATL200307170,2003,30717,ATL,NYN,ATL02,2,3,5
ATL200307180,2003,30718,ATL,NYN,ATL02,4,11,15
ATL200307190,2003,30719,ATL,NYN,ATL02,4,7,11
ATL200307200,2003,30720,ATL,NYN,ATL02,8,11,19
ATL200307210,2003,30721,ATL,CHN,ATL02,15,6,21
ATL200307220,2003,30722,ATL,CHN,ATL02,4,8,12
ATL200307230,2003,30723,ATL,FLO,ATL02,5,4,9
ATL200307240,2003,30724,ATL,FLO,ATL02,2,5,7
ATL200307290,2003,30729,ATL,HOU,ATL02,3,6,9
ATL200307300,2003,30730,ATL,HOU,ATL02,7,3,10
ATL200307310,2003,30731,ATL,HOU,ATL02,4,7,11
ATL200308010,2003,30801,ATL,LAN,ATL02,0,2,2
ATL200308020,2003,30802,ATL,LAN,ATL02,4,6,10
ATL200308030,2003,30803,ATL,LAN,ATL02,8,4,12
ATL200308120,2003,30812,ATL,SDN,ATL02,14,4,18
ATL200308130,2003,30813,ATL,SDN,ATL02,1,7,8
ATL200308140,2003,30814,ATL,SDN,ATL02,4,7,11
ATL200308150,2003,30815,ATL,ARI,ATL02,4,10,14
ATL200308160,2003,30816,ATL,ARI,ATL02,6,10,16
ATL200308170,2003,30817,ATL,ARI,ATL02,2,0,2
ATL200308180,2003,30818,ATL,ARI,ATL02,1,6,7
ATL200308260,2003,30826,ATL,NYN,ATL02,6,5,11
ATL200308270,2003,30827,ATL,NYN,ATL02,1,4,5
ATL200308280,2003,30828,ATL,NYN,ATL02,3,1,4
ATL200309051,2003,30905,ATL,PIT,ATL02,2,3,5
ATL200309052,2003,30905,ATL,PIT,ATL02,5,3,8
ATL200309060,2003,30906,ATL,PIT,ATL02,2,9,11
ATL200309070,2003,30907,ATL,PIT,ATL02,1,2,3
ATL200309080,2003,30908,ATL,PHI,ATL02,4,6,10
ATL200309090,2003,30909,ATL,PHI,ATL02,18,5,23
ATL200309100,2003,30910,ATL,PHI,ATL02,2,4,6
ATL200309110,2003,30911,ATL,PHI,ATL02,8,3,11
ATL200309190,2003,30919,ATL,FLO,ATL02,0,1,1
ATL200309200,2003,30920,ATL,FLO,ATL02,6,5,11
ATL200309210,2003,30921,ATL,FLO,ATL02,0,8,8
ATL200309220,2003,30922,ATL,FLO,ATL02,6,3,9
ATL200309230,2003,30923,ATL,MON,ATL02,0,2,2
ATL200309240,2003,30924,ATL,MON,ATL02,1,9,10
ATL200309300,2003,30930,ATL,CHN,ATL02,4,2,6
ATL200310010,2003,31001,ATL,CHN,ATL02,3,5,8
ATL200310050,2003,31005,ATL,CHN,ATL02,5,1,6
ATL200404060,2004,40406,ATL,NYN,ATL02,7,2,9
ATL200404070,2004,40407,ATL,NYN,ATL02,10,18,28
ATL200404080,2004,40408,ATL,NYN,ATL02,8,10,18
ATL200404090,2004,40409,ATL,CHN,ATL02,2,1,3
ATL200404100,2004,40410,ATL,CHN,ATL02,2,5,7
ATL200404110,2004,40411,ATL,CHN,ATL02,10,2,12
ATL200404160,2004,40416,ATL,FLO,ATL02,4,5,9
ATL200404170,2004,40417,ATL,FLO,ATL02,1,4,5
ATL200404180,2004,40418,ATL,FLO,ATL02,2,3,5
ATL200405040,2004,40504,ATL,SDN,ATL02,2,4,6
ATL200405050,2004,40505,ATL,SDN,ATL02,2,0,2
ATL200405060,2004,40506,ATL,SDN,ATL02,7,3,10
ATL200405070,2004,40507,ATL,HOU,ATL02,5,3,8
ATL200405080,2004,40508,ATL,HOU,ATL02,4,5,9
ATL200405090,2004,40509,ATL,HOU,ATL02,2,1,3
ATL200405180,2004,40518,ATL,ARI,ATL02,2,0,2
ATL200405190,2004,40519,ATL,ARI,ATL02,6,4,10
ATL200405200,2004,40520,ATL,ARI,ATL02,1,5,6
ATL200405210,2004,40521,ATL,LAN,ATL02,0,2,2
ATL200405220,2004,40522,ATL,LAN,ATL02,7,4,11
ATL200405230,2004,40523,ATL,LAN,ATL02,1,5,6
ATL200405310,2004,40531,ATL,MON,ATL02,2,8,10
ATL200406010,2004,40601,ATL,MON,ATL02,6,7,13
ATL200406020,2004,40602,ATL,MON,ATL02,8,4,12
ATL200406030,2004,40603,ATL,PHI,ATL02,4,8,12
ATL200406040,2004,40604,ATL,PHI,ATL02,9,1,10
ATL200406050,2004,40605,ATL,PHI,ATL02,5,3,8
ATL200406060,2004,40606,ATL,PHI,ATL02,4,6,10
ATL200406150,2004,40615,ATL,KCA,ATL02,2,3,5
ATL200406160,2004,40616,ATL,KCA,ATL02,10,4,14
ATL200406170,2004,40617,ATL,KCA,ATL02,10,4,14
ATL200406180,2004,40618,ATL,CLE,ATL02,4,2,6
ATL200406190,2004,40619,ATL,CLE,ATL02,0,4,4
ATL200406200,2004,40620,ATL,CLE,ATL02,5,2,7
ATL200406280,2004,40628,ATL,FLO,ATL02,1,6,7
ATL200406290,2004,40629,ATL,FLO,ATL02,5,4,9
ATL200406300,2004,40630,ATL,FLO,ATL02,6,9,15
ATL200407010,2004,40701,ATL,FLO,ATL02,1,9,10
ATL200407020,2004,40702,ATL,BOS,ATL02,3,6,9
ATL200407030,2004,40703,ATL,BOS,ATL02,6,1,7
ATL200407040,2004,40704,ATL,BOS,ATL02,4,10,14
ATL200407150,2004,40715,ATL,MON,ATL02,0,8,8
ATL200407160,2004,40716,ATL,MON,ATL02,5,1,6
ATL200407170,2004,40717,ATL,MON,ATL02,2,6,8
ATL200407180,2004,40718,ATL,MON,ATL02,5,16,21
ATL200407190,2004,40719,ATL,PHI,ATL02,2,4,6
ATL200407200,2004,40720,ATL,PHI,ATL02,4,3,7
ATL200407210,2004,40721,ATL,PIT,ATL02,4,3,7
ATL200407220,2004,40722,ATL,PIT,ATL02,1,2,3
ATL200407300,2004,40730,ATL,NYN,ATL02,1,3,4
ATL200407310,2004,40731,ATL,NYN,ATL02,0,8,8
ATL200408010,2004,40801,ATL,NYN,ATL02,5,6,11
ATL200408100,2004,40810,ATL,MIL,ATL02,3,2,5
ATL200408110,2004,40811,ATL,MIL,ATL02,3,10,13
ATL200408120,2004,40812,ATL,MIL,ATL02,2,4,6
ATL200408130,2004,40813,ATL,SLN,ATL02,4,1,5
ATL200408140,2004,40814,ATL,SLN,ATL02,7,9,16
ATL200408150,2004,40815,ATL,SLN,ATL02,10,4,14
ATL200408240,2004,40824,ATL,COL,ATL02,5,6,11
ATL200408250,2004,40825,ATL,COL,ATL02,1,8,9
ATL200408260,2004,40826,ATL,COL,ATL02,4,6,10
ATL200408270,2004,40827,ATL,SFN,ATL02,3,5,8
ATL200408280,2004,40828,ATL,SFN,ATL02,3,9,12
ATL200408290,2004,40829,ATL,SFN,ATL02,9,5,14
ATL200408300,2004,40830,ATL,SFN,ATL02,6,7,13
ATL200409060,2004,40906,ATL,PHI,ATL02,1,3,4
ATL200409081,2004,40908,ATL,PHI,ATL02,5,3,8
ATL200409082,2004,40908,ATL,PHI,ATL02,4,1,5
ATL200409090,2004,40909,ATL,PHI,ATL02,9,4,13
ATL200409100,2004,40910,ATL,MON,ATL02,3,4,7
ATL200409110,2004,40911,ATL,MON,ATL02,1,8,9
ATL200409120,2004,40912,ATL,MON,ATL02,8,9,17
ATL200409210,2004,40921,ATL,CIN,ATL02,4,5,9
ATL200409220,2004,40922,ATL,CIN,ATL02,11,8,19
ATL200409230,2004,40923,ATL,CIN,ATL02,3,2,5
ATL200409240,2004,40924,ATL,FLO,ATL02,7,8,15
ATL200409250,2004,40925,ATL,FLO,ATL02,0,1,1
ATL200409260,2004,40926,ATL,FLO,ATL02,3,6,9
ATL200409281,2004,40928,ATL,NYN,ATL02,2,1,3
ATL200409282,2004,40928,ATL,NYN,ATL02,2,5,7
ATL200409290,2004,40929,ATL,NYN,ATL02,3,6,9
ATL200410060,2004,41006,ATL,HOU,ATL02,9,3,12
ATL200410070,2004,41007,ATL,HOU,ATL02,2,4,6
ATL200410110,2004,41011,ATL,HOU,ATL02,12,3,15
ATL200504080,2005,50408,ATL,NYN,ATL02,1,3,4
ATL200504090,2005,50409,ATL,NYN,ATL02,3,6,9
ATL200504100,2005,50410,ATL,NYN,ATL02,6,1,7
ATL200504110,2005,50411,ATL,WAS,ATL02,2,11,13
ATL200504120,2005,50412,ATL,WAS,ATL02,4,3,7
ATL200504130,2005,50413,ATL,WAS,ATL02,11,4,15
ATL200504220,2005,50422,ATL,PHI,ATL02,2,6,8
ATL200504230,2005,50423,ATL,PHI,ATL02,1,11,12
ATL200504240,2005,50424,ATL,PHI,ATL02,0,4,4
ATL200504290,2005,50429,ATL,SLN,ATL02,6,5,11
ATL200504300,2005,50430,ATL,SLN,ATL02,2,3,5
ATL200505010,2005,50501,ATL,SLN,ATL02,1,2,3
ATL200505030,2005,50503,ATL,FLO,ATL02,11,6,17
ATL200505040,2005,50504,ATL,FLO,ATL02,2,5,7
ATL200505050,2005,50505,ATL,HOU,ATL02,3,9,12
ATL200505060,2005,50506,ATL,HOU,ATL02,4,9,13
ATL200505070,2005,50507,ATL,HOU,ATL02,1,4,5
ATL200505080,2005,50508,ATL,HOU,ATL02,0,16,16
ATL200505230,2005,50523,ATL,NYN,ATL02,6,8,14
ATL200505240,2005,50524,ATL,NYN,ATL02,0,4,4
ATL200505250,2005,50525,ATL,NYN,ATL02,0,3,3
ATL200505270,2005,50527,ATL,PHI,ATL02,5,1,6
ATL200505280,2005,50528,ATL,PHI,ATL02,12,5,17
ATL200505290,2005,50529,ATL,PHI,ATL02,2,7,9
ATL200506060,2005,50606,ATL,ANA,ATL02,4,2,6
ATL200506070,2005,50607,ATL,ANA,ATL02,2,3,5
ATL200506080,2005,50608,ATL,ANA,ATL02,8,4,12
ATL200506100,2005,50610,ATL,OAK,ATL02,6,4,10
ATL200506110,2005,50611,ATL,OAK,ATL02,3,5,8
ATL200506120,2005,50612,ATL,OAK,ATL02,11,5,16
ATL200506210,2005,50621,ATL,FLO,ATL02,0,5,5
ATL200506220,2005,50622,ATL,FLO,ATL02,0,8,8
ATL200506230,2005,50623,ATL,FLO,ATL02,8,0,8
ATL200506240,2005,50624,ATL,BAL,ATL02,5,7,12
ATL200506250,2005,50625,ATL,BAL,ATL02,4,5,9
ATL200506260,2005,50626,ATL,BAL,ATL02,1,8,9
ATL200507040,2005,50704,ATL,CHN,ATL02,0,4,4
ATL200507050,2005,50705,ATL,CHN,ATL02,1,5,6
ATL200507071,2005,50707,ATL,CHN,ATL02,0,6,6
ATL200507072,2005,50707,ATL,CHN,ATL02,4,9,13
ATL200507080,2005,50708,ATL,MIL,ATL02,1,2,3
ATL200507090,2005,50709,ATL,MIL,ATL02,9,6,15
ATL200507100,2005,50710,ATL,MIL,ATL02,8,4,12
ATL200507260,2005,50726,ATL,WAS,ATL02,2,3,5
ATL200507270,2005,50727,ATL,WAS,ATL02,3,4,7
ATL200507280,2005,50728,ATL,WAS,ATL02,4,5,9
ATL200507290,2005,50729,ATL,PIT,ATL02,1,2,3
ATL200507300,2005,50730,ATL,PIT,ATL02,6,9,15
ATL200507310,2005,50731,ATL,PIT,ATL02,4,5,9
ATL200508010,2005,50801,ATL,PIT,ATL02,4,1,5
ATL200508090,2005,50809,ATL,SFN,ATL02,1,7,8
ATL200508100,2005,50810,ATL,SFN,ATL02,4,5,9
ATL200508110,2005,50811,ATL,SFN,ATL02,5,3,8
ATL200508120,2005,50812,ATL,ARI,ATL02,8,0,8
ATL200508130,2005,50813,ATL,ARI,ATL02,5,9,14
ATL200508140,2005,50814,ATL,ARI,ATL02,8,13,21
ATL200508160,2005,50816,ATL,LAN,ATL02,6,4,10
ATL200508170,2005,50817,ATL,LAN,ATL02,2,10,12
ATL200508180,2005,50818,ATL,LAN,ATL02,7,4,11
ATL200508190,2005,50819,ATL,SDN,ATL02,12,7,19
ATL200508200,2005,50820,ATL,SDN,ATL02,7,2,9
ATL200508210,2005,50821,ATL,SDN,ATL02,2,6,8
ATL200508300,2005,50830,ATL,WAS,ATL02,3,2,5
ATL200508311,2005,50831,ATL,WAS,ATL02,3,5,8
ATL200508312,2005,50831,ATL,WAS,ATL02,4,3,7
ATL200509010,2005,50901,ATL,WAS,ATL02,7,8,15
ATL200509020,2005,50902,ATL,CIN,ATL02,4,7,11
ATL200509030,2005,50903,ATL,CIN,ATL02,3,9,12
ATL200509040,2005,50904,ATL,CIN,ATL02,8,3,11
ATL200509050,2005,50905,ATL,NYN,ATL02,2,4,6
ATL200509060,2005,50906,ATL,NYN,ATL02,1,3,4
ATL200509070,2005,50907,ATL,NYN,ATL02,3,4,7
ATL200509200,2005,50920,ATL,PHI,ATL02,1,4,5
ATL200509210,2005,50921,ATL,PHI,ATL02,10,6,16
ATL200509220,2005,50922,ATL,PHI,ATL02,4,0,4
ATL200509230,2005,50923,ATL,FLO,ATL02,3,4,7
ATL200509240,2005,50924,ATL,FLO,ATL02,1,6,7
ATL200509250,2005,50925,ATL,FLO,ATL02,3,5,8
ATL200509260,2005,50926,ATL,COL,ATL02,6,5,11
ATL200509270,2005,50927,ATL,COL,ATL02,3,12,15
ATL200509280,2005,50928,ATL,COL,ATL02,10,5,15
ATL200510050,2005,51005,ATL,HOU,ATL02,10,5,15
ATL200510060,2005,51006,ATL,HOU,ATL02,1,7,8
ATL200604100,2006,60410,ATL,PHI,ATL02,3,5,8
ATL200604120,2006,60412,ATL,PHI,ATL02,7,5,12
ATL200604130,2006,60413,ATL,PHI,ATL02,7,6,13
ATL200604140,2006,60414,ATL,SDN,ATL02,4,5,9
ATL200604150,2006,60415,ATL,SDN,ATL02,0,2,2
ATL200604160,2006,60416,ATL,SDN,ATL02,4,3,7
ATL200604280,2006,60428,ATL,NYN,ATL02,5,2,7
ATL200604290,2006,60429,ATL,NYN,ATL02,1,0,1
ATL200604300,2006,60430,ATL,NYN,ATL02,5,8,13
ATL200605010,2006,60501,ATL,COL,ATL02,0,2,2
ATL200605020,2006,60502,ATL,COL,ATL02,4,5,9
ATL200605120,2006,60512,ATL,WAS,ATL02,2,6,8
ATL200605130,2006,60513,ATL,WAS,ATL02,5,8,13
ATL200605140,2006,60514,ATL,WAS,ATL02,8,1,9
ATL200605150,2006,60515,ATL,FLO,ATL02,8,11,19
ATL200605160,2006,60516,ATL,FLO,ATL02,3,4,7
ATL200605170,2006,60517,ATL,FLO,ATL02,4,6,10
ATL200605180,2006,60518,ATL,FLO,ATL02,1,9,10
ATL200605290,2006,60529,ATL,LAN,ATL02,12,5,17
ATL200605300,2006,60530,ATL,LAN,ATL02,8,3,11
ATL200605310,2006,60531,ATL,LAN,ATL02,3,9,12
ATL200606010,2006,60601,ATL,ARI,ATL02,2,1,3
ATL200606031,2006,60603,ATL,ARI,ATL02,4,2,6
ATL200606032,2006,60603,ATL,ARI,ATL02,13,9,22
ATL200606040,2006,60604,ATL,ARI,ATL02,9,3,12
ATL200606050,2006,60605,ATL,WAS,ATL02,5,4,9
ATL200606060,2006,60606,ATL,WAS,ATL02,3,5,8
ATL200606070,2006,60607,ATL,WAS,ATL02,5,2,7
ATL200606160,2006,60616,ATL,BOS,ATL02,4,1,5
ATL200606170,2006,60617,ATL,BOS,ATL02,5,3,8
ATL200606180,2006,60618,ATL,BOS,ATL02,10,7,17
ATL200606200,2006,60620,ATL,TOR,ATL02,6,5,11
ATL200606210,2006,60621,ATL,TOR,ATL02,6,3,9
ATL200606220,2006,60622,ATL,TOR,ATL02,3,2,5
ATL200606300,2006,60630,ATL,BAL,ATL02,3,5,8
ATL200607010,2006,60701,ATL,BAL,ATL02,7,4,11
ATL200607020,2006,60702,ATL,BAL,ATL02,3,10,13
ATL200607030,2006,60703,ATL,SLN,ATL02,3,6,9
ATL200607040,2006,60704,ATL,SLN,ATL02,6,3,9
ATL200607050,2006,60705,ATL,SLN,ATL02,4,14,18
ATL200607060,2006,60706,ATL,CIN,ATL02,7,8,15
ATL200607070,2006,60707,ATL,CIN,ATL02,10,5,15
ATL200607080,2006,60708,ATL,CIN,ATL02,1,4,5
ATL200607090,2006,60709,ATL,CIN,ATL02,3,8,11
ATL200607250,2006,60725,ATL,FLO,ATL02,2,1,3
ATL200607260,2006,60726,ATL,FLO,ATL02,5,6,11
ATL200607270,2006,60727,ATL,FLO,ATL02,6,1,7
ATL200607280,2006,60728,ATL,NYN,ATL02,6,4,10
ATL200607290,2006,60729,ATL,NYN,ATL02,11,3,14
ATL200607300,2006,60730,ATL,NYN,ATL02,10,6,16
ATL200608070,2006,60807,ATL,PHI,ATL02,9,6,15
ATL200608080,2006,60808,ATL,PHI,ATL02,1,3,4
ATL200608090,2006,60809,ATL,PHI,ATL02,9,3,12
ATL200608110,2006,60811,ATL,MIL,ATL02,1,2,3
ATL200608120,2006,60812,ATL,MIL,ATL02,8,5,13
ATL200608130,2006,60813,ATL,MIL,ATL02,4,7,11
ATL200608210,2006,60821,ATL,PIT,ATL02,0,3,3
ATL200608220,2006,60822,ATL,PIT,ATL02,5,3,8
ATL200608230,2006,60823,ATL,PIT,ATL02,5,4,9
ATL200608250,2006,60825,ATL,WAS,ATL02,7,6,13
ATL200608260,2006,60826,ATL,WAS,ATL02,1,10,11
ATL200608270,2006,60827,ATL,WAS,ATL02,6,13,19
ATL200608290,2006,60829,ATL,SFN,ATL02,8,13,21
ATL200608300,2006,60830,ATL,SFN,ATL02,3,5,8
ATL200608310,2006,60831,ATL,SFN,ATL02,8,6,14
ATL200609080,2006,60908,ATL,CHN,ATL02,4,8,12
ATL200609090,2006,60909,ATL,CHN,ATL02,3,7,10
ATL200609100,2006,60910,ATL,CHN,ATL02,1,2,3
ATL200609110,2006,60911,ATL,CHN,ATL02,8,3,11
ATL200609131,2006,60913,ATL,PHI,ATL02,6,5,11
ATL200609132,2006,60913,ATL,PHI,ATL02,7,2,9
ATL200609140,2006,60914,ATL,PHI,ATL02,1,4,5
ATL200609150,2006,60915,ATL,FLO,ATL02,6,4,10
ATL200609160,2006,60916,ATL,FLO,ATL02,1,2,3
ATL200609170,2006,60917,ATL,FLO,ATL02,7,8,15
ATL200609260,2006,60926,ATL,NYN,ATL02,0,12,12
ATL200609270,2006,60927,ATL,NYN,ATL02,1,13,14
ATL200609280,2006,60928,ATL,NYN,ATL02,7,4,11
ATL200609290,2006,60929,ATL,HOU,ATL02,1,4,5
ATL200609300,2006,60930,ATL,HOU,ATL02,5,4,9
ATL200610010,2006,61001,ATL,HOU,ATL02,1,3,4
ATL200704060,2007,70406,ATL,NYN,ATL02,11,1,12
ATL200704070,2007,70407,ATL,NYN,ATL02,3,5,8
ATL200704080,2007,70408,ATL,NYN,ATL02,2,3,5
ATL200704100,2007,70410,ATL,WAS,ATL02,0,8,8
ATL200704110,2007,70411,ATL,WAS,ATL02,3,8,11
ATL200704120,2007,70412,ATL,WAS,ATL02,2,0,2
ATL200704130,2007,70413,ATL,FLO,ATL02,11,4,15
ATL200704150,2007,70415,ATL,FLO,ATL02,4,8,12
ATL200704180,2007,70418,ATL,CHN,ATL02,6,8,14
ATL200704190,2007,70419,ATL,CHN,ATL02,3,0,3
ATL200704300,2007,70430,ATL,PHI,ATL02,2,5,7
ATL200705010,2007,70501,ATL,PHI,ATL02,6,4,10
ATL200705020,2007,70502,ATL,PHI,ATL02,3,4,7
ATL200705040,2007,70504,ATL,LAN,ATL02,0,4,4
ATL200705050,2007,70505,ATL,LAN,ATL02,6,3,9
ATL200705060,2007,70506,ATL,LAN,ATL02,4,6,10
ATL200705070,2007,70507,ATL,SDN,ATL02,4,2,6
ATL200705080,2007,70508,ATL,SDN,ATL02,2,3,5
ATL200705090,2007,70509,ATL,SDN,ATL02,2,3,5
ATL200705100,2007,70510,ATL,SDN,ATL02,3,5,8
ATL200705220,2007,70522,ATL,NYN,ATL02,1,8,9
ATL200705230,2007,70523,ATL,NYN,ATL02,3,0,3
ATL200705240,2007,70524,ATL,NYN,ATL02,1,2,3
ATL200705250,2007,70525,ATL,PHI,ATL02,8,3,11
ATL200705260,2007,70526,ATL,PHI,ATL02,6,4,10
ATL200705270,2007,70527,ATL,PHI,ATL02,13,6,19
ATL200706040,2007,70604,ATL,FLO,ATL02,6,4,10
ATL200706051,2007,70605,ATL,FLO,ATL02,1,3,4
ATL200706052,2007,70605,ATL,FLO,ATL02,5,1,6
ATL200706060,2007,70606,ATL,FLO,ATL02,7,4,11
ATL200706070,2007,70607,ATL,CHN,ATL02,2,1,3
ATL200706080,2007,70608,ATL,CHN,ATL02,9,1,10
ATL200706090,2007,70609,ATL,CHN,ATL02,5,9,14
ATL200706100,2007,70610,ATL,CHN,ATL02,4,5,9
ATL200706180,2007,70618,ATL,BOS,ATL02,4,9,13
ATL200706190,2007,70619,ATL,BOS,ATL02,4,0,4
ATL200706200,2007,70620,ATL,BOS,ATL02,11,0,11
ATL200706220,2007,70622,ATL,DET,ATL02,5,0,5
ATL200706230,2007,70623,ATL,DET,ATL02,2,1,3
ATL200706240,2007,70624,ATL,DET,ATL02,5,0,5
ATL200706250,2007,70625,ATL,WAS,ATL02,1,4,5
ATL200706260,2007,70626,ATL,WAS,ATL02,2,6,8
ATL200706270,2007,70627,ATL,WAS,ATL02,0,13,13
ATL200707130,2007,70713,ATL,PIT,ATL02,1,9,10
ATL200707140,2007,70714,ATL,PIT,ATL02,4,5,9
ATL200707150,2007,70715,ATL,PIT,ATL02,1,5,6
ATL200707160,2007,70716,ATL,CIN,ATL02,10,3,13
ATL200707170,2007,70717,ATL,CIN,ATL02,6,5,11
ATL200707180,2007,70718,ATL,CIN,ATL02,5,4,9
ATL200707190,2007,70719,ATL,SLN,ATL02,1,10,11
ATL200707200,2007,70720,ATL,SLN,ATL02,4,2,6
ATL200707210,2007,70721,ATL,SLN,ATL02,6,14,20
ATL200707220,2007,70722,ATL,SLN,ATL02,7,2,9
ATL200707310,2007,70731,ATL,HOU,ATL02,4,12,16
ATL200708010,2007,70801,ATL,HOU,ATL02,3,12,15
ATL200708020,2007,70802,ATL,HOU,ATL02,12,11,23
ATL200708030,2007,70803,ATL,COL,ATL02,9,2,11
ATL200708040,2007,70804,ATL,COL,ATL02,4,6,10
ATL200708050,2007,70805,ATL,COL,ATL02,5,6,11
ATL200708140,2007,70814,ATL,SFN,ATL02,4,5,9
ATL200708150,2007,70815,ATL,SFN,ATL02,3,6,9
ATL200708160,2007,70816,ATL,SFN,ATL02,9,3,12
ATL200708170,2007,70817,ATL,ARI,ATL02,4,0,4
ATL200708180,2007,70818,ATL,ARI,ATL02,12,6,18
ATL200708190,2007,70819,ATL,ARI,ATL02,2,6,8
ATL200708310,2007,70831,ATL,NYN,ATL02,7,1,8
ATL200709010,2007,70901,ATL,NYN,ATL02,5,1,6
ATL200709020,2007,70902,ATL,NYN,ATL02,3,2,5
ATL200709030,2007,70903,ATL,PHI,ATL02,1,5,6
ATL200709040,2007,70904,ATL,PHI,ATL02,5,2,7
ATL200709050,2007,70905,ATL,PHI,ATL02,8,9,17
ATL200709070,2007,70907,ATL,WAS,ATL02,1,7,8
ATL200709080,2007,70908,ATL,WAS,ATL02,2,9,11
ATL200709090,2007,70909,ATL,WAS,ATL02,7,4,11
ATL200709170,2007,70917,ATL,FLO,ATL02,6,11,17
ATL200709180,2007,70918,ATL,FLO,ATL02,3,4,7
ATL200709190,2007,70919,ATL,FLO,ATL02,1,5,6
ATL200709200,2007,70920,ATL,MIL,ATL02,1,3,4
ATL200709210,2007,70921,ATL,MIL,ATL02,4,1,5
ATL200709220,2007,70922,ATL,MIL,ATL02,3,4,7
ATL200709230,2007,70923,ATL,MIL,ATL02,4,7,11
ATL200803310,2008,80331,ATL,PIT,ATL02,12,11,23
ATL200804020,2008,80402,ATL,PIT,ATL02,2,10,12
ATL200804030,2008,80403,ATL,PIT,ATL02,4,3,7
ATL200804050,2008,80405,ATL,NYN,ATL02,5,11,16
ATL200804060,2008,80406,ATL,NYN,ATL02,1,3,4
ATL200804180,2008,80418,ATL,LAN,ATL02,1,6,7
ATL200804190,2008,80419,ATL,LAN,ATL02,1,4,5
ATL200804200,2008,80420,ATL,LAN,ATL02,1,6,7
ATL200804210,2008,80421,ATL,WAS,ATL02,3,7,10
ATL200804220,2008,80422,ATL,WAS,ATL02,6,0,6
ATL200804230,2008,80423,ATL,FLO,ATL02,7,2,9
ATL200804240,2008,80424,ATL,FLO,ATL02,4,7,11
ATL200805020,2008,80502,ATL,CIN,ATL02,0,2,2
ATL200805030,2008,80503,ATL,CIN,ATL02,1,9,10
ATL200805040,2008,80504,ATL,CIN,ATL02,7,14,21
ATL200805060,2008,80506,ATL,SDN,ATL02,3,5,8
ATL200805070,2008,80507,ATL,SDN,ATL02,2,5,7
ATL200805080,2008,80508,ATL,SDN,ATL02,4,5,9
ATL200805160,2008,80516,ATL,OAK,ATL02,2,3,5
ATL200805170,2008,80517,ATL,OAK,ATL02,5,4,9
ATL200805180,2008,80518,ATL,OAK,ATL02,2,5,7
ATL200805201,2008,80520,ATL,NYN,ATL02,1,6,7
ATL200805202,2008,80520,ATL,NYN,ATL02,2,6,8
ATL200805210,2008,80521,ATL,NYN,ATL02,4,11,15
ATL200805220,2008,80522,ATL,NYN,ATL02,2,4,6
ATL200805230,2008,80523,ATL,ARI,ATL02,11,1,12
ATL200805240,2008,80524,ATL,ARI,ATL02,1,3,4
ATL200805250,2008,80525,ATL,ARI,ATL02,9,3,12
ATL200805260,2008,80526,ATL,ARI,ATL02,3,7,10
ATL200806020,2008,80602,ATL,FLO,ATL02,5,7,12
ATL200806030,2008,80603,ATL,FLO,ATL02,4,5,9
ATL200806040,2008,80604,ATL,FLO,ATL02,6,4,10
ATL200806050,2008,80605,ATL,FLO,ATL02,5,7,12
ATL200806060,2008,80606,ATL,PHI,ATL02,4,3,7
ATL200806070,2008,80607,ATL,PHI,ATL02,6,2,8
ATL200806080,2008,80608,ATL,PHI,ATL02,6,3,9
ATL200806200,2008,80620,ATL,SEA,ATL02,10,2,12
ATL200806210,2008,80621,ATL,SEA,ATL02,4,5,9
ATL200806220,2008,80622,ATL,SEA,ATL02,3,8,11
ATL200806230,2008,80623,ATL,MIL,ATL02,4,1,5
ATL200806240,2008,80624,ATL,MIL,ATL02,4,3,7
ATL200806250,2008,80625,ATL,MIL,ATL02,2,4,6
ATL200807010,2008,80701,ATL,PHI,ATL02,8,3,11
ATL200807020,2008,80702,ATL,PHI,ATL02,7,3,10
ATL200807030,2008,80703,ATL,PHI,ATL02,4,1,5
ATL200807040,2008,80704,ATL,HOU,ATL02,2,6,8
ATL200807050,2008,80705,ATL,HOU,ATL02,6,1,7
ATL200807060,2008,80706,ATL,HOU,ATL02,6,7,13
ATL200807180,2008,80718,ATL,WAS,ATL02,6,7,13
ATL200807190,2008,80719,ATL,WAS,ATL02,8,2,10
ATL200807200,2008,80720,ATL,WAS,ATL02,15,6,21
ATL200807280,2008,80728,ATL,SLN,ATL02,12,3,15
ATL200807290,2008,80729,ATL,SLN,ATL02,8,3,11
ATL200807300,2008,80730,ATL,SLN,ATL02,7,2,9
ATL200807310,2008,80731,ATL,SLN,ATL02,4,9,13
ATL200808010,2008,80801,ATL,MIL,ATL02,9,0,9
ATL200808020,2008,80802,ATL,MIL,ATL02,4,2,6
ATL200808030,2008,80803,ATL,MIL,ATL02,0,5,5
ATL200808131,2008,80813,ATL,CHN,ATL02,10,2,12
ATL200808132,2008,80813,ATL,CHN,ATL02,8,0,8
ATL200808140,2008,80814,ATL,CHN,ATL02,11,7,18
ATL200808150,2008,80815,ATL,SFN,ATL02,5,1,6
ATL200808160,2008,80816,ATL,SFN,ATL02,5,11,16
ATL200808170,2008,80817,ATL,SFN,ATL02,3,1,4
ATL200808180,2008,80818,ATL,SFN,ATL02,5,0,5
ATL200808260,2008,80826,ATL,FLO,ATL02,9,10,19
ATL200808270,2008,80827,ATL,FLO,ATL02,4,1,5
ATL200808280,2008,80828,ATL,FLO,ATL02,2,4,6
ATL200809040,2008,80904,ATL,WAS,ATL02,0,2,2
ATL200809050,2008,80905,ATL,WAS,ATL02,5,10,15
ATL200809060,2008,80906,ATL,WAS,ATL02,8,5,13
ATL200809070,2008,80907,ATL,WAS,ATL02,7,4,11
ATL200809090,2008,80909,ATL,COL,ATL02,4,5,9
ATL200809100,2008,80910,ATL,COL,ATL02,5,9,14
ATL200809110,2008,80911,ATL,COL,ATL02,4,8,12
ATL200809160,2008,80916,ATL,PHI,ATL02,8,7,15
ATL200809170,2008,80917,ATL,PHI,ATL02,6,1,7
ATL200809180,2008,80918,ATL,PHI,ATL02,4,3,7
ATL200809190,2008,80919,ATL,NYN,ATL02,9,5,14
ATL200809200,2008,80920,ATL,NYN,ATL02,2,4,6
ATL200809210,2008,80921,ATL,NYN,ATL02,6,7,13
ATL200904100,2009,90410,ATL,WAS,ATL02,5,6,11
ATL200904110,2009,90411,ATL,WAS,ATL02,3,5,8
ATL200904120,2009,90412,ATL,WAS,ATL02,5,8,13
ATL200904140,2009,90414,ATL,FLO,ATL02,5,1,6
ATL200904150,2009,90415,ATL,FLO,ATL02,10,4,14
ATL200904160,2009,90416,ATL,FLO,ATL02,6,2,8
ATL200904270,2009,90427,ATL,SLN,ATL02,3,2,5
ATL200904280,2009,90428,ATL,SLN,ATL02,1,2,3
ATL200904290,2009,90429,ATL,SLN,ATL02,5,3,8
ATL200905010,2009,90501,ATL,HOU,ATL02,2,7,9
ATL200905020,2009,90502,ATL,HOU,ATL02,5,1,6
ATL200905030,2009,90503,ATL,HOU,ATL02,7,5,12
ATL200905040,2009,90504,ATL,NYN,ATL02,6,4,10
ATL200905050,2009,90505,ATL,NYN,ATL02,4,3,7
ATL200905150,2009,90515,ATL,ARI,ATL02,3,4,7
ATL200905160,2009,90516,ATL,ARI,ATL02,12,0,12
ATL200905180,2009,90518,ATL,COL,ATL02,5,1,6
ATL200905190,2009,90519,ATL,COL,ATL02,1,8,9
ATL200905200,2009,90520,ATL,COL,ATL02,4,12,16
ATL200905210,2009,90521,ATL,COL,ATL02,9,0,9
ATL200905220,2009,90522,ATL,TOR,ATL02,0,1,1
ATL200905230,2009,90523,ATL,TOR,ATL02,3,4,7
ATL200905240,2009,90524,ATL,TOR,ATL02,2,10,12
ATL200906020,2009,90602,ATL,CHN,ATL02,5,6,11
ATL200906030,2009,90603,ATL,CHN,ATL02,3,2,5
ATL200906050,2009,90605,ATL,MIL,ATL02,4,0,4
ATL200906060,2009,90606,ATL,MIL,ATL02,3,0,3
ATL200906070,2009,90607,ATL,MIL,ATL02,7,8,15
ATL200906080,2009,90608,ATL,PIT,ATL02,6,7,13
ATL200906090,2009,90609,ATL,PIT,ATL02,3,4,7
ATL200906100,2009,90610,ATL,PIT,ATL02,3,2,5
ATL200906110,2009,90611,ATL,PIT,ATL02,3,1,4
ATL200906220,2009,90622,ATL,CHN,ATL02,0,2,2
ATL200906230,2009,90623,ATL,NYA,ATL02,0,4,4
ATL200906240,2009,90624,ATL,NYA,ATL02,8,4,12
ATL200906250,2009,90625,ATL,NYA,ATL02,11,7,18
ATL200906260,2009,90626,ATL,BOS,ATL02,4,1,5
ATL200906270,2009,90627,ATL,BOS,ATL02,1,0,1
ATL200906280,2009,90628,ATL,BOS,ATL02,1,2,3
ATL200906300,2009,90630,ATL,PHI,ATL02,4,5,9
ATL200907010,2009,90701,ATL,PHI,ATL02,1,11,12
ATL200907020,2009,90702,ATL,PHI,ATL02,2,5,7
ATL200907160,2009,90716,ATL,NYN,ATL02,3,5,8
ATL200907170,2009,90717,ATL,NYN,ATL02,0,11,11
ATL200907180,2009,90718,ATL,NYN,ATL02,5,1,6
ATL200907190,2009,90719,ATL,NYN,ATL02,1,7,8
ATL200907200,2009,90720,ATL,SFN,ATL02,3,11,14
ATL200907210,2009,90721,ATL,SFN,ATL02,1,8,9
ATL200907220,2009,90722,ATL,SFN,ATL02,2,4,6
ATL200907230,2009,90723,ATL,SFN,ATL02,5,1,6
ATL200907310,2009,90731,ATL,LAN,ATL02,5,0,5
ATL200908010,2009,90801,ATL,LAN,ATL02,3,4,7
ATL200908020,2009,90802,ATL,LAN,ATL02,9,1,10
ATL200908110,2009,90811,ATL,WAS,ATL02,1,8,9
ATL200908120,2009,90812,ATL,WAS,ATL02,2,6,8
ATL200908140,2009,90814,ATL,PHI,ATL02,3,2,5
ATL200908150,2009,90815,ATL,PHI,ATL02,3,4,7
ATL200908160,2009,90816,ATL,PHI,ATL02,4,1,5
ATL200908170,2009,90817,ATL,ARI,ATL02,4,9,13
ATL200908210,2009,90821,ATL,FLO,ATL02,5,3,8
ATL200908220,2009,90822,ATL,FLO,ATL02,3,4,7
ATL200908230,2009,90823,ATL,FLO,ATL02,5,7,12
ATL200908250,2009,90825,ATL,SDN,ATL02,2,1,3
ATL200908260,2009,90826,ATL,SDN,ATL02,12,5,17
ATL200908270,2009,90827,ATL,SDN,ATL02,1,9,10
ATL200909040,2009,90904,ATL,CIN,ATL02,3,1,4
ATL200909050,2009,90905,ATL,CIN,ATL02,3,1,4
ATL200909060,2009,90906,ATL,CIN,ATL02,4,2,6
ATL200909150,2009,90915,ATL,NYN,ATL02,0,6,6
ATL200909160,2009,90916,ATL,NYN,ATL02,5,6,11
ATL200909170,2009,90917,ATL,NYN,ATL02,3,7,10
ATL200909180,2009,90918,ATL,PHI,ATL02,9,4,13
ATL200909190,2009,90919,ATL,PHI,ATL02,4,6,10
ATL200909200,2009,90920,ATL,PHI,ATL02,4,2,6
ATL200909280,2009,90928,ATL,FLO,ATL02,0,4,4
ATL200909290,2009,90929,ATL,FLO,ATL02,5,4,9
ATL200909300,2009,90930,ATL,FLO,ATL02,5,4,9
ATL200910010,2009,91001,ATL,WAS,ATL02,2,1,3
ATL200910020,2009,91002,ATL,WAS,ATL02,6,3,9
ATL200910030,2009,91003,ATL,WAS,ATL02,6,4,10
ATL200910040,2009,91004,ATL,WAS,ATL02,2,1,3
BAL200004030,2000,403,BAL,CLE,BAL12,4,1,5
BAL200004050,2000,405,BAL,CLE,BAL12,7,11,18
BAL200004060,2000,406,BAL,CLE,BAL12,2,6,8
BAL200004070,2000,407,BAL,DET,BAL12,10,14,24
BAL200004080,2000,408,BAL,DET,BAL12,1,2,3
BAL200004090,2000,409,BAL,DET,BAL12,6,11,17
BAL200004190,2000,419,BAL,TBA,BAL12,2,3,5
BAL200004200,2000,420,BAL,TBA,BAL12,4,8,12
BAL200004280,2000,428,BAL,TEX,BAL12,3,4,7
BAL200004290,2000,429,BAL,TEX,BAL12,1,3,4
BAL200004300,2000,430,BAL,TEX,BAL12,8,4,12
BAL200005020,2000,502,BAL,ANA,BAL12,6,7,13
BAL200005030,2000,503,BAL,ANA,BAL12,6,5,11
BAL200005040,2000,504,BAL,ANA,BAL12,8,5,13
BAL200005110,2000,511,BAL,BOS,BAL12,11,4,15
BAL200005120,2000,512,BAL,BOS,BAL12,9,0,9
BAL200005130,2000,513,BAL,BOS,BAL12,5,1,6
BAL200005140,2000,514,BAL,BOS,BAL12,10,1,11
BAL200005230,2000,523,BAL,SEA,BAL12,2,4,6
BAL200005240,2000,524,BAL,SEA,BAL12,3,4,7
BAL200005250,2000,525,BAL,SEA,BAL12,1,5,6
BAL200005260,2000,526,BAL,OAK,BAL12,3,8,11
BAL200005270,2000,527,BAL,OAK,BAL12,4,0,4
BAL200006090,2000,609,BAL,PHI,BAL12,9,5,14
BAL200006100,2000,610,BAL,PHI,BAL12,4,11,15
BAL200006110,2000,611,BAL,PHI,BAL12,2,7,9
BAL200006130,2000,613,BAL,TEX,BAL12,2,3,5
BAL200006140,2000,614,BAL,TEX,BAL12,10,11,21
BAL200006150,2000,615,BAL,TEX,BAL12,1,10,11
BAL200006160,2000,616,BAL,ANA,BAL12,3,4,7
BAL200006170,2000,617,BAL,ANA,BAL12,8,3,11
BAL200006180,2000,618,BAL,ANA,BAL12,8,6,14
BAL200006300,2000,630,BAL,TOR,BAL12,3,8,11
BAL200007010,2000,701,BAL,TOR,BAL12,5,12,17
BAL200007020,2000,702,BAL,TOR,BAL12,2,3,5
BAL200007030,2000,703,BAL,TOR,BAL12,6,4,10
BAL200007130,2000,713,BAL,ATL,BAL12,6,3,9
BAL200007140,2000,714,BAL,ATL,BAL12,4,1,5
BAL200007150,2000,715,BAL,ATL,BAL12,7,3,10
BAL200007160,2000,716,BAL,FLO,BAL12,5,9,14
BAL200007170,2000,717,BAL,FLO,BAL12,3,5,8
BAL200007180,2000,718,BAL,FLO,BAL12,7,0,7
BAL200007201,2000,720,BAL,BOS,BAL12,11,7,18
BAL200007202,2000,720,BAL,BOS,BAL12,4,9,13
BAL200007240,2000,724,BAL,NYA,BAL12,4,3,7
BAL200007250,2000,725,BAL,NYA,BAL12,19,1,20
BAL200007260,2000,726,BAL,NYA,BAL12,4,1,5
BAL200007291,2000,729,BAL,CLE,BAL12,14,3,17
BAL200007292,2000,729,BAL,CLE,BAL12,0,4,4
BAL200007300,2000,730,BAL,CLE,BAL12,7,10,17
BAL200007310,2000,731,BAL,MIN,BAL12,5,6,11
BAL200008010,2000,801,BAL,MIN,BAL12,0,10,10
BAL200008020,2000,802,BAL,MIN,BAL12,10,6,16
BAL200008140,2000,814,BAL,CHA,BAL12,2,8,10
BAL200008150,2000,815,BAL,CHA,BAL12,14,4,18
BAL200008160,2000,816,BAL,CHA,BAL12,7,3,10
BAL200008170,2000,817,BAL,CHA,BAL12,3,5,8
BAL200008180,2000,818,BAL,KCA,BAL12,4,1,5
BAL200008190,2000,819,BAL,KCA,BAL12,7,0,7
BAL200008200,2000,820,BAL,KCA,BAL12,1,2,3
BAL200008210,2000,821,BAL,KCA,BAL12,1,2,3
BAL200008250,2000,825,BAL,TBA,BAL12,3,4,7
BAL200008261,2000,826,BAL,TBA,BAL12,4,1,5
BAL200008262,2000,826,BAL,TBA,BAL12,0,2,2
BAL200008270,2000,827,BAL,TBA,BAL12,2,3,5
BAL200008290,2000,829,BAL,DET,BAL12,12,2,14
BAL200008300,2000,830,BAL,DET,BAL12,1,5,6
BAL200008310,2000,831,BAL,DET,BAL12,6,1,7
BAL200009150,2000,915,BAL,SEA,BAL12,10,2,12
BAL200009160,2000,916,BAL,SEA,BAL12,14,0,14
BAL200009170,2000,917,BAL,SEA,BAL12,3,2,5
BAL200009180,2000,918,BAL,OAK,BAL12,12,3,15
BAL200009190,2000,919,BAL,OAK,BAL12,7,4,11
BAL200009201,2000,920,BAL,OAK,BAL12,0,2,2
BAL200009202,2000,920,BAL,OAK,BAL12,4,0,4
BAL200009260,2000,926,BAL,TOR,BAL12,1,2,3
BAL200009270,2000,927,BAL,TOR,BAL12,4,0,4
BAL200009280,2000,928,BAL,TOR,BAL12,1,23,24
BAL200009290,2000,929,BAL,NYA,BAL12,2,13,15
BAL200009300,2000,930,BAL,NYA,BAL12,1,9,10
BAL200010010,2000,1001,BAL,NYA,BAL12,3,7,10
BAL200104020,2001,10402,BAL,BOS,BAL12,1,2,3
BAL200104040,2001,10404,BAL,BOS,BAL12,3,0,3
BAL200104050,2001,10405,BAL,BOS,BAL12,1,2,3
BAL200104130,2001,10413,BAL,TBA,BAL12,2,0,2
BAL200104140,2001,10414,BAL,TBA,BAL12,5,6,11
BAL200104150,2001,10415,BAL,TBA,BAL12,7,4,11
BAL200104160,2001,10416,BAL,TBA,BAL12,2,6,8
BAL200104170,2001,10417,BAL,CLE,BAL12,8,1,9
BAL200104180,2001,10418,BAL,CLE,BAL12,4,1,5
BAL200104190,2001,10419,BAL,CLE,BAL12,11,5,16
BAL200104300,2001,10430,BAL,TBA,BAL12,3,5,8
BAL200105010,2001,10501,BAL,TBA,BAL12,1,3,4
BAL200105020,2001,10502,BAL,TBA,BAL12,7,1,8
BAL200105030,2001,10503,BAL,NYA,BAL12,7,5,12
BAL200105040,2001,10504,BAL,NYA,BAL12,6,5,11
BAL200105050,2001,10505,BAL,NYA,BAL12,5,2,7
BAL200105060,2001,10506,BAL,NYA,BAL12,2,1,3
BAL200105150,2001,10515,BAL,DET,BAL12,3,11,14
BAL200105160,2001,10516,BAL,DET,BAL12,2,3,5
BAL200105170,2001,10517,BAL,DET,BAL12,7,5,12
BAL200105180,2001,10518,BAL,MIN,BAL12,2,7,9
BAL200105190,2001,10519,BAL,MIN,BAL12,7,5,12
BAL200105200,2001,10520,BAL,MIN,BAL12,2,3,5
BAL200105230,2001,10523,BAL,ANA,BAL12,5,12,17
BAL200105240,2001,10524,BAL,ANA,BAL12,4,6,10
BAL200105250,2001,10525,BAL,TEX,BAL12,6,7,13
BAL200105270,2001,10527,BAL,TEX,BAL12,1,3,4
BAL200105280,2001,10528,BAL,TEX,BAL12,6,3,9
BAL200106080,2001,10608,BAL,MON,BAL12,0,5,5
BAL200106090,2001,10609,BAL,MON,BAL12,4,2,6
BAL200106100,2001,10610,BAL,MON,BAL12,2,3,5
BAL200106120,2001,10612,BAL,NYN,BAL12,10,3,13
BAL200106130,2001,10613,BAL,NYN,BAL12,7,6,13
BAL200106140,2001,10614,BAL,NYN,BAL12,2,5,7
BAL200106180,2001,10618,BAL,TOR,BAL12,2,3,5
BAL200106190,2001,10619,BAL,TOR,BAL12,1,5,6
BAL200106200,2001,10620,BAL,TOR,BAL12,6,5,11
BAL200106210,2001,10621,BAL,CHA,BAL12,6,0,6
BAL200106220,2001,10622,BAL,CHA,BAL12,4,6,10
BAL200106230,2001,10623,BAL,CHA,BAL12,8,3,11
BAL200106240,2001,10624,BAL,CHA,BAL12,8,2,10
BAL200107030,2001,10703,BAL,NYA,BAL12,10,6,16
BAL200107040,2001,10704,BAL,NYA,BAL12,4,3,7
BAL200107050,2001,10705,BAL,NYA,BAL12,6,3,9
BAL200107060,2001,10706,BAL,PHI,BAL12,3,2,5
BAL200107070,2001,10707,BAL,PHI,BAL12,3,4,7
BAL200107080,2001,10708,BAL,PHI,BAL12,5,4,9
BAL200107180,2001,10718,BAL,TEX,BAL12,6,4,10
BAL200107210,2001,10721,BAL,ANA,BAL12,6,5,11
BAL200107221,2001,10722,BAL,ANA,BAL12,9,4,13
BAL200107222,2001,10722,BAL,ANA,BAL12,1,5,6
BAL200107230,2001,10723,BAL,ANA,BAL12,9,4,13
BAL200107300,2001,10730,BAL,TEX,BAL12,6,4,10
BAL200107310,2001,10731,BAL,TBA,BAL12,5,4,9
BAL200108010,2001,10801,BAL,TBA,BAL12,5,6,11
BAL200108020,2001,10802,BAL,TBA,BAL12,3,2,5
BAL200108110,2001,10811,BAL,BOS,BAL12,2,4,6
BAL200108120,2001,10812,BAL,BOS,BAL12,12,10,22
BAL200108140,2001,10814,BAL,KCA,BAL12,2,5,7
BAL200108150,2001,10815,BAL,KCA,BAL12,4,5,9
BAL200108160,2001,10816,BAL,KCA,BAL12,9,2,11
BAL200108240,2001,10824,BAL,TOR,BAL12,5,0,5
BAL200108250,2001,10825,BAL,TOR,BAL12,9,0,9
BAL200108260,2001,10826,BAL,TOR,BAL12,5,1,6
BAL200108280,2001,10828,BAL,OAK,BAL12,6,2,8
BAL200108290,2001,10829,BAL,OAK,BAL12,4,1,5
BAL200108300,2001,10830,BAL,OAK,BAL12,15,0,15
BAL200108310,2001,10831,BAL,SEA,BAL12,0,3,3
BAL200109010,2001,10901,BAL,SEA,BAL12,6,4,10
BAL200109020,2001,10902,BAL,SEA,BAL12,1,0,1
BAL200109210,2001,10921,BAL,NYA,BAL12,6,7,13
BAL200109220,2001,10922,BAL,NYA,BAL12,2,11,13
BAL200109230,2001,10923,BAL,NYA,BAL12,5,4,9
BAL200110010,2001,11001,BAL,TOR,BAL12,1,0,1
BAL200110020,2001,11002,BAL,TOR,BAL12,3,4,7
BAL200110030,2001,11003,BAL,TOR,BAL12,7,6,13
BAL200110040,2001,11004,BAL,BOS,BAL12,5,4,9
BAL200110051,2001,11005,BAL,BOS,BAL12,5,0,5
BAL200110052,2001,11005,BAL,BOS,BAL12,7,5,12
BAL200110060,2001,11006,BAL,BOS,BAL12,5,1,6
BAL200204010,2002,20401,BAL,NYA,BAL12,3,10,13
BAL200204030,2002,20403,BAL,NYA,BAL12,1,0,1
BAL200204040,2002,20404,BAL,NYA,BAL12,4,1,5
BAL200204050,2002,20405,BAL,BOS,BAL12,3,0,3
BAL200204060,2002,20406,BAL,BOS,BAL12,4,2,6
BAL200204070,2002,20407,BAL,BOS,BAL12,4,1,5
BAL200204100,2002,20410,BAL,TBA,BAL12,3,2,5
BAL200204110,2002,20411,BAL,TBA,BAL12,6,15,21
BAL200204230,2002,20423,BAL,BOS,BAL12,5,7,12
BAL200204240,2002,20424,BAL,BOS,BAL12,3,5,8
BAL200204250,2002,20425,BAL,BOS,BAL12,7,0,7
BAL200205020,2002,20502,BAL,KCA,BAL12,2,6,8
BAL200205030,2002,20503,BAL,KCA,BAL12,3,4,7
BAL200205040,2002,20504,BAL,KCA,BAL12,0,10,10
BAL200205050,2002,20505,BAL,KCA,BAL12,2,3,5
BAL200205060,2002,20506,BAL,CLE,BAL12,9,4,13
BAL200205070,2002,20507,BAL,CLE,BAL12,3,4,7
BAL200205080,2002,20508,BAL,CLE,BAL12,6,2,8
BAL200205170,2002,20517,BAL,TBA,BAL12,3,5,8
BAL200205180,2002,20518,BAL,TBA,BAL12,5,4,9
BAL200205190,2002,20519,BAL,TBA,BAL12,4,0,4
BAL200205280,2002,20528,BAL,OAK,BAL12,5,2,7
BAL200205290,2002,20529,BAL,OAK,BAL12,5,10,15
BAL200205300,2002,20530,BAL,SEA,BAL12,5,4,9
BAL200205310,2002,20531,BAL,SEA,BAL12,7,8,15
BAL200206010,2002,20601,BAL,SEA,BAL12,3,4,7
BAL200206020,2002,20602,BAL,SEA,BAL12,11,8,19
BAL200206070,2002,20607,BAL,LAN,BAL12,2,4,6
BAL200206080,2002,20608,BAL,LAN,BAL12,8,4,12
BAL200206090,2002,20609,BAL,LAN,BAL12,2,1,3
BAL200206100,2002,20610,BAL,SDN,BAL12,6,8,14
BAL200206110,2002,20611,BAL,SDN,BAL12,5,6,11
BAL200206120,2002,20612,BAL,SDN,BAL12,2,0,2
BAL200206250,2002,20625,BAL,NYA,BAL12,3,4,7
BAL200206260,2002,20626,BAL,NYA,BAL12,7,8,15
BAL200206270,2002,20627,BAL,NYA,BAL12,3,2,5
BAL200206280,2002,20628,BAL,PHI,BAL12,6,2,8
BAL200206290,2002,20629,BAL,PHI,BAL12,1,11,12
BAL200206300,2002,20630,BAL,PHI,BAL12,8,5,13
BAL200207110,2002,20711,BAL,OAK,BAL12,4,1,5
BAL200207120,2002,20712,BAL,OAK,BAL12,1,0,1
BAL200207130,2002,20713,BAL,OAK,BAL12,6,0,6
BAL200207140,2002,20714,BAL,OAK,BAL12,3,6,9
BAL200207150,2002,20715,BAL,SEA,BAL12,5,6,11
BAL200207160,2002,20716,BAL,SEA,BAL12,1,6,7
BAL200207190,2002,20719,BAL,CHA,BAL12,4,10,14
BAL200207200,2002,20720,BAL,CHA,BAL12,3,4,7
BAL200207210,2002,20721,BAL,CHA,BAL12,8,7,15
BAL200207220,2002,20722,BAL,TOR,BAL12,6,3,9
BAL200207240,2002,20724,BAL,TOR,BAL12,5,2,7
BAL200208060,2002,20806,BAL,MIN,BAL12,2,9,11
BAL200208070,2002,20807,BAL,MIN,BAL12,4,6,10
BAL200208080,2002,20808,BAL,MIN,BAL12,1,4,5
BAL200208160,2002,20816,BAL,DET,BAL12,6,5,11
BAL200208170,2002,20817,BAL,DET,BAL12,3,7,10
BAL200208180,2002,20818,BAL,DET,BAL12,7,4,11
BAL200208190,2002,20819,BAL,TBA,BAL12,7,3,10
BAL200208200,2002,20820,BAL,TBA,BAL12,4,7,11
BAL200208210,2002,20821,BAL,TBA,BAL12,1,2,3
BAL200208220,2002,20822,BAL,TBA,BAL12,2,3,5
BAL200208230,2002,20823,BAL,TOR,BAL12,7,11,18
BAL200208241,2002,20824,BAL,TOR,BAL12,4,1,5
BAL200208242,2002,20824,BAL,TOR,BAL12,8,3,11
BAL200208250,2002,20825,BAL,TOR,BAL12,5,2,7
BAL200209030,2002,20903,BAL,TEX,BAL12,7,1,8
BAL200209040,2002,20904,BAL,TEX,BAL12,3,8,11
BAL200209050,2002,20905,BAL,TEX,BAL12,11,2,13
BAL200209060,2002,20906,BAL,ANA,BAL12,6,3,9
BAL200209070,2002,20907,BAL,ANA,BAL12,4,2,6
BAL200209080,2002,20908,BAL,ANA,BAL12,6,2,8
BAL200209160,2002,20916,BAL,TOR,BAL12,2,0,2
BAL200209170,2002,20917,BAL,TOR,BAL12,4,10,14
BAL200209180,2002,20918,BAL,TOR,BAL12,2,1,3
BAL200209190,2002,20919,BAL,TOR,BAL12,9,3,12
BAL200209200,2002,20920,BAL,BOS,BAL12,4,2,6
BAL200209210,2002,20921,BAL,BOS,BAL12,3,0,3
BAL200209220,2002,20922,BAL,BOS,BAL12,13,2,15
BAL200209230,2002,20923,BAL,BOS,BAL12,5,4,9
BAL200209270,2002,20927,BAL,NYA,BAL12,6,2,8
BAL200209280,2002,20928,BAL,NYA,BAL12,4,2,6
BAL200209290,2002,20929,BAL,NYA,BAL12,6,1,7
BAL200303310,2003,30331,BAL,CLE,BAL12,5,6,11
BAL200304020,2003,30402,BAL,CLE,BAL12,4,2,6
BAL200304030,2003,30403,BAL,CLE,BAL12,3,0,3
BAL200304040,2003,30404,BAL,BOS,BAL12,8,7,15
BAL200304050,2003,30405,BAL,BOS,BAL12,1,2,3
BAL200304060,2003,30406,BAL,BOS,BAL12,12,2,14
BAL200304180,2003,30418,BAL,TBA,BAL12,7,9,16
BAL200304190,2003,30419,BAL,TBA,BAL12,8,7,15
BAL200304200,2003,30420,BAL,TBA,BAL12,1,4,5
BAL200304210,2003,30421,BAL,TBA,BAL12,0,4,4
BAL200304220,2003,30422,BAL,CHA,BAL12,3,1,4
BAL200304230,2003,30423,BAL,CHA,BAL12,1,7,8
BAL200304240,2003,30424,BAL,CHA,BAL12,4,5,9
BAL200305020,2003,30502,BAL,KCA,BAL12,5,2,7
BAL200305030,2003,30503,BAL,KCA,BAL12,1,6,7
BAL200305040,2003,30504,BAL,KCA,BAL12,4,0,4
BAL200305050,2003,30505,BAL,DET,BAL12,6,1,7
BAL200305060,2003,30506,BAL,DET,BAL12,7,6,13
BAL200305070,2003,30507,BAL,DET,BAL12,9,4,13
BAL200305160,2003,30516,BAL,TBA,BAL12,5,1,6
BAL200305170,2003,30517,BAL,TBA,BAL12,0,2,2
BAL200305180,2003,30518,BAL,TBA,BAL12,9,8,17
BAL200305270,2003,30527,BAL,ANA,BAL12,4,12,16
BAL200305280,2003,30528,BAL,ANA,BAL12,2,6,8
BAL200305290,2003,30529,BAL,TEX,BAL12,8,4,12
BAL200305300,2003,30530,BAL,TEX,BAL12,1,8,9
BAL200305310,2003,30531,BAL,TEX,BAL12,1,7,8
BAL200306010,2003,30601,BAL,TEX,BAL12,4,5,9
BAL200306100,2003,30610,BAL,CHN,BAL12,4,0,4
BAL200306110,2003,30611,BAL,CHN,BAL12,7,6,13
BAL200306120,2003,30612,BAL,CHN,BAL12,1,6,7
BAL200306130,2003,30613,BAL,MIL,BAL12,2,7,9
BAL200306140,2003,30614,BAL,MIL,BAL12,8,3,11
BAL200306150,2003,30615,BAL,MIL,BAL12,4,5,9
BAL200306180,2003,30618,BAL,TOR,BAL12,6,2,8
BAL200306190,2003,30619,BAL,TOR,BAL12,6,1,7
BAL200306270,2003,30627,BAL,PHI,BAL12,4,2,6
BAL200306280,2003,30628,BAL,PHI,BAL12,9,5,14
BAL200306290,2003,30629,BAL,PHI,BAL12,4,3,7
BAL200306300,2003,30630,BAL,NYA,BAL12,6,5,11
BAL200307010,2003,30701,BAL,NYA,BAL12,3,7,10
BAL200307030,2003,30703,BAL,TOR,BAL12,5,6,11
BAL200307040,2003,30704,BAL,TOR,BAL12,5,8,13
BAL200307050,2003,30705,BAL,TOR,BAL12,2,9,11
BAL200307060,2003,30706,BAL,TOR,BAL12,5,3,8
BAL200307170,2003,30717,BAL,ANA,BAL12,1,2,3
BAL200307180,2003,30718,BAL,ANA,BAL12,5,6,11
BAL200307190,2003,30719,BAL,ANA,BAL12,4,8,12
BAL200307200,2003,30720,BAL,ANA,BAL12,6,7,13
BAL200307210,2003,30721,BAL,TEX,BAL12,2,3,5
BAL200307220,2003,30722,BAL,TEX,BAL12,6,12,18
BAL200308010,2003,30801,BAL,BOS,BAL12,1,2,3
BAL200308020,2003,30802,BAL,BOS,BAL12,2,11,13
BAL200308030,2003,30803,BAL,BOS,BAL12,7,5,12
BAL200308040,2003,30804,BAL,MIN,BAL12,3,2,5
BAL200308050,2003,30805,BAL,MIN,BAL12,2,3,5
BAL200308060,2003,30806,BAL,MIN,BAL12,7,3,10
BAL200308070,2003,30807,BAL,MIN,BAL12,3,5,8
BAL200308140,2003,30814,BAL,NYA,BAL12,8,5,13
BAL200308150,2003,30815,BAL,NYA,BAL12,6,4,10
BAL200308160,2003,30816,BAL,NYA,BAL12,5,4,9
BAL200308170,2003,30817,BAL,NYA,BAL12,8,0,8
BAL200308190,2003,30819,BAL,TBA,BAL12,9,2,11
BAL200308200,2003,30820,BAL,TBA,BAL12,5,9,14
BAL200308210,2003,30821,BAL,TBA,BAL12,4,5,9
BAL200309020,2003,30902,BAL,OAK,BAL12,2,0,2
BAL200309030,2003,30903,BAL,OAK,BAL12,0,9,9
BAL200309040,2003,30904,BAL,OAK,BAL12,5,7,12
BAL200309050,2003,30905,BAL,SEA,BAL12,6,4,10
BAL200309060,2003,30906,BAL,SEA,BAL12,1,3,4
BAL200309070,2003,30907,BAL,SEA,BAL12,1,2,3
BAL200309080,2003,30908,BAL,BOS,BAL12,10,13,23
BAL200309090,2003,30909,BAL,BOS,BAL12,9,2,11
BAL200309100,2003,30910,BAL,BOS,BAL12,5,0,5
BAL200309150,2003,30915,BAL,NYA,BAL12,13,1,14
BAL200309160,2003,30916,BAL,NYA,BAL12,6,3,9
BAL200309170,2003,30917,BAL,NYA,BAL12,3,5,8
BAL200309180,2003,30918,BAL,NYA,BAL12,1,1,2
BAL200309190,2003,30919,BAL,TOR,BAL12,5,2,7
BAL200309200,2003,30920,BAL,TOR,BAL12,1,2,3
BAL200309210,2003,30921,BAL,TOR,BAL12,7,4,11
BAL200404040,2004,40404,BAL,BOS,BAL12,2,7,9
BAL200404060,2004,40406,BAL,BOS,BAL12,4,1,5
BAL200404070,2004,40407,BAL,BOS,BAL12,10,3,13
BAL200404080,2004,40408,BAL,BOS,BAL12,2,3,5
BAL200404200,2004,40420,BAL,TBA,BAL12,1,9,10
BAL200404210,2004,40421,BAL,TBA,BAL12,7,3,10
BAL200404220,2004,40422,BAL,TBA,BAL12,6,7,13
BAL200404230,2004,40423,BAL,TOR,BAL12,3,11,14
BAL200404240,2004,40424,BAL,TOR,BAL12,5,4,9
BAL200404250,2004,40425,BAL,TOR,BAL12,15,3,18
BAL200404270,2004,40427,BAL,SEA,BAL12,7,5,12
BAL200404280,2004,40428,BAL,SEA,BAL12,1,3,4
BAL200404290,2004,40429,BAL,SEA,BAL12,5,9,14
BAL200405030,2004,40503,BAL,CHA,BAL12,5,4,9
BAL200405040,2004,40504,BAL,CHA,BAL12,3,10,13
BAL200405050,2004,40505,BAL,CHA,BAL12,6,5,11
BAL200405070,2004,40507,BAL,CLE,BAL12,2,3,5
BAL200405080,2004,40508,BAL,CLE,BAL12,7,10,17
BAL200405090,2004,40509,BAL,CLE,BAL12,11,12,23
BAL200405140,2004,40514,BAL,ANA,BAL12,10,9,19
BAL200405150,2004,40515,BAL,ANA,BAL12,7,4,11
BAL200405160,2004,40516,BAL,ANA,BAL12,0,4,4
BAL200405250,2004,40525,BAL,NYA,BAL12,11,3,14
BAL200405260,2004,40526,BAL,NYA,BAL12,12,9,21
BAL200405270,2004,40527,BAL,NYA,BAL12,18,5,23
BAL200406040,2004,40604,BAL,TBA,BAL12,8,7,15
BAL200406060,2004,40606,BAL,TBA,BAL12,4,5,9
BAL200406080,2004,40608,BAL,ARI,BAL12,8,1,9
BAL200406090,2004,40609,BAL,ARI,BAL12,2,8,10
BAL200406100,2004,40610,BAL,ARI,BAL12,3,0,3
BAL200406121,2004,40612,BAL,SFN,BAL12,9,6,15
BAL200406122,2004,40612,BAL,SFN,BAL12,4,5,9
BAL200406130,2004,40613,BAL,SFN,BAL12,7,3,10
BAL200406220,2004,40622,BAL,NYA,BAL12,10,4,14
BAL200406230,2004,40623,BAL,NYA,BAL12,2,13,15
BAL200406240,2004,40624,BAL,NYA,BAL12,5,2,7
BAL200406250,2004,40625,BAL,ATL,BAL12,0,5,5
BAL200406260,2004,40626,BAL,ATL,BAL12,5,0,5
BAL200406270,2004,40627,BAL,ATL,BAL12,8,7,15
BAL200407051,2004,40705,BAL,TBA,BAL12,2,4,6
BAL200407052,2004,40705,BAL,TBA,BAL12,2,8,10
BAL200407060,2004,40706,BAL,TBA,BAL12,3,1,4
BAL200407070,2004,40707,BAL,TBA,BAL12,13,3,16
BAL200407090,2004,40709,BAL,KCA,BAL12,7,0,7
BAL200407100,2004,40710,BAL,KCA,BAL12,2,7,9
BAL200407110,2004,40711,BAL,KCA,BAL12,11,7,18
BAL200407230,2004,40723,BAL,MIN,BAL12,7,3,10
BAL200407240,2004,40724,BAL,MIN,BAL12,2,4,6
BAL200407250,2004,40725,BAL,MIN,BAL12,8,4,12
BAL200407260,2004,40726,BAL,BOS,BAL12,12,5,17
BAL200407280,2004,40728,BAL,BOS,BAL12,1,4,5
BAL200408031,2004,40803,BAL,SEA,BAL12,7,9,16
BAL200408032,2004,40803,BAL,SEA,BAL12,4,5,9
BAL200408040,2004,40804,BAL,SEA,BAL12,3,6,9
BAL200408060,2004,40806,BAL,TEX,BAL12,1,9,10
BAL200408070,2004,40807,BAL,TEX,BAL12,1,3,4
BAL200408080,2004,40808,BAL,TEX,BAL12,5,11,16
BAL200408090,2004,40809,BAL,TEX,BAL12,3,7,10
BAL200408160,2004,40816,BAL,OAK,BAL12,3,1,4
BAL200408170,2004,40817,BAL,OAK,BAL12,11,0,11
BAL200408180,2004,40818,BAL,OAK,BAL12,5,4,9
BAL200408200,2004,40820,BAL,TOR,BAL12,14,4,18
BAL200408210,2004,40821,BAL,TOR,BAL12,10,4,14
BAL200408220,2004,40822,BAL,TOR,BAL12,8,5,13
BAL200409060,2004,40906,BAL,MIN,BAL12,1,4,5
BAL200409070,2004,40907,BAL,MIN,BAL12,3,1,4
BAL200409080,2004,40908,BAL,MIN,BAL12,9,0,9
BAL200409100,2004,40910,BAL,NYA,BAL12,8,14,22
BAL200409110,2004,40911,BAL,NYA,BAL12,5,2,7
BAL200409120,2004,40912,BAL,NYA,BAL12,9,7,16
BAL200409240,2004,40924,BAL,DET,BAL12,5,7,12
BAL200409250,2004,40925,BAL,DET,BAL12,0,3,3
BAL200409260,2004,40926,BAL,DET,BAL12,0,5,5
BAL200409270,2004,40927,BAL,TOR,BAL12,4,1,5
BAL200409291,2004,40929,BAL,TOR,BAL12,6,7,13
BAL200409292,2004,40929,BAL,TOR,BAL12,0,4,4
BAL200409300,2004,40930,BAL,TOR,BAL12,3,9,12
BAL200410010,2004,41001,BAL,BOS,BAL12,8,3,11
BAL200410021,2004,41002,BAL,BOS,BAL12,7,5,12
BAL200410022,2004,41002,BAL,BOS,BAL12,7,5,12
BAL200410030,2004,41003,BAL,BOS,BAL12,2,3,5
BAL200504040,2005,50404,BAL,OAK,BAL12,0,4,4
BAL200504060,2005,50406,BAL,OAK,BAL12,9,0,9
BAL200504070,2005,50407,BAL,OAK,BAL12,5,1,6
BAL200504150,2005,50415,BAL,NYA,BAL12,1,8,9
BAL200504160,2005,50416,BAL,NYA,BAL12,6,7,13
BAL200504170,2005,50417,BAL,NYA,BAL12,4,8,12
BAL200504180,2005,50418,BAL,DET,BAL12,13,3,16
BAL200504190,2005,50419,BAL,DET,BAL12,4,8,12
BAL200504200,2005,50420,BAL,BOS,BAL12,8,0,8
BAL200504210,2005,50421,BAL,BOS,BAL12,1,0,1
BAL200504290,2005,50429,BAL,TBA,BAL12,0,5,5
BAL200504300,2005,50430,BAL,TBA,BAL12,5,7,12
BAL200505010,2005,50501,BAL,TBA,BAL12,4,7,11
BAL200505020,2005,50502,BAL,TOR,BAL12,6,2,8
BAL200505030,2005,50503,BAL,TOR,BAL12,1,0,1
BAL200505040,2005,50504,BAL,TOR,BAL12,1,5,6
BAL200505060,2005,50506,BAL,KCA,BAL12,1,3,4
BAL200505070,2005,50507,BAL,KCA,BAL12,3,5,8
BAL200505080,2005,50508,BAL,KCA,BAL12,10,8,18
BAL200505090,2005,50509,BAL,MIN,BAL12,0,3,3
BAL200505100,2005,50510,BAL,MIN,BAL12,6,4,10
BAL200505110,2005,50511,BAL,MIN,BAL12,4,7,11
BAL200505200,2005,50520,BAL,PHI,BAL12,9,3,12
BAL200505210,2005,50521,BAL,PHI,BAL12,0,7,7
BAL200505220,2005,50522,BAL,PHI,BAL12,7,2,9
BAL200505240,2005,50524,BAL,SEA,BAL12,2,3,5
BAL200505250,2005,50525,BAL,SEA,BAL12,1,3,4
BAL200505260,2005,50526,BAL,SEA,BAL12,2,5,7
BAL200505270,2005,50527,BAL,DET,BAL12,4,3,7
BAL200505280,2005,50528,BAL,DET,BAL12,5,3,8
BAL200505290,2005,50529,BAL,DET,BAL12,8,6,14
BAL200506130,2005,50613,BAL,HOU,BAL12,5,8,13
BAL200506140,2005,50614,BAL,HOU,BAL12,1,6,7
BAL200506150,2005,50615,BAL,HOU,BAL12,1,5,6
BAL200506170,2005,50617,BAL,COL,BAL12,2,1,3
BAL200506180,2005,50618,BAL,COL,BAL12,2,7,9
BAL200506190,2005,50619,BAL,COL,BAL12,2,4,6
BAL200506270,2005,50627,BAL,NYA,BAL12,6,4,10
BAL200506280,2005,50628,BAL,NYA,BAL12,4,5,9
BAL200506300,2005,50630,BAL,CLE,BAL12,9,3,12
BAL200507010,2005,50701,BAL,CLE,BAL12,3,1,4
BAL200507020,2005,50702,BAL,CLE,BAL12,0,4,4
BAL200507030,2005,50703,BAL,CLE,BAL12,9,4,13
BAL200507070,2005,50707,BAL,BOS,BAL12,1,3,4
BAL200507080,2005,50708,BAL,BOS,BAL12,7,2,9
BAL200507090,2005,50709,BAL,BOS,BAL12,1,9,10
BAL200507100,2005,50710,BAL,BOS,BAL12,1,4,5
BAL200507250,2005,50725,BAL,TEX,BAL12,4,2,6
BAL200507260,2005,50726,BAL,TEX,BAL12,4,5,9
BAL200507270,2005,50727,BAL,TEX,BAL12,11,8,19
BAL200507280,2005,50728,BAL,TEX,BAL12,2,1,3
BAL200507290,2005,50729,BAL,CHA,BAL12,7,2,9
BAL200507300,2005,50730,BAL,CHA,BAL12,9,6,15
BAL200507310,2005,50731,BAL,CHA,BAL12,9,4,13
BAL200508010,2005,50801,BAL,CHA,BAL12,6,3,9
BAL200508090,2005,50809,BAL,TBA,BAL12,2,5,7
BAL200508100,2005,50810,BAL,TBA,BAL12,5,9,14
BAL200508110,2005,50811,BAL,TBA,BAL12,2,4,6
BAL200508120,2005,50812,BAL,TOR,BAL12,12,0,12
BAL200508130,2005,50813,BAL,TOR,BAL12,0,1,1
BAL200508140,2005,50814,BAL,TOR,BAL12,7,6,13
BAL200508230,2005,50823,BAL,ANA,BAL12,7,6,13
BAL200508240,2005,50824,BAL,ANA,BAL12,3,1,4
BAL200508250,2005,50825,BAL,ANA,BAL12,0,2,2
BAL200508260,2005,50826,BAL,OAK,BAL12,4,1,5
BAL200508270,2005,50827,BAL,OAK,BAL12,12,3,15
BAL200508280,2005,50828,BAL,OAK,BAL12,10,3,13
BAL200508290,2005,50829,BAL,OAK,BAL12,10,5,15
BAL200509050,2005,50905,BAL,TOR,BAL12,6,2,8
BAL200509060,2005,50906,BAL,TOR,BAL12,0,5,5
BAL200509070,2005,50907,BAL,TOR,BAL12,7,4,11
BAL200509160,2005,50916,BAL,TBA,BAL12,6,1,7
BAL200509170,2005,50917,BAL,TBA,BAL12,1,2,3
BAL200509180,2005,50918,BAL,TBA,BAL12,6,5,11
BAL200509230,2005,50923,BAL,BOS,BAL12,6,3,9
BAL200509240,2005,50924,BAL,BOS,BAL12,4,3,7
BAL200509250,2005,50925,BAL,BOS,BAL12,9,3,12
BAL200509260,2005,50926,BAL,NYA,BAL12,11,3,14
BAL200509270,2005,50927,BAL,NYA,BAL12,9,17,26
BAL200509280,2005,50928,BAL,NYA,BAL12,2,1,3
BAL200509290,2005,50929,BAL,NYA,BAL12,8,4,12
BAL200604030,2006,60403,BAL,TBA,BAL12,6,9,15
BAL200604050,2006,60405,BAL,TBA,BAL12,6,16,22
BAL200604060,2006,60406,BAL,TBA,BAL12,2,0,2
BAL200604070,2006,60407,BAL,BOS,BAL12,14,8,22
BAL200604080,2006,60408,BAL,BOS,BAL12,2,1,3
BAL200604090,2006,60409,BAL,BOS,BAL12,4,1,5
BAL200604140,2006,60414,BAL,ANA,BAL12,5,6,11
BAL200604150,2006,60415,BAL,ANA,BAL12,2,3,5
BAL200604160,2006,60416,BAL,ANA,BAL12,9,3,12
BAL200604170,2006,60417,BAL,ANA,BAL12,2,4,6
BAL200604180,2006,60418,BAL,CLE,BAL12,15,1,16
BAL200604190,2006,60419,BAL,CLE,BAL12,9,18,27
BAL200604200,2006,60420,BAL,CLE,BAL12,4,9,13
BAL200604280,2006,60428,BAL,SEA,BAL12,2,5,7
BAL200604290,2006,60429,BAL,SEA,BAL12,8,6,14
BAL200604300,2006,60430,BAL,SEA,BAL12,4,3,7
BAL200605010,2006,60501,BAL,TOR,BAL12,9,7,16
BAL200605020,2006,60502,BAL,TOR,BAL12,2,9,11
BAL200605090,2006,60509,BAL,DET,BAL12,6,7,13
BAL200605100,2006,60510,BAL,DET,BAL12,6,3,9
BAL200605120,2006,60512,BAL,KCA,BAL12,5,6,11
BAL200605130,2006,60513,BAL,KCA,BAL12,1,11,12
BAL200605140,2006,60514,BAL,KCA,BAL12,7,8,15
BAL200605150,2006,60515,BAL,BOS,BAL12,11,1,12
BAL200605160,2006,60516,BAL,BOS,BAL12,6,5,11
BAL200605170,2006,60517,BAL,BOS,BAL12,3,4,7
BAL200605300,2006,60530,BAL,TBA,BAL12,5,7,12
BAL200605310,2006,60531,BAL,TBA,BAL12,5,6,11
BAL200606010,2006,60601,BAL,TBA,BAL12,8,6,14
BAL200606020,2006,60602,BAL,NYA,BAL12,6,5,11
BAL200606030,2006,60603,BAL,NYA,BAL12,6,5,11
BAL200606040,2006,60604,BAL,NYA,BAL12,4,11,15
BAL200606050,2006,60605,BAL,TOR,BAL12,0,4,4
BAL200606060,2006,60606,BAL,TOR,BAL12,6,4,10
BAL200606070,2006,60607,BAL,TOR,BAL12,5,3,8
BAL200606080,2006,60608,BAL,TOR,BAL12,5,7,12
BAL200606200,2006,60620,BAL,FLO,BAL12,6,2,8
BAL200606210,2006,60621,BAL,FLO,BAL12,0,4,4
BAL200606220,2006,60622,BAL,FLO,BAL12,8,5,13
BAL200606230,2006,60623,BAL,WAS,BAL12,1,2,3
BAL200606240,2006,60624,BAL,WAS,BAL12,2,3,5
BAL200606250,2006,60625,BAL,WAS,BAL12,9,5,14
BAL200606281,2006,60628,BAL,PHI,BAL12,4,7,11
BAL200606282,2006,60628,BAL,PHI,BAL12,5,12,17
BAL200606290,2006,60629,BAL,PHI,BAL12,4,0,4
BAL200607130,2006,60713,BAL,TEX,BAL12,15,1,16
BAL200607140,2006,60714,BAL,TEX,BAL12,2,1,3
BAL200607150,2006,60715,BAL,TEX,BAL12,1,8,9
BAL200607160,2006,60716,BAL,TEX,BAL12,0,4,4
BAL200607170,2006,60717,BAL,OAK,BAL12,3,5,8
BAL200607180,2006,60718,BAL,OAK,BAL12,5,4,9
BAL200607190,2006,60719,BAL,OAK,BAL12,5,1,6
BAL200607280,2006,60728,BAL,CHA,BAL12,6,4,10
BAL200607290,2006,60729,BAL,CHA,BAL12,13,11,24
BAL200607300,2006,60730,BAL,CHA,BAL12,7,8,15
BAL200607310,2006,60731,BAL,SEA,BAL12,10,5,15
BAL200608010,2006,60801,BAL,SEA,BAL12,0,2,2
BAL200608020,2006,60802,BAL,SEA,BAL12,2,1,3
BAL200608040,2006,60804,BAL,NYA,BAL12,5,4,9
BAL200608050,2006,60805,BAL,NYA,BAL12,0,5,5
BAL200608060,2006,60806,BAL,NYA,BAL12,6,1,7
BAL200608180,2006,60818,BAL,TOR,BAL12,2,7,9
BAL200608190,2006,60819,BAL,TOR,BAL12,0,15,15
BAL200608200,2006,60820,BAL,TOR,BAL12,9,2,11
BAL200608220,2006,60822,BAL,MIN,BAL12,3,6,9
BAL200608230,2006,60823,BAL,MIN,BAL12,4,1,5
BAL200608240,2006,60824,BAL,MIN,BAL12,11,2,13
BAL200608250,2006,60825,BAL,TBA,BAL12,0,4,4
BAL200608260,2006,60826,BAL,TBA,BAL12,2,3,5
BAL200608270,2006,60827,BAL,TBA,BAL12,4,5,9
BAL200609080,2006,60908,BAL,NYA,BAL12,4,9,13
BAL200609090,2006,60909,BAL,NYA,BAL12,3,2,5
BAL200609100,2006,60910,BAL,NYA,BAL12,9,4,13
BAL200609110,2006,60911,BAL,NYA,BAL12,9,6,15
BAL200609120,2006,60912,BAL,BOS,BAL12,6,5,11
BAL200609130,2006,60913,BAL,BOS,BAL12,0,4,4
BAL200609140,2006,60914,BAL,BOS,BAL12,6,5,11
BAL200609210,2006,60921,BAL,DET,BAL12,3,4,7
BAL200609220,2006,60922,BAL,MIN,BAL12,3,7,10
BAL200609230,2006,60923,BAL,MIN,BAL12,8,5,13
BAL200609240,2006,60924,BAL,MIN,BAL12,6,3,9
BAL200704090,2007,70409,BAL,DET,BAL12,2,6,8
BAL200704100,2007,70410,BAL,DET,BAL12,3,1,4
BAL200704110,2007,70411,BAL,DET,BAL12,4,1,5
BAL200704120,2007,70412,BAL,KCA,BAL12,1,2,3
BAL200704130,2007,70413,BAL,KCA,BAL12,1,8,9
BAL200704140,2007,70414,BAL,KCA,BAL12,4,6,10
BAL200704200,2007,70420,BAL,TOR,BAL12,4,5,9
BAL200704210,2007,70421,BAL,TOR,BAL12,2,5,7
BAL200704220,2007,70422,BAL,TOR,BAL12,3,7,10
BAL200704230,2007,70423,BAL,OAK,BAL12,6,5,11
BAL200704240,2007,70424,BAL,OAK,BAL12,4,2,6
BAL200704250,2007,70425,BAL,BOS,BAL12,6,1,7
BAL200704260,2007,70426,BAL,BOS,BAL12,5,2,7
BAL200705040,2007,70504,BAL,CLE,BAL12,2,3,5
BAL200705050,2007,70505,BAL,CLE,BAL12,2,8,10
BAL200705060,2007,70506,BAL,CLE,BAL12,9,6,15
BAL200705070,2007,70507,BAL,CLE,BAL12,10,1,11
BAL200705080,2007,70508,BAL,TBA,BAL12,3,8,11
BAL200705090,2007,70509,BAL,TBA,BAL12,0,1,1
BAL200705100,2007,70510,BAL,TBA,BAL12,6,11,17
BAL200705220,2007,70522,BAL,TOR,BAL12,6,4,10
BAL200705230,2007,70523,BAL,TOR,BAL12,2,5,7
BAL200705240,2007,70524,BAL,TOR,BAL12,5,4,9
BAL200705250,2007,70525,BAL,OAK,BAL12,3,2,5
BAL200705260,2007,70526,BAL,OAK,BAL12,3,8,11
BAL200705270,2007,70527,BAL,OAK,BAL12,4,8,12
BAL200706080,2007,70608,BAL,COL,BAL12,2,4,6
BAL200706090,2007,70609,BAL,COL,BAL12,3,2,5
BAL200706100,2007,70610,BAL,COL,BAL12,6,1,7
BAL200706120,2007,70612,BAL,WAS,BAL12,7,4,11
BAL200706130,2007,70613,BAL,WAS,BAL12,9,6,15
BAL200706140,2007,70614,BAL,WAS,BAL12,3,1,4
BAL200706150,2007,70615,BAL,ARI,BAL12,7,3,10
BAL200706160,2007,70616,BAL,ARI,BAL12,8,4,12
BAL200706170,2007,70617,BAL,ARI,BAL12,6,4,10
BAL200706260,2007,70626,BAL,NYA,BAL12,2,3,5
BAL200706270,2007,70627,BAL,NYA,BAL12,0,4,4
BAL200706280,2007,70628,BAL,NYA,BAL12,8,7,15
BAL200706290,2007,70629,BAL,ANA,BAL12,9,7,16
BAL200706300,2007,70630,BAL,ANA,BAL12,3,6,9
BAL200707010,2007,70701,BAL,ANA,BAL12,4,3,7
BAL200707120,2007,70712,BAL,CHA,BAL12,9,7,16
BAL200707130,2007,70713,BAL,CHA,BAL12,0,2,2
BAL200707140,2007,70714,BAL,CHA,BAL12,6,7,13
BAL200707150,2007,70715,BAL,CHA,BAL12,3,5,8
BAL200707240,2007,70724,BAL,TBA,BAL12,0,3,3
BAL200707250,2007,70725,BAL,TBA,BAL12,1,6,7
BAL200707260,2007,70726,BAL,TBA,BAL12,7,10,17
BAL200707270,2007,70727,BAL,NYA,BAL12,2,4,6
BAL200707280,2007,70728,BAL,NYA,BAL12,5,7,12
BAL200707290,2007,70729,BAL,NYA,BAL12,10,6,16
BAL200708070,2007,70807,BAL,SEA,BAL12,10,3,13
BAL200708080,2007,70808,BAL,SEA,BAL12,8,4,12
BAL200708090,2007,70809,BAL,SEA,BAL12,13,8,21
BAL200708100,2007,70810,BAL,BOS,BAL12,5,6,11
BAL200708110,2007,70811,BAL,BOS,BAL12,6,2,8
BAL200708120,2007,70812,BAL,BOS,BAL12,3,6,9
BAL200708210,2007,70821,BAL,TEX,BAL12,2,6,8
BAL200708221,2007,70822,BAL,TEX,BAL12,30,3,33
BAL200708222,2007,70822,BAL,TEX,BAL12,9,7,16
BAL200708230,2007,70823,BAL,MIN,BAL12,5,2,7
BAL200708240,2007,70824,BAL,MIN,BAL12,7,4,11
BAL200708250,2007,70825,BAL,MIN,BAL12,8,1,9
BAL200708260,2007,70826,BAL,MIN,BAL12,11,3,14
BAL200708280,2007,70828,BAL,TBA,BAL12,15,8,23
BAL200708290,2007,70829,BAL,TBA,BAL12,5,4,9
BAL200708300,2007,70830,BAL,TBA,BAL12,8,6,14
BAL200709060,2007,70906,BAL,BOS,BAL12,7,6,13
BAL200709070,2007,70907,BAL,BOS,BAL12,4,0,4
BAL200709080,2007,70908,BAL,BOS,BAL12,5,11,16
BAL200709090,2007,70909,BAL,BOS,BAL12,3,2,5
BAL200709110,2007,70911,BAL,ANA,BAL12,10,5,15
BAL200709120,2007,70912,BAL,ANA,BAL12,18,6,24
BAL200709130,2007,70913,BAL,ANA,BAL12,0,3,3
BAL200709240,2007,70924,BAL,KCA,BAL12,2,3,5
BAL200709250,2007,70925,BAL,TOR,BAL12,11,4,15
BAL200709260,2007,70926,BAL,TOR,BAL12,8,5,13
BAL200709270,2007,70927,BAL,TOR,BAL12,5,8,13
BAL200709280,2007,70928,BAL,NYA,BAL12,9,10,19
BAL200709290,2007,70929,BAL,NYA,BAL12,11,10,21
BAL200709300,2007,70930,BAL,NYA,BAL12,10,4,14
BAL200803310,2008,80331,BAL,TBA,BAL12,6,2,8
BAL200804020,2008,80402,BAL,TBA,BAL12,6,9,15
BAL200804040,2008,80404,BAL,SEA,BAL12,4,7,11
BAL200804050,2008,80405,BAL,SEA,BAL12,4,6,10
BAL200804060,2008,80406,BAL,SEA,BAL12,2,3,5
BAL200804070,2008,80407,BAL,SEA,BAL12,4,5,9
BAL200804140,2008,80414,BAL,TOR,BAL12,3,4,7
BAL200804150,2008,80415,BAL,TOR,BAL12,11,3,14
BAL200804160,2008,80416,BAL,CHA,BAL12,3,1,4
BAL200804170,2008,80417,BAL,CHA,BAL12,5,6,11
BAL200804180,2008,80418,BAL,NYA,BAL12,2,8,10
BAL200804190,2008,80419,BAL,NYA,BAL12,0,6,6
BAL200804200,2008,80420,BAL,NYA,BAL12,7,1,8
BAL200804290,2008,80429,BAL,TBA,BAL12,4,7,11
BAL200804300,2008,80430,BAL,TBA,BAL12,8,1,9
BAL200805010,2008,80501,BAL,TBA,BAL12,4,2,6
BAL200805130,2008,80513,BAL,BOS,BAL12,4,5,9
BAL200805140,2008,80514,BAL,BOS,BAL12,3,6,9
BAL200805160,2008,80516,BAL,WAS,BAL12,3,5,8
BAL200805170,2008,80517,BAL,WAS,BAL12,5,6,11
BAL200805180,2008,80518,BAL,WAS,BAL12,2,1,3
BAL200805260,2008,80526,BAL,NYA,BAL12,1,6,7
BAL200805270,2008,80527,BAL,NYA,BAL12,9,10,19
BAL200805280,2008,80528,BAL,NYA,BAL12,4,2,6
BAL200805300,2008,80530,BAL,BOS,BAL12,5,2,7
BAL200805310,2008,80531,BAL,BOS,BAL12,6,3,9
BAL200806010,2008,80601,BAL,BOS,BAL12,9,4,13
BAL200806020,2008,80602,BAL,BOS,BAL12,3,6,9
BAL200806130,2008,80613,BAL,PIT,BAL12,6,9,15
BAL200806140,2008,80614,BAL,PIT,BAL12,7,8,15
BAL200806150,2008,80615,BAL,PIT,BAL12,5,4,9
BAL200806170,2008,80617,BAL,HOU,BAL12,5,6,11
BAL200806180,2008,80618,BAL,HOU,BAL12,1,2,3
BAL200806190,2008,80619,BAL,HOU,BAL12,5,7,12
BAL200806300,2008,80630,BAL,KCA,BAL12,6,5,11
BAL200807010,2008,80701,BAL,KCA,BAL12,5,7,12
BAL200807020,2008,80702,BAL,KCA,BAL12,2,5,7
BAL200807030,2008,80703,BAL,KCA,BAL12,10,7,17
BAL200807040,2008,80704,BAL,TEX,BAL12,4,10,14
BAL200807050,2008,80705,BAL,TEX,BAL12,5,3,8
BAL200807060,2008,80706,BAL,TEX,BAL12,11,10,21
BAL200807170,2008,80717,BAL,DET,BAL12,6,5,11
BAL200807180,2008,80718,BAL,DET,BAL12,4,7,11
BAL200807190,2008,80719,BAL,DET,BAL12,10,11,21
BAL200807200,2008,80720,BAL,DET,BAL12,5,1,6
BAL200807210,2008,80721,BAL,TOR,BAL12,3,8,11
BAL200807220,2008,80722,BAL,TOR,BAL12,10,8,18
BAL200807230,2008,80723,BAL,TOR,BAL12,5,1,6
BAL200807240,2008,80724,BAL,TOR,BAL12,7,1,8
BAL200807250,2008,80725,BAL,ANA,BAL12,6,5,11
BAL200807260,2008,80726,BAL,ANA,BAL12,11,6,17
BAL200807270,2008,80727,BAL,ANA,BAL12,2,5,7
BAL200808080,2008,80808,BAL,TEX,BAL12,1,9,10
BAL200808090,2008,80809,BAL,TEX,BAL12,0,9,9
BAL200808100,2008,80810,BAL,TEX,BAL12,15,7,22
BAL200808180,2008,80818,BAL,BOS,BAL12,6,3,9
BAL200808190,2008,80819,BAL,BOS,BAL12,7,2,9
BAL200808200,2008,80820,BAL,BOS,BAL12,6,11,17
BAL200808220,2008,80822,BAL,NYA,BAL12,9,4,13
BAL200808230,2008,80823,BAL,NYA,BAL12,5,3,8
BAL200808240,2008,80824,BAL,NYA,BAL12,8,7,15
BAL200808250,2008,80825,BAL,CHA,BAL12,4,3,7
BAL200808260,2008,80826,BAL,CHA,BAL12,8,3,11
BAL200808270,2008,80827,BAL,CHA,BAL12,3,11,14
BAL200809050,2008,80905,BAL,OAK,BAL12,11,2,13
BAL200809060,2008,80906,BAL,OAK,BAL12,5,1,6
BAL200809080,2008,80908,BAL,CLE,BAL12,3,14,17
BAL200809090,2008,80909,BAL,CLE,BAL12,6,1,7
BAL200809100,2008,80910,BAL,CLE,BAL12,7,1,8
BAL200809110,2008,80911,BAL,CLE,BAL12,3,6,9
BAL200809131,2008,80913,BAL,MIN,BAL12,12,2,14
BAL200809132,2008,80913,BAL,MIN,BAL12,12,6,18
BAL200809140,2008,80914,BAL,MIN,BAL12,3,7,10
BAL200809220,2008,80922,BAL,TBA,BAL12,4,2,6
BAL200809231,2008,80923,BAL,TBA,BAL12,5,2,7
BAL200809232,2008,80923,BAL,TBA,BAL12,7,5,12
BAL200809240,2008,80924,BAL,TBA,BAL12,11,6,17
BAL200809260,2008,80926,BAL,TOR,BAL12,3,0,3
BAL200809270,2008,80927,BAL,TOR,BAL12,1,2,3
BAL200809280,2008,80928,BAL,TOR,BAL12,10,1,11
BAL200904060,2009,90406,BAL,NYA,BAL12,5,10,15
BAL200904080,2009,90408,BAL,NYA,BAL12,5,7,12
BAL200904090,2009,90409,BAL,NYA,BAL12,11,2,13
BAL200904100,2009,90410,BAL,TBA,BAL12,4,5,9
BAL200904110,2009,90411,BAL,TBA,BAL12,0,6,6
BAL200904120,2009,90412,BAL,TBA,BAL12,11,3,14
BAL200904210,2009,90421,BAL,CHA,BAL12,3,10,13
BAL200904220,2009,90422,BAL,CHA,BAL12,8,2,10
BAL200904230,2009,90423,BAL,CHA,BAL12,2,6,8
BAL200904240,2009,90424,BAL,TEX,BAL12,5,4,9
BAL200904250,2009,90425,BAL,TEX,BAL12,6,5,11
BAL200904260,2009,90426,BAL,TEX,BAL12,5,8,13
BAL200904270,2009,90427,BAL,TEX,BAL12,6,4,10
BAL200904280,2009,90428,BAL,ANA,BAL12,7,5,12
BAL200904290,2009,90429,BAL,ANA,BAL12,3,2,5
BAL200905060,2009,90506,BAL,MIN,BAL12,1,4,5
BAL200905070,2009,90507,BAL,MIN,BAL12,4,5,9
BAL200905080,2009,90508,BAL,NYA,BAL12,4,0,4
BAL200905090,2009,90509,BAL,NYA,BAL12,5,12,17
BAL200905100,2009,90510,BAL,NYA,BAL12,5,3,8
BAL200905120,2009,90512,BAL,TBA,BAL12,5,7,12
BAL200905130,2009,90513,BAL,TBA,BAL12,8,6,14
BAL200905250,2009,90525,BAL,TOR,BAL12,1,4,5
BAL200905260,2009,90526,BAL,TOR,BAL12,2,7,9
BAL200905270,2009,90527,BAL,TOR,BAL12,10,12,22
BAL200905280,2009,90528,BAL,DET,BAL12,1,5,6
BAL200905290,2009,90529,BAL,DET,BAL12,2,7,9
BAL200905300,2009,90530,BAL,DET,BAL12,6,3,9
BAL200905310,2009,90531,BAL,DET,BAL12,3,0,3
BAL200906090,2009,90609,BAL,SEA,BAL12,1,3,4
BAL200906100,2009,90610,BAL,SEA,BAL12,4,1,5
BAL200906110,2009,90611,BAL,SEA,BAL12,6,3,9
BAL200906120,2009,90612,BAL,ATL,BAL12,7,2,9
BAL200906130,2009,90613,BAL,ATL,BAL12,4,8,12
BAL200906140,2009,90614,BAL,ATL,BAL12,2,11,13
BAL200906160,2009,90616,BAL,NYN,BAL12,6,4,10
BAL200906170,2009,90617,BAL,NYN,BAL12,4,6,10
BAL200906180,2009,90618,BAL,NYN,BAL12,4,5,9
BAL200906260,2009,90626,BAL,WAS,BAL12,1,11,12
BAL200906270,2009,90627,BAL,WAS,BAL12,3,6,9
BAL200906280,2009,90628,BAL,WAS,BAL12,5,3,8
BAL200906290,2009,90629,BAL,BOS,BAL12,4,0,4
BAL200906300,2009,90630,BAL,BOS,BAL12,10,11,21
BAL200907010,2009,90701,BAL,BOS,BAL12,6,5,11
BAL200907100,2009,90710,BAL,TOR,BAL12,2,0,2
BAL200907110,2009,90711,BAL,TOR,BAL12,3,4,7
BAL200907120,2009,90712,BAL,TOR,BAL12,2,4,6
BAL200907270,2009,90727,BAL,KCA,BAL12,5,3,8
BAL200907280,2009,90728,BAL,KCA,BAL12,4,3,7
BAL200907290,2009,90729,BAL,KCA,BAL12,3,7,10
BAL200907300,2009,90730,BAL,KCA,BAL12,3,7,10
BAL200907310,2009,90731,BAL,BOS,BAL12,6,5,11
BAL200908010,2009,90801,BAL,BOS,BAL12,4,0,4
BAL200908020,2009,90802,BAL,BOS,BAL12,18,10,28
BAL200908100,2009,90810,BAL,OAK,BAL12,9,1,10
BAL200908110,2009,90811,BAL,OAK,BAL12,2,3,5
BAL200908120,2009,90812,BAL,OAK,BAL12,6,3,9
BAL200908140,2009,90814,BAL,ANA,BAL12,6,16,22
BAL200908150,2009,90815,BAL,ANA,BAL12,5,1,6
BAL200908160,2009,90816,BAL,ANA,BAL12,17,8,25
BAL200908170,2009,90817,BAL,ANA,BAL12,8,5,13
BAL200908270,2009,90827,BAL,CLE,BAL12,5,4,9
BAL200908280,2009,90828,BAL,CLE,BAL12,4,13,17
BAL200908290,2009,90829,BAL,CLE,BAL12,5,3,8
BAL200908300,2009,90830,BAL,CLE,BAL12,2,5,7
BAL200908310,2009,90831,BAL,NYA,BAL12,5,1,6
BAL200909010,2009,90901,BAL,NYA,BAL12,9,6,15
BAL200909020,2009,90902,BAL,NYA,BAL12,10,2,12
BAL200909040,2009,90904,BAL,TEX,BAL12,5,1,6
BAL200909050,2009,90905,BAL,TEX,BAL12,4,5,9
BAL200909060,2009,90906,BAL,TEX,BAL12,0,7,7
BAL200909140,2009,90914,BAL,TBA,BAL12,8,4,12
BAL200909150,2009,90915,BAL,TBA,BAL12,5,10,15
BAL200909160,2009,90916,BAL,TBA,BAL12,2,4,6
BAL200909170,2009,90917,BAL,TBA,BAL12,3,0,3
BAL200909180,2009,90918,BAL,BOS,BAL12,3,1,4
BAL200909190,2009,90919,BAL,BOS,BAL12,11,5,16
BAL200909200,2009,90920,BAL,BOS,BAL12,9,3,12
BAL200910020,2009,91002,BAL,TOR,BAL12,7,13,20
BAL200910030,2009,91003,BAL,TOR,BAL12,3,6,9
BAL200910040,2009,91004,BAL,TOR,BAL12,4,5,9
BOS200004110,2000,411,BOS,MIN,BOS07,4,13,17
BOS200004120,2000,412,BOS,MIN,BOS07,3,7,10
BOS200004130,2000,413,BOS,MIN,BOS07,3,4,7
BOS200004140,2000,414,BOS,OAK,BOS07,13,6,19
BOS200004150,2000,415,BOS,OAK,BOS07,2,14,16
BOS200004160,2000,416,BOS,OAK,BOS07,4,5,9
BOS200004170,2000,417,BOS,OAK,BOS07,1,0,1
BOS200005010,2000,501,BOS,DET,BOS07,6,10,16
BOS200005020,2000,502,BOS,DET,BOS07,7,6,13
BOS200005030,2000,503,BOS,DET,BOS07,2,4,6
BOS200005050,2000,505,BOS,TBA,BOS07,3,5,8
BOS200005060,2000,506,BOS,TBA,BOS07,1,0,1
BOS200005070,2000,507,BOS,TBA,BOS07,7,9,16
BOS200005080,2000,508,BOS,CHA,BOS07,2,3,5
BOS200005090,2000,509,BOS,CHA,BOS07,6,0,6
BOS200005100,2000,510,BOS,CHA,BOS07,3,5,8
BOS200005190,2000,519,BOS,DET,BOS07,0,3,3
BOS200005200,2000,520,BOS,DET,BOS07,2,1,3
BOS200005210,2000,521,BOS,DET,BOS07,7,5,12
BOS200005230,2000,523,BOS,TOR,BOS07,3,2,5
BOS200005240,2000,524,BOS,TOR,BOS07,3,6,9
BOS200005250,2000,525,BOS,TOR,BOS07,11,6,17
BOS200005300,2000,530,BOS,KCA,BOS07,2,8,10
BOS200005310,2000,531,BOS,KCA,BOS07,9,7,16
BOS200006010,2000,601,BOS,KCA,BOS07,13,11,24
BOS200006080,2000,608,BOS,CLE,BOS07,0,3,3
BOS200006160,2000,616,BOS,TOR,BOS07,4,7,11
BOS200006170,2000,617,BOS,TOR,BOS07,11,10,21
BOS200006180,2000,618,BOS,TOR,BOS07,5,1,6
BOS200006190,2000,619,BOS,NYA,BOS07,22,1,23
BOS200006200,2000,620,BOS,NYA,BOS07,3,0,3
BOS200006210,2000,621,BOS,NYA,BOS07,7,9,16
BOS200006220,2000,622,BOS,NYA,BOS07,2,4,6
BOS200006270,2000,627,BOS,BAL,BOS07,6,3,9
BOS200006280,2000,628,BOS,BAL,BOS07,8,7,15
BOS200006290,2000,629,BOS,BAL,BOS07,4,12,16
BOS200007070,2000,707,BOS,ATL,BOS07,5,3,8
BOS200007080,2000,708,BOS,ATL,BOS07,5,1,6
BOS200007090,2000,709,BOS,ATL,BOS07,2,7,9
BOS200007130,2000,713,BOS,NYN,BOS07,3,4,7
BOS200007140,2000,714,BOS,NYN,BOS07,6,4,10
BOS200007150,2000,715,BOS,NYN,BOS07,4,6,10
BOS200007160,2000,716,BOS,MON,BOS07,2,5,7
BOS200007170,2000,717,BOS,MON,BOS07,3,7,10
BOS200007180,2000,718,BOS,MON,BOS07,1,3,4
BOS200007210,2000,721,BOS,CHA,BOS07,8,5,13
BOS200007220,2000,722,BOS,CHA,BOS07,6,8,14
BOS200007230,2000,723,BOS,CHA,BOS07,0,1,1
BOS200007240,2000,724,BOS,MIN,BOS07,4,2,6
BOS200007250,2000,725,BOS,MIN,BOS07,4,2,6
BOS200008040,2000,804,BOS,KCA,BOS07,4,5,9
BOS200008050,2000,805,BOS,KCA,BOS07,7,5,12
BOS200008060,2000,806,BOS,KCA,BOS07,3,1,4
BOS200008140,2000,814,BOS,TBA,BOS07,3,7,10
BOS200008150,2000,815,BOS,TBA,BOS07,3,1,4
BOS200008160,2000,816,BOS,TBA,BOS07,3,4,7
BOS200008170,2000,817,BOS,TEX,BOS07,7,8,15
BOS200008180,2000,818,BOS,TEX,BOS07,4,6,10
BOS200008190,2000,819,BOS,TEX,BOS07,0,9,9
BOS200008200,2000,820,BOS,TEX,BOS07,6,2,8
BOS200008210,2000,821,BOS,ANA,BOS07,6,7,13
BOS200008220,2000,822,BOS,ANA,BOS07,11,4,15
BOS200008230,2000,823,BOS,ANA,BOS07,1,3,4
BOS200009010,2000,901,BOS,SEA,BOS07,2,6,8
BOS200009020,2000,902,BOS,SEA,BOS07,4,1,5
BOS200009030,2000,903,BOS,SEA,BOS07,5,0,5
BOS200009040,2000,904,BOS,SEA,BOS07,1,5,6
BOS200009050,2000,905,BOS,OAK,BOS07,3,10,13
BOS200009060,2000,906,BOS,OAK,BOS07,6,4,10
BOS200009070,2000,907,BOS,MIN,BOS07,6,11,17
BOS200009080,2000,908,BOS,NYA,BOS07,4,0,4
BOS200009090,2000,909,BOS,NYA,BOS07,5,3,8
BOS200009100,2000,910,BOS,NYA,BOS07,6,2,8
BOS200009190,2000,919,BOS,CLE,BOS07,4,7,11
BOS200009201,2000,920,BOS,CLE,BOS07,2,1,3
BOS200009202,2000,920,BOS,CLE,BOS07,5,4,9
BOS200009211,2000,921,BOS,CLE,BOS07,8,9,17
BOS200009212,2000,921,BOS,CLE,BOS07,8,5,13
BOS200009220,2000,922,BOS,BAL,BOS07,3,1,4
BOS200009230,2000,923,BOS,BAL,BOS07,7,8,15
BOS200009240,2000,924,BOS,BAL,BOS07,1,0,1
BOS200104060,2001,10406,BOS,TBA,BOS07,4,11,15
BOS200104070,2001,10407,BOS,TBA,BOS07,2,6,8
BOS200104080,2001,10408,BOS,TBA,BOS07,0,3,3
BOS200104100,2001,10410,BOS,BAL,BOS07,1,10,11
BOS200104110,2001,10411,BOS,BAL,BOS07,5,4,9
BOS200104120,2001,10412,BOS,BAL,BOS07,2,8,10
BOS200104130,2001,10413,BOS,NYA,BOS07,2,3,5
BOS200104140,2001,10414,BOS,NYA,BOS07,3,2,5
BOS200104150,2001,10415,BOS,NYA,BOS07,4,5,9
BOS200104160,2001,10416,BOS,NYA,BOS07,1,4,5
BOS200104240,2001,10424,BOS,MIN,BOS07,4,9,13
BOS200104250,2001,10425,BOS,MIN,BOS07,6,4,10
BOS200104260,2001,10426,BOS,MIN,BOS07,0,2,2
BOS200104270,2001,10427,BOS,KCA,BOS07,2,9,11
BOS200104280,2001,10428,BOS,KCA,BOS07,8,2,10
BOS200104290,2001,10429,BOS,KCA,BOS07,11,8,19
BOS200105080,2001,10508,BOS,SEA,BOS07,4,12,16
BOS200105090,2001,10509,BOS,SEA,BOS07,10,5,15
BOS200105100,2001,10510,BOS,SEA,BOS07,5,2,7
BOS200105110,2001,10511,BOS,OAK,BOS07,7,6,13
BOS200105120,2001,10512,BOS,OAK,BOS07,3,9,12
BOS200105130,2001,10513,BOS,OAK,BOS07,4,5,9
BOS200105250,2001,10525,BOS,TOR,BOS07,0,4,4
BOS200105260,2001,10526,BOS,TOR,BOS07,5,0,5
BOS200105270,2001,10527,BOS,TOR,BOS07,2,4,6
BOS200105280,2001,10528,BOS,NYA,BOS07,4,3,7
BOS200105300,2001,10530,BOS,NYA,BOS07,0,3,3
BOS200106050,2001,10605,BOS,DET,BOS07,3,4,7
BOS200106060,2001,10606,BOS,DET,BOS07,7,3,10
BOS200106070,2001,10607,BOS,DET,BOS07,1,8,9
BOS200106080,2001,10608,BOS,PHI,BOS07,2,3,5
BOS200106090,2001,10609,BOS,PHI,BOS07,5,2,7
BOS200106100,2001,10610,BOS,PHI,BOS07,4,5,9
BOS200106120,2001,10612,BOS,FLO,BOS07,2,4,6
BOS200106130,2001,10613,BOS,FLO,BOS07,4,2,6
BOS200106140,2001,10614,BOS,FLO,BOS07,4,6,10
BOS200106220,2001,10622,BOS,TOR,BOS07,4,3,7
BOS200106230,2001,10623,BOS,TOR,BOS07,9,6,15
BOS200106240,2001,10624,BOS,TOR,BOS07,5,2,7
BOS200106250,2001,10625,BOS,TBA,BOS07,8,12,20
BOS200106260,2001,10626,BOS,TBA,BOS07,6,7,13
BOS200106270,2001,10627,BOS,TBA,BOS07,9,7,16
BOS200106280,2001,10628,BOS,TBA,BOS07,4,3,7
BOS200107060,2001,10706,BOS,ATL,BOS07,6,5,11
BOS200107070,2001,10707,BOS,ATL,BOS07,1,3,4
BOS200107080,2001,10708,BOS,ATL,BOS07,8,0,8
BOS200107240,2001,10724,BOS,TOR,BOS07,4,6,10
BOS200107250,2001,10725,BOS,TOR,BOS07,4,3,7
BOS200107260,2001,10726,BOS,TOR,BOS07,3,6,9
BOS200107270,2001,10727,BOS,CHA,BOS07,5,9,14
BOS200107280,2001,10728,BOS,CHA,BOS07,3,1,4
BOS200107290,2001,10729,BOS,CHA,BOS07,3,4,7
BOS200107310,2001,10731,BOS,ANA,BOS07,4,3,7
BOS200108010,2001,10801,BOS,ANA,BOS07,4,2,6
BOS200108020,2001,10802,BOS,ANA,BOS07,13,4,17
BOS200108041,2001,10804,BOS,TEX,BOS07,4,10,14
BOS200108042,2001,10804,BOS,TEX,BOS07,2,6,8
BOS200108050,2001,10805,BOS,TEX,BOS07,3,6,9
BOS200108060,2001,10806,BOS,TEX,BOS07,7,10,17
BOS200108140,2001,10814,BOS,SEA,BOS07,6,3,9
BOS200108150,2001,10815,BOS,SEA,BOS07,6,2,8
BOS200108160,2001,10816,BOS,SEA,BOS07,4,6,10
BOS200108170,2001,10817,BOS,BAL,BOS07,11,5,16
BOS200108180,2001,10818,BOS,BAL,BOS07,1,5,6
BOS200108190,2001,10819,BOS,BAL,BOS07,13,7,20
BOS200108310,2001,10831,BOS,NYA,BOS07,3,1,4
BOS200109010,2001,10901,BOS,NYA,BOS07,2,1,3
BOS200109020,2001,10902,BOS,NYA,BOS07,1,0,1
BOS200109040,2001,10904,BOS,CLE,BOS07,8,5,13
BOS200109050,2001,10905,BOS,CLE,BOS07,7,10,17
BOS200109060,2001,10906,BOS,CLE,BOS07,6,4,10
BOS200109180,2001,10918,BOS,TBA,BOS07,2,7,9
BOS200109190,2001,10919,BOS,TBA,BOS07,12,2,14
BOS200109200,2001,10920,BOS,TBA,BOS07,1,2,3
BOS200109210,2001,10921,BOS,DET,BOS07,2,5,7
BOS200109220,2001,10922,BOS,DET,BOS07,4,3,7
BOS200109230,2001,10923,BOS,DET,BOS07,12,6,18
BOS200109240,2001,10924,BOS,BAL,BOS07,5,1,6
BOS200109250,2001,10925,BOS,BAL,BOS07,12,7,19
BOS200109260,2001,10926,BOS,BAL,BOS07,6,9,15
BOS200109270,2001,10927,BOS,BAL,BOS07,4,2,6
BOS200204010,2002,20401,BOS,TOR,BOS07,12,11,23
BOS200204090,2002,20409,BOS,KCA,BOS07,4,8,12
BOS200204100,2002,20410,BOS,KCA,BOS07,6,2,8
BOS200204110,2002,20411,BOS,KCA,BOS07,8,5,13
BOS200204120,2002,20412,BOS,NYA,BOS07,2,3,5
BOS200204130,2002,20413,BOS,NYA,BOS07,6,7,13
BOS200204140,2002,20414,BOS,NYA,BOS07,6,2,8
BOS200204150,2002,20415,BOS,NYA,BOS07,3,4,7
BOS200204260,2002,20426,BOS,TBA,BOS07,2,4,6
BOS200204270,2002,20427,BOS,TBA,BOS07,0,10,10
BOS200204290,2002,20429,BOS,BAL,BOS07,5,3,8
BOS200204300,2002,20430,BOS,BAL,BOS07,0,4,4
BOS200205010,2002,20501,BOS,BAL,BOS07,3,15,18
BOS200205140,2002,20514,BOS,OAK,BOS07,2,6,8
BOS200205150,2002,20515,BOS,OAK,BOS07,2,8,10
BOS200205160,2002,20516,BOS,OAK,BOS07,5,0,5
BOS200205170,2002,20517,BOS,SEA,BOS07,6,3,9
BOS200205180,2002,20518,BOS,SEA,BOS07,1,4,5
BOS200205190,2002,20519,BOS,SEA,BOS07,2,3,5
BOS200205200,2002,20520,BOS,CHA,BOS07,0,9,9
BOS200205210,2002,20521,BOS,CHA,BOS07,8,3,11
BOS200205220,2002,20522,BOS,CHA,BOS07,2,0,2
BOS200205230,2002,20523,BOS,NYA,BOS07,1,3,4
BOS200205240,2002,20524,BOS,NYA,BOS07,8,9,17
BOS200205250,2002,20525,BOS,NYA,BOS07,3,2,5
BOS200205260,2002,20526,BOS,NYA,BOS07,14,5,19
BOS200206070,2002,20607,BOS,ARI,BOS07,7,5,12
BOS200206080,2002,20608,BOS,ARI,BOS07,3,2,5
BOS200206090,2002,20609,BOS,ARI,BOS07,7,3,10
BOS200206100,2002,20610,BOS,COL,BOS07,3,7,10
BOS200206110,2002,20611,BOS,COL,BOS07,3,1,4
BOS200206120,2002,20612,BOS,COL,BOS07,5,7,12
BOS200206250,2002,20625,BOS,CLE,BOS07,4,2,6
BOS200206260,2002,20626,BOS,CLE,BOS07,4,7,11
BOS200206280,2002,20628,BOS,ATL,BOS07,4,2,6
BOS200206290,2002,20629,BOS,ATL,BOS07,2,1,3
BOS200206300,2002,20630,BOS,ATL,BOS07,7,3,10
BOS200207010,2002,20701,BOS,TOR,BOS07,0,4,4
BOS200207021,2002,20702,BOS,TOR,BOS07,1,2,3
BOS200207022,2002,20702,BOS,TOR,BOS07,4,6,10
BOS200207030,2002,20703,BOS,TOR,BOS07,2,5,7
BOS200207040,2002,20704,BOS,TOR,BOS07,5,9,14
BOS200207050,2002,20705,BOS,DET,BOS07,9,5,14
BOS200207060,2002,20706,BOS,DET,BOS07,0,8,8
BOS200207070,2002,20707,BOS,DET,BOS07,9,8,17
BOS200207231,2002,20723,BOS,TBA,BOS07,4,22,26
BOS200207232,2002,20723,BOS,TBA,BOS07,5,4,9
BOS200207240,2002,20724,BOS,TBA,BOS07,9,5,14
BOS200207250,2002,20725,BOS,TBA,BOS07,0,6,6
BOS200207260,2002,20726,BOS,BAL,BOS07,9,2,11
BOS200207270,2002,20727,BOS,BAL,BOS07,0,4,4
BOS200207280,2002,20728,BOS,BAL,BOS07,3,12,15
BOS200208060,2002,20806,BOS,OAK,BOS07,9,1,10
BOS200208070,2002,20807,BOS,OAK,BOS07,3,2,5
BOS200208080,2002,20808,BOS,OAK,BOS07,2,4,6
BOS200208090,2002,20809,BOS,MIN,BOS07,5,4,9
BOS200208100,2002,20810,BOS,MIN,BOS07,0,2,2
BOS200208110,2002,20811,BOS,MIN,BOS07,1,3,4
BOS200208200,2002,20820,BOS,TEX,BOS07,3,2,5
BOS200208210,2002,20821,BOS,TEX,BOS07,3,5,8
BOS200208220,2002,20822,BOS,TEX,BOS07,3,12,15
BOS200208230,2002,20823,BOS,ANA,BOS07,1,4,5
BOS200208240,2002,20824,BOS,ANA,BOS07,2,0,2
BOS200208250,2002,20825,BOS,ANA,BOS07,8,3,11
BOS200208260,2002,20826,BOS,ANA,BOS07,9,10,19
BOS200208270,2002,20827,BOS,NYA,BOS07,6,0,6
BOS200208280,2002,20828,BOS,NYA,BOS07,7,0,7
BOS200209050,2002,20905,BOS,TOR,BOS07,5,4,9
BOS200209060,2002,20906,BOS,TOR,BOS07,2,7,9
BOS200209070,2002,20907,BOS,TOR,BOS07,1,4,5
BOS200209080,2002,20908,BOS,TOR,BOS07,9,4,13
BOS200209130,2002,20913,BOS,BAL,BOS07,8,3,11
BOS200209140,2002,20914,BOS,BAL,BOS07,4,6,10
BOS200209150,2002,20915,BOS,BAL,BOS07,8,3,11
BOS200209161,2002,20916,BOS,CLE,BOS07,1,6,7
BOS200209162,2002,20916,BOS,CLE,BOS07,7,1,8
BOS200209170,2002,20917,BOS,CLE,BOS07,2,4,6
BOS200209180,2002,20918,BOS,CLE,BOS07,6,4,10
BOS200209270,2002,20927,BOS,TBA,BOS07,1,6,7
BOS200209280,2002,20928,BOS,TBA,BOS07,9,6,15
BOS200209290,2002,20929,BOS,TBA,BOS07,8,11,19
BOS200304120,2003,30412,BOS,BAL,BOS07,13,6,19
BOS200304130,2003,30413,BOS,BAL,BOS07,0,2,2
BOS200304150,2003,30415,BOS,TBA,BOS07,5,6,11
BOS200304160,2003,30416,BOS,TBA,BOS07,4,6,10
BOS200304170,2003,30417,BOS,TBA,BOS07,0,6,6
BOS200304180,2003,30418,BOS,TOR,BOS07,3,7,10
BOS200304190,2003,30419,BOS,TOR,BOS07,2,7,9
BOS200304200,2003,30420,BOS,TOR,BOS07,5,6,11
BOS200304210,2003,30421,BOS,TOR,BOS07,11,6,17
BOS200304290,2003,30429,BOS,KCA,BOS07,2,7,9
BOS200304300,2003,30430,BOS,KCA,BOS07,4,5,9
BOS200305010,2003,30501,BOS,KCA,BOS07,5,6,11
BOS200305020,2003,30502,BOS,MIN,BOS07,11,7,18
BOS200305030,2003,30503,BOS,MIN,BOS07,1,9,10
BOS200305040,2003,30504,BOS,MIN,BOS07,9,4,13
BOS200305130,2003,30513,BOS,TEX,BOS07,4,5,9
BOS200305140,2003,30514,BOS,TEX,BOS07,1,7,8
BOS200305150,2003,30515,BOS,TEX,BOS07,3,12,15
BOS200305160,2003,30516,BOS,ANA,BOS07,6,5,11
BOS200305170,2003,30517,BOS,ANA,BOS07,6,2,8
BOS200305180,2003,30518,BOS,ANA,BOS07,3,5,8
BOS200305190,2003,30519,BOS,NYA,BOS07,7,3,10
BOS200305200,2003,30520,BOS,NYA,BOS07,7,10,17
BOS200305210,2003,30521,BOS,NYA,BOS07,4,2,6
BOS200305230,2003,30523,BOS,CLE,BOS07,2,9,11
BOS200305240,2003,30524,BOS,CLE,BOS07,3,12,15
BOS200305250,2003,30525,BOS,CLE,BOS07,6,4,10
BOS200306100,2003,30610,BOS,SLN,BOS07,9,7,16
BOS200306110,2003,30611,BOS,SLN,BOS07,1,13,14
BOS200306120,2003,30612,BOS,SLN,BOS07,8,7,15
BOS200306130,2003,30613,BOS,HOU,BOS07,3,4,7
BOS200306140,2003,30614,BOS,HOU,BOS07,4,8,12
BOS200306150,2003,30615,BOS,HOU,BOS07,2,3,5
BOS200306230,2003,30623,BOS,DET,BOS07,1,3,4
BOS200306240,2003,30624,BOS,DET,BOS07,1,10,11
BOS200306250,2003,30625,BOS,DET,BOS07,2,11,13
BOS200306260,2003,30626,BOS,DET,BOS07,4,6,10
BOS200306270,2003,30627,BOS,FLO,BOS07,8,25,33
BOS200306280,2003,30628,BOS,FLO,BOS07,10,9,19
BOS200306290,2003,30629,BOS,FLO,BOS07,7,11,18
BOS200307170,2003,30717,BOS,TOR,BOS07,5,2,7
BOS200307180,2003,30718,BOS,TOR,BOS07,4,1,5
BOS200307190,2003,30719,BOS,TOR,BOS07,4,5,9
BOS200307200,2003,30720,BOS,TOR,BOS07,4,9,13
BOS200307210,2003,30721,BOS,DET,BOS07,5,14,19
BOS200307220,2003,30722,BOS,DET,BOS07,4,7,11
BOS200307230,2003,30723,BOS,TBA,BOS07,4,10,14
BOS200307240,2003,30724,BOS,TBA,BOS07,15,9,24
BOS200307250,2003,30725,BOS,NYA,BOS07,4,3,7
BOS200307260,2003,30726,BOS,NYA,BOS07,4,5,9
BOS200307270,2003,30727,BOS,NYA,BOS07,4,6,10
BOS200308050,2003,30805,BOS,ANA,BOS07,9,10,19
BOS200308060,2003,30806,BOS,ANA,BOS07,2,4,6
BOS200308070,2003,30807,BOS,ANA,BOS07,3,9,12
BOS200308081,2003,30808,BOS,BAL,BOS07,10,4,14
BOS200308082,2003,30808,BOS,BAL,BOS07,4,2,6
BOS200308090,2003,30809,BOS,BAL,BOS07,4,6,10
BOS200308100,2003,30810,BOS,BAL,BOS07,5,3,8
BOS200308190,2003,30819,BOS,OAK,BOS07,3,2,5
BOS200308200,2003,30820,BOS,OAK,BOS07,8,6,14
BOS200308210,2003,30821,BOS,OAK,BOS07,5,14,19
BOS200308220,2003,30822,BOS,SEA,BOS07,4,6,10
BOS200308230,2003,30823,BOS,SEA,BOS07,6,7,13
BOS200308240,2003,30824,BOS,SEA,BOS07,1,6,7
BOS200308250,2003,30825,BOS,SEA,BOS07,1,8,9
BOS200308260,2003,30826,BOS,TOR,BOS07,12,9,21
BOS200308270,2003,30827,BOS,TOR,BOS07,3,6,9
BOS200308290,2003,30829,BOS,NYA,BOS07,5,10,15
BOS200308300,2003,30830,BOS,NYA,BOS07,10,7,17
BOS200308310,2003,30831,BOS,NYA,BOS07,8,4,12
BOS200309120,2003,30912,BOS,CHA,BOS07,4,7,11
BOS200309130,2003,30913,BOS,CHA,BOS07,3,1,4
BOS200309140,2003,30914,BOS,CHA,BOS07,7,2,9
BOS200309150,2003,30915,BOS,TBA,BOS07,2,8,10
BOS200309160,2003,30916,BOS,TBA,BOS07,2,3,5
BOS200309170,2003,30917,BOS,TBA,BOS07,7,0,7
BOS200309180,2003,30918,BOS,TBA,BOS07,3,4,7
BOS200309220,2003,30922,BOS,BAL,BOS07,5,7,12
BOS200309230,2003,30923,BOS,BAL,BOS07,5,6,11
BOS200309240,2003,30924,BOS,BAL,BOS07,7,3,10
BOS200309250,2003,30925,BOS,BAL,BOS07,3,14,17
BOS200310040,2003,31004,BOS,OAK,BOS07,1,3,4
BOS200310050,2003,31005,BOS,OAK,BOS07,4,5,9
BOS200310110,2003,31011,BOS,NYA,BOS07,4,3,7
BOS200310130,2003,31013,BOS,NYA,BOS07,2,3,5
BOS200310140,2003,31014,BOS,NYA,BOS07,4,2,6
BOS200404090,2004,40409,BOS,TOR,BOS07,10,5,15
BOS200404100,2004,40410,BOS,TOR,BOS07,1,4,5
BOS200404110,2004,40411,BOS,TOR,BOS07,4,6,10
BOS200404150,2004,40415,BOS,BAL,BOS07,12,7,19
BOS200404160,2004,40416,BOS,NYA,BOS07,2,6,8
BOS200404170,2004,40417,BOS,NYA,BOS07,2,5,7
BOS200404180,2004,40418,BOS,NYA,BOS07,7,3,10
BOS200404190,2004,40419,BOS,NYA,BOS07,4,5,9
BOS200404280,2004,40428,BOS,TBA,BOS07,0,6,6
BOS200404291,2004,40429,BOS,TBA,BOS07,0,4,4
BOS200404292,2004,40429,BOS,TBA,BOS07,3,7,10
BOS200405070,2004,40507,BOS,KCA,BOS07,6,7,13
BOS200405080,2004,40508,BOS,KCA,BOS07,1,9,10
BOS200405090,2004,40509,BOS,KCA,BOS07,8,4,12
BOS200405100,2004,40510,BOS,CLE,BOS07,10,6,16
BOS200405110,2004,40511,BOS,CLE,BOS07,3,5,8
BOS200405120,2004,40512,BOS,CLE,BOS07,6,4,10
BOS200405210,2004,40521,BOS,TOR,BOS07,5,11,16
BOS200405220,2004,40522,BOS,TOR,BOS07,2,5,7
BOS200405230,2004,40523,BOS,TOR,BOS07,2,7,9
BOS200405250,2004,40525,BOS,OAK,BOS07,2,12,14
BOS200405260,2004,40526,BOS,OAK,BOS07,6,9,15
BOS200405270,2004,40527,BOS,OAK,BOS07,15,2,17
BOS200405280,2004,40528,BOS,SEA,BOS07,4,8,12
BOS200405290,2004,40529,BOS,SEA,BOS07,5,4,9
BOS200405300,2004,40530,BOS,SEA,BOS07,7,9,16
BOS200405310,2004,40531,BOS,BAL,BOS07,13,4,17
BOS200406080,2004,40608,BOS,SDN,BOS07,0,1,1
BOS200406090,2004,40609,BOS,SDN,BOS07,8,1,9
BOS200406100,2004,40610,BOS,SDN,BOS07,3,9,12
BOS200406110,2004,40611,BOS,LAN,BOS07,1,2,3
BOS200406120,2004,40612,BOS,LAN,BOS07,14,5,19
BOS200406130,2004,40613,BOS,LAN,BOS07,1,4,5
BOS200406220,2004,40622,BOS,MIN,BOS07,2,9,11
BOS200406230,2004,40623,BOS,MIN,BOS07,4,2,6
BOS200406240,2004,40624,BOS,MIN,BOS07,4,3,7
BOS200406250,2004,40625,BOS,PHI,BOS07,1,12,13
BOS200406260,2004,40626,BOS,PHI,BOS07,9,2,11
BOS200406270,2004,40627,BOS,PHI,BOS07,3,12,15
BOS200407060,2004,40706,BOS,OAK,BOS07,0,11,11
BOS200407070,2004,40707,BOS,OAK,BOS07,3,11,14
BOS200407080,2004,40708,BOS,OAK,BOS07,7,8,15
BOS200407090,2004,40709,BOS,TEX,BOS07,0,7,7
BOS200407100,2004,40710,BOS,TEX,BOS07,6,14,20
BOS200407110,2004,40711,BOS,TEX,BOS07,6,5,11
BOS200407210,2004,40721,BOS,BAL,BOS07,10,5,15
BOS200407221,2004,40722,BOS,BAL,BOS07,8,3,11
BOS200407222,2004,40722,BOS,BAL,BOS07,0,4,4
BOS200407230,2004,40723,BOS,NYA,BOS07,8,7,15
BOS200407240,2004,40724,BOS,NYA,BOS07,10,11,21
BOS200407250,2004,40725,BOS,NYA,BOS07,6,9,15
BOS200408090,2004,40809,BOS,TBA,BOS07,8,3,11
BOS200408100,2004,40810,BOS,TBA,BOS07,4,8,12
BOS200408110,2004,40811,BOS,TBA,BOS07,4,14,18
BOS200408120,2004,40812,BOS,TBA,BOS07,0,6,6
BOS200408130,2004,40813,BOS,CHA,BOS07,8,7,15
BOS200408140,2004,40814,BOS,CHA,BOS07,3,4,7
BOS200408150,2004,40815,BOS,CHA,BOS07,5,4,9
BOS200408160,2004,40816,BOS,TOR,BOS07,4,8,12
BOS200408170,2004,40817,BOS,TOR,BOS07,4,5,9
BOS200408180,2004,40818,BOS,TOR,BOS07,4,6,10
BOS200408260,2004,40826,BOS,DET,BOS07,1,4,5
BOS200408270,2004,40827,BOS,DET,BOS07,3,5,8
BOS200408280,2004,40828,BOS,DET,BOS07,1,5,6
BOS200408290,2004,40829,BOS,DET,BOS07,1,6,7
BOS200408310,2004,40831,BOS,ANA,BOS07,7,10,17
BOS200409010,2004,40901,BOS,ANA,BOS07,7,12,19
BOS200409020,2004,40902,BOS,ANA,BOS07,3,4,7
BOS200409030,2004,40903,BOS,TEX,BOS07,0,2,2
BOS200409040,2004,40904,BOS,TEX,BOS07,8,6,14
BOS200409050,2004,40905,BOS,TEX,BOS07,5,6,11
BOS200409140,2004,40914,BOS,TBA,BOS07,5,2,7
BOS200409150,2004,40915,BOS,TBA,BOS07,6,8,14
BOS200409160,2004,40916,BOS,TBA,BOS07,4,11,15
BOS200409200,2004,40920,BOS,BAL,BOS07,9,6,15
BOS200409210,2004,40921,BOS,BAL,BOS07,2,3,5
BOS200409220,2004,40922,BOS,BAL,BOS07,6,7,13
BOS200409230,2004,40923,BOS,BAL,BOS07,9,7,16
BOS200409240,2004,40924,BOS,NYA,BOS07,6,4,10
BOS200409250,2004,40925,BOS,NYA,BOS07,5,12,17
BOS200409260,2004,40926,BOS,NYA,BOS07,4,11,15
BOS200410080,2004,41008,BOS,ANA,BOS07,6,8,14
BOS200410160,2004,41016,BOS,NYA,BOS07,19,8,27
BOS200410170,2004,41017,BOS,NYA,BOS07,4,6,10
BOS200410180,2004,41018,BOS,NYA,BOS07,4,5,9
BOS200410230,2004,41023,BOS,SLN,BOS07,9,11,20
BOS200410240,2004,41024,BOS,SLN,BOS07,2,6,8
BOS200504110,2005,50411,BOS,NYA,BOS07,1,8,9
BOS200504130,2005,50413,BOS,NYA,BOS07,5,2,7
BOS200504140,2005,50414,BOS,NYA,BOS07,5,8,13
BOS200504150,2005,50415,BOS,TBA,BOS07,0,10,10
BOS200504160,2005,50416,BOS,TBA,BOS07,2,6,8
BOS200504170,2005,50417,BOS,TBA,BOS07,1,3,4
BOS200504180,2005,50418,BOS,TOR,BOS07,7,12,19
BOS200504190,2005,50419,BOS,TOR,BOS07,4,3,7
BOS200504250,2005,50425,BOS,BAL,BOS07,8,4,12
BOS200504260,2005,50426,BOS,BAL,BOS07,11,8,19
BOS200505060,2005,50506,BOS,SEA,BOS07,2,7,9
BOS200505081,2005,50508,BOS,SEA,BOS07,3,6,9
BOS200505082,2005,50508,BOS,SEA,BOS07,6,4,10
BOS200505090,2005,50509,BOS,OAK,BOS07,5,13,18
BOS200505100,2005,50510,BOS,OAK,BOS07,2,3,5
BOS200505110,2005,50511,BOS,OAK,BOS07,5,6,11
BOS200505200,2005,50520,BOS,ATL,BOS07,3,4,7
BOS200505210,2005,50521,BOS,ATL,BOS07,7,5,12
BOS200505220,2005,50522,BOS,ATL,BOS07,2,5,7
BOS200505300,2005,50530,BOS,BAL,BOS07,8,1,9
BOS200505310,2005,50531,BOS,BAL,BOS07,1,5,6
BOS200506010,2005,50601,BOS,BAL,BOS07,9,3,12
BOS200506020,2005,50602,BOS,BAL,BOS07,4,6,10
BOS200506030,2005,50603,BOS,ANA,BOS07,4,7,11
BOS200506040,2005,50604,BOS,ANA,BOS07,13,6,19
BOS200506050,2005,50605,BOS,ANA,BOS07,3,6,9
BOS200506130,2005,50613,BOS,CIN,BOS07,3,10,13
BOS200506140,2005,50614,BOS,CIN,BOS07,0,7,7
BOS200506150,2005,50615,BOS,CIN,BOS07,1,6,7
BOS200506170,2005,50617,BOS,PIT,BOS07,5,6,11
BOS200506180,2005,50618,BOS,PIT,BOS07,2,0,2
BOS200506190,2005,50619,BOS,PIT,BOS07,0,8,8
BOS200506270,2005,50627,BOS,CLE,BOS07,7,0,7
BOS200506280,2005,50628,BOS,CLE,BOS07,12,8,20
BOS200506290,2005,50629,BOS,CLE,BOS07,2,5,7
BOS200507010,2005,50701,BOS,TOR,BOS07,15,2,17
BOS200507020,2005,50702,BOS,TOR,BOS07,4,6,10
BOS200507030,2005,50703,BOS,TOR,BOS07,5,2,7
BOS200507140,2005,50714,BOS,NYA,BOS07,8,6,14
BOS200507150,2005,50715,BOS,NYA,BOS07,1,17,18
BOS200507160,2005,50716,BOS,NYA,BOS07,7,4,11
BOS200507170,2005,50717,BOS,NYA,BOS07,5,3,8
BOS200507180,2005,50718,BOS,TBA,BOS07,3,1,4
BOS200507190,2005,50719,BOS,TBA,BOS07,2,5,7
BOS200507200,2005,50720,BOS,TBA,BOS07,4,9,13
BOS200507290,2005,50729,BOS,MIN,BOS07,5,8,13
BOS200507300,2005,50730,BOS,MIN,BOS07,2,6,8
BOS200507310,2005,50731,BOS,MIN,BOS07,3,4,7
BOS200508020,2005,50802,BOS,KCA,BOS07,4,6,10
BOS200508030,2005,50803,BOS,KCA,BOS07,5,8,13
BOS200508040,2005,50804,BOS,KCA,BOS07,9,11,20
BOS200508080,2005,50808,BOS,TEX,BOS07,6,11,17
BOS200508090,2005,50809,BOS,TEX,BOS07,7,8,15
BOS200508100,2005,50810,BOS,TEX,BOS07,5,16,21
BOS200508120,2005,50812,BOS,CHA,BOS07,8,9,17
BOS200508130,2005,50813,BOS,CHA,BOS07,4,7,11
BOS200508260,2005,50826,BOS,DET,BOS07,8,9,17
BOS200508270,2005,50827,BOS,DET,BOS07,12,8,20
BOS200508280,2005,50828,BOS,DET,BOS07,3,11,14
BOS200508290,2005,50829,BOS,TBA,BOS07,6,10,16
BOS200508300,2005,50830,BOS,TBA,BOS07,6,7,13
BOS200508310,2005,50831,BOS,TBA,BOS07,6,7,13
BOS200509010,2005,50901,BOS,TBA,BOS07,4,7,11
BOS200509020,2005,50902,BOS,BAL,BOS07,7,3,10
BOS200509030,2005,50903,BOS,BAL,BOS07,6,7,13
BOS200509040,2005,50904,BOS,BAL,BOS07,1,5,6
BOS200509050,2005,50905,BOS,CHA,BOS07,5,3,8
BOS200509060,2005,50906,BOS,ANA,BOS07,2,3,5
BOS200509070,2005,50907,BOS,ANA,BOS07,3,6,9
BOS200509080,2005,50908,BOS,ANA,BOS07,3,0,3
BOS200509150,2005,50915,BOS,OAK,BOS07,6,2,8
BOS200509160,2005,50916,BOS,OAK,BOS07,2,3,5
BOS200509170,2005,50917,BOS,OAK,BOS07,1,2,3
BOS200509180,2005,50918,BOS,OAK,BOS07,12,3,15
BOS200509271,2005,50927,BOS,TOR,BOS07,1,3,4
BOS200509272,2005,50927,BOS,TOR,BOS07,7,5,12
BOS200509280,2005,50928,BOS,TOR,BOS07,7,2,9
BOS200509290,2005,50929,BOS,TOR,BOS07,4,5,9
BOS200509300,2005,50930,BOS,NYA,BOS07,3,5,8
BOS200510010,2005,51001,BOS,NYA,BOS07,8,4,12
BOS200510020,2005,51002,BOS,NYA,BOS07,1,10,11
BOS200510070,2005,51007,BOS,CHA,BOS07,5,3,8
BOS200604110,2006,60411,BOS,TOR,BOS07,3,5,8
BOS200604120,2006,60412,BOS,TOR,BOS07,8,4,12
BOS200604130,2006,60413,BOS,TOR,BOS07,8,6,14
BOS200604140,2006,60414,BOS,SEA,BOS07,1,2,3
BOS200604150,2006,60415,BOS,SEA,BOS07,3,0,3
BOS200604160,2006,60416,BOS,SEA,BOS07,2,3,5
BOS200604170,2006,60417,BOS,SEA,BOS07,6,7,13
BOS200604180,2006,60418,BOS,TBA,BOS07,4,7,11
BOS200604190,2006,60419,BOS,TBA,BOS07,1,9,10
BOS200604200,2006,60420,BOS,TBA,BOS07,5,1,6
BOS200605010,2006,60501,BOS,NYA,BOS07,3,7,10
BOS200605030,2006,60503,BOS,TOR,BOS07,7,6,13
BOS200605040,2006,60504,BOS,TOR,BOS07,4,7,11
BOS200605050,2006,60505,BOS,BAL,BOS07,3,6,9
BOS200605060,2006,60506,BOS,BAL,BOS07,3,9,12
BOS200605070,2006,60507,BOS,BAL,BOS07,3,10,13
BOS200605120,2006,60512,BOS,TEX,BOS07,6,0,6
BOS200605220,2006,60522,BOS,NYA,BOS07,5,9,14
BOS200605230,2006,60523,BOS,NYA,BOS07,7,5,12
BOS200605240,2006,60524,BOS,NYA,BOS07,8,6,14
BOS200605250,2006,60525,BOS,TBA,BOS07,1,4,5
BOS200605260,2006,60526,BOS,TBA,BOS07,4,8,12
BOS200605270,2006,60527,BOS,TBA,BOS07,4,6,10
BOS200605280,2006,60528,BOS,TBA,BOS07,4,5,9
BOS200606090,2006,60609,BOS,TEX,BOS07,3,4,7
BOS200606100,2006,60610,BOS,TEX,BOS07,7,4,11
BOS200606111,2006,60611,BOS,TEX,BOS07,4,5,9
BOS200606112,2006,60611,BOS,TEX,BOS07,13,6,19
BOS200606190,2006,60619,BOS,WAS,BOS07,3,6,9
BOS200606200,2006,60620,BOS,WAS,BOS07,3,11,14
BOS200606210,2006,60621,BOS,WAS,BOS07,3,9,12
BOS200606230,2006,60623,BOS,PHI,BOS07,2,10,12
BOS200606240,2006,60624,BOS,PHI,BOS07,3,5,8
BOS200606260,2006,60626,BOS,PHI,BOS07,7,8,15
BOS200606270,2006,60627,BOS,NYN,BOS07,4,9,13
BOS200606280,2006,60628,BOS,NYN,BOS07,2,10,12
BOS200606290,2006,60629,BOS,NYN,BOS07,2,4,6
BOS200607130,2006,60713,BOS,OAK,BOS07,5,4,9
BOS200607140,2006,60714,BOS,OAK,BOS07,15,3,18
BOS200607150,2006,60715,BOS,OAK,BOS07,0,7,7
BOS200607160,2006,60716,BOS,OAK,BOS07,8,1,9
BOS200607170,2006,60717,BOS,KCA,BOS07,4,5,9
BOS200607180,2006,60718,BOS,KCA,BOS07,0,1,1
BOS200607190,2006,60719,BOS,KCA,BOS07,0,1,1
BOS200607200,2006,60720,BOS,TEX,BOS07,4,6,10
BOS200607280,2006,60728,BOS,ANA,BOS07,8,3,11
BOS200607290,2006,60729,BOS,ANA,BOS07,6,7,13
BOS200607300,2006,60730,BOS,ANA,BOS07,10,4,14
BOS200607310,2006,60731,BOS,CLE,BOS07,8,9,17
BOS200608010,2006,60801,BOS,CLE,BOS07,6,3,9
BOS200608020,2006,60802,BOS,CLE,BOS07,5,6,11
BOS200608030,2006,60803,BOS,CLE,BOS07,7,6,13
BOS200608110,2006,60811,BOS,BAL,BOS07,2,9,11
BOS200608120,2006,60812,BOS,BAL,BOS07,7,8,15
BOS200608130,2006,60813,BOS,BAL,BOS07,9,11,20
BOS200608140,2006,60814,BOS,DET,BOS07,7,4,11
BOS200608150,2006,60815,BOS,DET,BOS07,3,2,5
BOS200608160,2006,60816,BOS,DET,BOS07,4,6,10
BOS200608181,2006,60818,BOS,NYA,BOS07,12,4,16
BOS200608182,2006,60818,BOS,NYA,BOS07,14,11,25
BOS200608190,2006,60819,BOS,NYA,BOS07,13,5,18
BOS200608200,2006,60820,BOS,NYA,BOS07,8,5,13
BOS200608210,2006,60821,BOS,NYA,BOS07,2,1,3
BOS200608310,2006,60831,BOS,TOR,BOS07,4,6,10
BOS200609010,2006,60901,BOS,TOR,BOS07,1,2,3
BOS200609020,2006,60902,BOS,TOR,BOS07,5,1,6
BOS200609030,2006,60903,BOS,TOR,BOS07,6,1,7
BOS200609040,2006,60904,BOS,CHA,BOS07,2,3,5
BOS200609050,2006,60905,BOS,CHA,BOS07,0,1,1
BOS200609060,2006,60906,BOS,CHA,BOS07,8,1,9
BOS200609080,2006,60908,BOS,KCA,BOS07,10,9,19
BOS200609090,2006,60909,BOS,KCA,BOS07,10,4,14
BOS200609100,2006,60910,BOS,KCA,BOS07,3,9,12
BOS200609190,2006,60919,BOS,MIN,BOS07,7,3,10
BOS200609200,2006,60920,BOS,MIN,BOS07,8,2,10
BOS200609210,2006,60921,BOS,MIN,BOS07,0,6,6
BOS200609260,2006,60926,BOS,TBA,BOS07,1,5,6
BOS200609270,2006,60927,BOS,TBA,BOS07,11,0,11
BOS200609290,2006,60929,BOS,BAL,BOS07,3,4,7
BOS200609300,2006,60930,BOS,BAL,BOS07,5,4,9
BOS200610010,2006,61001,BOS,BAL,BOS07,0,9,9
BOS200704100,2007,70410,BOS,SEA,BOS07,3,14,17
BOS200704110,2007,70411,BOS,SEA,BOS07,3,0,3
BOS200704130,2007,70413,BOS,ANA,BOS07,1,10,11
BOS200704140,2007,70414,BOS,ANA,BOS07,0,8,8
BOS200704160,2007,70416,BOS,ANA,BOS07,2,7,9
BOS200704200,2007,70420,BOS,NYA,BOS07,6,7,13
BOS200704210,2007,70421,BOS,NYA,BOS07,5,7,12
BOS200704220,2007,70422,BOS,NYA,BOS07,6,7,13
BOS200704230,2007,70423,BOS,TOR,BOS07,7,3,10
BOS200704240,2007,70424,BOS,TOR,BOS07,10,3,13
BOS200705010,2007,70501,BOS,OAK,BOS07,5,4,9
BOS200705020,2007,70502,BOS,OAK,BOS07,4,6,10
BOS200705030,2007,70503,BOS,SEA,BOS07,7,8,15
BOS200705110,2007,70511,BOS,BAL,BOS07,6,3,9
BOS200705120,2007,70512,BOS,BAL,BOS07,4,13,17
BOS200705130,2007,70513,BOS,BAL,BOS07,5,6,11
BOS200705140,2007,70514,BOS,DET,BOS07,1,7,8
BOS200705150,2007,70515,BOS,DET,BOS07,7,2,9
BOS200705171,2007,70517,BOS,DET,BOS07,1,2,3
BOS200705172,2007,70517,BOS,DET,BOS07,2,4,6
BOS200705191,2007,70519,BOS,ATL,BOS07,3,13,16
BOS200705192,2007,70519,BOS,ATL,BOS07,14,0,14
BOS200705200,2007,70520,BOS,ATL,BOS07,3,6,9
BOS200705280,2007,70528,BOS,CLE,BOS07,3,5,8
BOS200705290,2007,70529,BOS,CLE,BOS07,2,4,6
BOS200705300,2007,70530,BOS,CLE,BOS07,8,4,12
BOS200706010,2007,70601,BOS,NYA,BOS07,9,5,14
BOS200706020,2007,70602,BOS,NYA,BOS07,6,11,17
BOS200706030,2007,70603,BOS,NYA,BOS07,6,5,11
BOS200706120,2007,70612,BOS,COL,BOS07,1,2,3
BOS200706130,2007,70613,BOS,COL,BOS07,12,2,14
BOS200706140,2007,70614,BOS,COL,BOS07,7,1,8
BOS200706150,2007,70615,BOS,SFN,BOS07,2,10,12
BOS200706160,2007,70616,BOS,SFN,BOS07,0,1,1
BOS200706170,2007,70617,BOS,SFN,BOS07,5,9,14
BOS200706290,2007,70629,BOS,TEX,BOS07,1,2,3
BOS200706300,2007,70630,BOS,TEX,BOS07,5,4,9
BOS200707010,2007,70701,BOS,TEX,BOS07,2,1,3
BOS200707020,2007,70702,BOS,TEX,BOS07,3,7,10
BOS200707030,2007,70703,BOS,TBA,BOS07,1,4,5
BOS200707040,2007,70704,BOS,TBA,BOS07,5,7,12
BOS200707050,2007,70705,BOS,TBA,BOS07,4,15,19
BOS200707120,2007,70712,BOS,TOR,BOS07,4,7,11
BOS200707130,2007,70713,BOS,TOR,BOS07,6,5,11
BOS200707140,2007,70714,BOS,TOR,BOS07,4,9,13
BOS200707150,2007,70715,BOS,TOR,BOS07,2,1,3
BOS200707160,2007,70716,BOS,KCA,BOS07,0,4,4
BOS200707170,2007,70717,BOS,KCA,BOS07,9,3,12
BOS200707180,2007,70718,BOS,KCA,BOS07,6,5,11
BOS200707190,2007,70719,BOS,CHA,BOS07,4,2,6
BOS200707200,2007,70720,BOS,CHA,BOS07,3,10,13
BOS200707210,2007,70721,BOS,CHA,BOS07,2,11,13
BOS200707220,2007,70722,BOS,CHA,BOS07,5,8,13
BOS200707310,2007,70731,BOS,BAL,BOS07,5,3,8
BOS200708010,2007,70801,BOS,BAL,BOS07,4,5,9
BOS200708020,2007,70802,BOS,BAL,BOS07,4,7,11
BOS200708130,2007,70813,BOS,TBA,BOS07,0,3,3
BOS200708140,2007,70814,BOS,TBA,BOS07,1,2,3
BOS200708150,2007,70815,BOS,TBA,BOS07,6,5,11
BOS200708171,2007,70817,BOS,ANA,BOS07,4,8,12
BOS200708172,2007,70817,BOS,ANA,BOS07,7,5,12
BOS200708180,2007,70818,BOS,ANA,BOS07,5,10,15
BOS200708190,2007,70819,BOS,ANA,BOS07,3,1,4
BOS200708310,2007,70831,BOS,BAL,BOS07,9,8,17
BOS200709010,2007,70901,BOS,BAL,BOS07,0,10,10
BOS200709020,2007,70902,BOS,BAL,BOS07,2,3,5
BOS200709030,2007,70903,BOS,TOR,BOS07,10,13,23
BOS200709040,2007,70904,BOS,TOR,BOS07,3,5,8
BOS200709050,2007,70905,BOS,TOR,BOS07,6,4,10
BOS200709100,2007,70910,BOS,TBA,BOS07,1,0,1
BOS200709110,2007,70911,BOS,TBA,BOS07,10,16,26
BOS200709120,2007,70912,BOS,TBA,BOS07,4,5,9
BOS200709140,2007,70914,BOS,NYA,BOS07,8,7,15
BOS200709150,2007,70915,BOS,NYA,BOS07,1,10,11
BOS200709160,2007,70916,BOS,NYA,BOS07,4,3,7
BOS200709250,2007,70925,BOS,OAK,BOS07,3,7,10
BOS200709260,2007,70926,BOS,OAK,BOS07,6,11,17
BOS200709270,2007,70927,BOS,MIN,BOS07,5,4,9
BOS200709280,2007,70928,BOS,MIN,BOS07,2,5,7
BOS200709290,2007,70929,BOS,MIN,BOS07,4,6,10
BOS200709300,2007,70930,BOS,MIN,BOS07,3,2,5
BOS200710030,2007,71003,BOS,ANA,BOS07,0,4,4
BOS200710050,2007,71005,BOS,ANA,BOS07,3,6,9
BOS200710120,2007,71012,BOS,CLE,BOS07,3,10,13
BOS200710130,2007,71013,BOS,CLE,BOS07,13,6,19
BOS200710200,2007,71020,BOS,CLE,BOS07,2,12,14
BOS200710210,2007,71021,BOS,CLE,BOS07,2,11,13
BOS200710240,2007,71024,BOS,COL,BOS07,1,13,14
BOS200710250,2007,71025,BOS,COL,BOS07,1,2,3
BOS200804080,2008,80408,BOS,DET,BOS07,0,5,5
BOS200804090,2008,80409,BOS,DET,BOS07,7,2,9
BOS200804100,2008,80410,BOS,DET,BOS07,6,12,18
BOS200804110,2008,80411,BOS,NYA,BOS07,4,1,5
BOS200804120,2008,80412,BOS,NYA,BOS07,3,4,7
BOS200804130,2008,80413,BOS,NYA,BOS07,5,8,13
BOS200804180,2008,80418,BOS,TEX,BOS07,3,11,14
BOS200804190,2008,80419,BOS,TEX,BOS07,3,5,8
BOS200804200,2008,80420,BOS,TEX,BOS07,5,6,11
BOS200804210,2008,80421,BOS,TEX,BOS07,3,8,11
BOS200804220,2008,80422,BOS,ANA,BOS07,6,7,13
BOS200804230,2008,80423,BOS,ANA,BOS07,6,4,10
BOS200804240,2008,80424,BOS,ANA,BOS07,7,5,12
BOS200804290,2008,80429,BOS,TOR,BOS07,0,1,1
BOS200804300,2008,80430,BOS,TOR,BOS07,1,2,3
BOS200805010,2008,80501,BOS,TOR,BOS07,3,0,3
BOS200805020,2008,80502,BOS,TBA,BOS07,3,7,10
BOS200805030,2008,80503,BOS,TBA,BOS07,4,12,16
BOS200805040,2008,80504,BOS,TBA,BOS07,3,7,10
BOS200805171,2008,80517,BOS,MIL,BOS07,3,5,8
BOS200805172,2008,80517,BOS,MIL,BOS07,6,7,13
BOS200805180,2008,80518,BOS,MIL,BOS07,7,11,18
BOS200805190,2008,80519,BOS,KCA,BOS07,0,7,7
BOS200805200,2008,80520,BOS,KCA,BOS07,1,2,3
BOS200805210,2008,80521,BOS,KCA,BOS07,3,6,9
BOS200805220,2008,80522,BOS,KCA,BOS07,8,11,19
BOS200806030,2008,80603,BOS,TBA,BOS07,4,7,11
BOS200806040,2008,80604,BOS,TBA,BOS07,1,5,6
BOS200806050,2008,80605,BOS,TBA,BOS07,1,7,8
BOS200806060,2008,80606,BOS,SEA,BOS07,8,0,8
BOS200806070,2008,80607,BOS,SEA,BOS07,3,11,14
BOS200806080,2008,80608,BOS,SEA,BOS07,1,2,3
BOS200806100,2008,80610,BOS,BAL,BOS07,10,6,16
BOS200806110,2008,80611,BOS,BAL,BOS07,3,6,9
BOS200806120,2008,80612,BOS,BAL,BOS07,2,9,11
BOS200806200,2008,80620,BOS,SLN,BOS07,5,4,9
BOS200806210,2008,80621,BOS,SLN,BOS07,9,3,12
BOS200806220,2008,80622,BOS,SLN,BOS07,3,5,8
BOS200806230,2008,80623,BOS,ARI,BOS07,2,1,3
BOS200806240,2008,80624,BOS,ARI,BOS07,4,5,9
BOS200806250,2008,80625,BOS,ARI,BOS07,0,5,5
BOS200807070,2008,80707,BOS,MIN,BOS07,0,1,1
BOS200807080,2008,80708,BOS,MIN,BOS07,5,6,11
BOS200807090,2008,80709,BOS,MIN,BOS07,5,18,23
BOS200807110,2008,80711,BOS,BAL,BOS07,7,3,10
BOS200807120,2008,80712,BOS,BAL,BOS07,1,12,13
BOS200807130,2008,80713,BOS,BAL,BOS07,1,2,3
BOS200807250,2008,80725,BOS,NYA,BOS07,1,0,1
BOS200807260,2008,80726,BOS,NYA,BOS07,10,3,13
BOS200807270,2008,80727,BOS,NYA,BOS07,2,9,11
BOS200807280,2008,80728,BOS,ANA,BOS07,7,5,12
BOS200807290,2008,80729,BOS,ANA,BOS07,6,2,8
BOS200807300,2008,80730,BOS,ANA,BOS07,9,2,11
BOS200808010,2008,80801,BOS,OAK,BOS07,1,2,3
BOS200808020,2008,80802,BOS,OAK,BOS07,2,12,14
BOS200808030,2008,80803,BOS,OAK,BOS07,2,5,7
BOS200808120,2008,80812,BOS,TEX,BOS07,17,19,36
BOS200808130,2008,80813,BOS,TEX,BOS07,4,8,12
BOS200808140,2008,80814,BOS,TEX,BOS07,0,10,10
BOS200808160,2008,80816,BOS,TOR,BOS07,4,1,5
BOS200808170,2008,80817,BOS,TOR,BOS07,15,4,19
BOS200808290,2008,80829,BOS,CHA,BOS07,0,8,8
BOS200808300,2008,80830,BOS,CHA,BOS07,2,8,10
BOS200808310,2008,80831,BOS,CHA,BOS07,4,2,6
BOS200809010,2008,80901,BOS,BAL,BOS07,4,7,11
BOS200809020,2008,80902,BOS,BAL,BOS07,2,14,16
BOS200809030,2008,80903,BOS,BAL,BOS07,4,5,9
BOS200809080,2008,80908,BOS,TBA,BOS07,0,3,3
BOS200809090,2008,80909,BOS,TBA,BOS07,5,4,9
BOS200809100,2008,80910,BOS,TBA,BOS07,4,2,6
BOS200809120,2008,80912,BOS,TOR,BOS07,0,7,7
BOS200809131,2008,80913,BOS,TOR,BOS07,8,1,9
BOS200809132,2008,80913,BOS,TOR,BOS07,5,7,12
BOS200809140,2008,80914,BOS,TOR,BOS07,3,4,7
BOS200809220,2008,80922,BOS,CLE,BOS07,4,3,7
BOS200809230,2008,80923,BOS,CLE,BOS07,4,5,9
BOS200809240,2008,80924,BOS,CLE,BOS07,4,5,9
BOS200809250,2008,80925,BOS,CLE,BOS07,1,6,7
BOS200809260,2008,80926,BOS,NYA,BOS07,19,8,27
BOS200809281,2008,80928,BOS,NYA,BOS07,6,2,8
BOS200809282,2008,80928,BOS,NYA,BOS07,3,4,7
BOS200810050,2008,81005,BOS,ANA,BOS07,5,4,9
BOS200810060,2008,81006,BOS,ANA,BOS07,2,3,5
BOS200810130,2008,81013,BOS,TBA,BOS07,9,1,10
BOS200810140,2008,81014,BOS,TBA,BOS07,13,4,17
BOS200810160,2008,81016,BOS,TBA,BOS07,7,8,15
BOS200904070,2009,90407,BOS,TBA,BOS07,3,5,8
BOS200904080,2009,90408,BOS,TBA,BOS07,7,2,9
BOS200904090,2009,90409,BOS,TBA,BOS07,4,3,7
BOS200904170,2009,90417,BOS,BAL,BOS07,8,10,18
BOS200904180,2009,90418,BOS,BAL,BOS07,4,6,10
BOS200904190,2009,90419,BOS,BAL,BOS07,1,2,3
BOS200904200,2009,90420,BOS,BAL,BOS07,1,12,13
BOS200904221,2009,90422,BOS,MIN,BOS07,1,10,11
BOS200904222,2009,90422,BOS,MIN,BOS07,3,7,10
BOS200904240,2009,90424,BOS,NYA,BOS07,4,5,9
BOS200904250,2009,90425,BOS,NYA,BOS07,11,16,27
BOS200904260,2009,90426,BOS,NYA,BOS07,1,4,5
BOS200905060,2009,90506,BOS,CLE,BOS07,9,2,11
BOS200905070,2009,90507,BOS,CLE,BOS07,3,13,16
BOS200905080,2009,90508,BOS,TBA,BOS07,3,7,10
BOS200905090,2009,90509,BOS,TBA,BOS07,14,5,19
BOS200905100,2009,90510,BOS,TBA,BOS07,3,4,7
BOS200905190,2009,90519,BOS,TOR,BOS07,1,2,3
BOS200905200,2009,90520,BOS,TOR,BOS07,3,8,11
BOS200905210,2009,90521,BOS,TOR,BOS07,1,5,6
BOS200905220,2009,90522,BOS,NYN,BOS07,5,3,8
BOS200905230,2009,90523,BOS,NYN,BOS07,3,2,5
BOS200905240,2009,90524,BOS,NYN,BOS07,5,12,17
BOS200906050,2009,90605,BOS,TEX,BOS07,5,1,6
BOS200906060,2009,90606,BOS,TEX,BOS07,1,8,9
BOS200906070,2009,90607,BOS,TEX,BOS07,6,3,9
BOS200906090,2009,90609,BOS,NYA,BOS07,0,7,7
BOS200906100,2009,90610,BOS,NYA,BOS07,5,6,11
BOS200906110,2009,90611,BOS,NYA,BOS07,3,4,7
BOS200906160,2009,90616,BOS,FLO,BOS07,2,8,10
BOS200906170,2009,90617,BOS,FLO,BOS07,1,6,7
BOS200906180,2009,90618,BOS,FLO,BOS07,2,1,3
BOS200906190,2009,90619,BOS,ATL,BOS07,8,2,10
BOS200906200,2009,90620,BOS,ATL,BOS07,0,3,3
BOS200906210,2009,90621,BOS,ATL,BOS07,5,6,11
BOS200907030,2009,90703,BOS,SEA,BOS07,7,6,13
BOS200907040,2009,90704,BOS,SEA,BOS07,3,2,5
BOS200907050,2009,90705,BOS,SEA,BOS07,4,8,12
BOS200907060,2009,90706,BOS,OAK,BOS07,6,0,6
BOS200907070,2009,90707,BOS,OAK,BOS07,2,5,7
BOS200907080,2009,90708,BOS,OAK,BOS07,4,5,9
BOS200907090,2009,90709,BOS,KCA,BOS07,8,6,14
BOS200907100,2009,90710,BOS,KCA,BOS07,0,1,1
BOS200907110,2009,90711,BOS,KCA,BOS07,9,15,24
BOS200907120,2009,90712,BOS,KCA,BOS07,0,6,6
BOS200907240,2009,90724,BOS,BAL,BOS07,1,3,4
BOS200907250,2009,90725,BOS,BAL,BOS07,2,7,9
BOS200907260,2009,90726,BOS,BAL,BOS07,6,2,8
BOS200907270,2009,90727,BOS,OAK,BOS07,3,8,11
BOS200907280,2009,90728,BOS,OAK,BOS07,9,8,17
BOS200907290,2009,90729,BOS,OAK,BOS07,8,6,14
BOS200907300,2009,90730,BOS,OAK,BOS07,5,8,13
BOS200908100,2009,90810,BOS,DET,BOS07,5,6,11
BOS200908110,2009,90811,BOS,DET,BOS07,5,7,12
BOS200908120,2009,90812,BOS,DET,BOS07,2,8,10
BOS200908130,2009,90813,BOS,DET,BOS07,2,0,2
BOS200908210,2009,90821,BOS,NYA,BOS07,20,11,31
BOS200908220,2009,90822,BOS,NYA,BOS07,1,14,15
BOS200908230,2009,90823,BOS,NYA,BOS07,8,4,12
BOS200908240,2009,90824,BOS,CHA,BOS07,8,12,20
BOS200908250,2009,90825,BOS,CHA,BOS07,3,6,9
BOS200908260,2009,90826,BOS,CHA,BOS07,2,3,5
BOS200908270,2009,90827,BOS,CHA,BOS07,9,5,14
BOS200908280,2009,90828,BOS,TOR,BOS07,5,6,11
BOS200908290,2009,90829,BOS,TOR,BOS07,2,3,5
BOS200908300,2009,90830,BOS,TOR,BOS07,0,7,7
BOS200909080,2009,90908,BOS,BAL,BOS07,0,10,10
BOS200909090,2009,90909,BOS,BAL,BOS07,5,7,12
BOS200909120,2009,90912,BOS,TBA,BOS07,1,9,10
BOS200909131,2009,90913,BOS,TBA,BOS07,1,3,4
BOS200909132,2009,90913,BOS,TBA,BOS07,0,4,4
BOS200909150,2009,90915,BOS,ANA,BOS07,1,4,5
BOS200909160,2009,90916,BOS,ANA,BOS07,8,9,17
BOS200909170,2009,90917,BOS,ANA,BOS07,4,3,7
BOS200909280,2009,90928,BOS,TOR,BOS07,11,5,16
BOS200909290,2009,90929,BOS,TOR,BOS07,8,7,15
BOS200909300,2009,90930,BOS,TOR,BOS07,12,0,12
BOS200910010,2009,91001,BOS,CLE,BOS07,0,3,3
BOS200910020,2009,91002,BOS,CLE,BOS07,2,6,8
BOS200910030,2009,91003,BOS,CLE,BOS07,6,11,17
BOS200910040,2009,91004,BOS,CLE,BOS07,7,12,19
BOS200910110,2009,91011,BOS,ANA,BOS07,7,6,13
CHA200004140,2000,414,CHA,ANA,CHI12,4,9,13
CHA200004150,2000,415,CHA,ANA,CHI12,3,1,4
CHA200004160,2000,416,CHA,ANA,CHI12,3,1,4
CHA200004180,2000,418,CHA,SEA,CHI12,11,18,29
CHA200004190,2000,419,CHA,SEA,CHI12,2,5,7
CHA200004210,2000,421,CHA,DET,CHI12,2,7,9
CHA200004220,2000,422,CHA,DET,CHI12,6,14,20
CHA200004230,2000,423,CHA,DET,CHI12,4,9,13
CHA200004240,2000,424,CHA,BAL,CHI12,2,8,10
CHA200004250,2000,425,CHA,BAL,CHI12,12,6,18
CHA200004260,2000,426,CHA,BAL,CHI12,6,11,17
CHA200004270,2000,427,CHA,BAL,CHI12,4,13,17
CHA200005010,2000,501,CHA,TOR,CHI12,5,3,8
CHA200005020,2000,502,CHA,TOR,CHI12,4,1,5
CHA200005030,2000,503,CHA,TOR,CHI12,3,7,10
CHA200005120,2000,512,CHA,MIN,CHI12,4,3,7
CHA200005130,2000,513,CHA,MIN,CHI12,3,4,7
CHA200005140,2000,514,CHA,MIN,CHI12,3,5,8
CHA200005230,2000,523,CHA,NYA,CHI12,2,8,10
CHA200005240,2000,524,CHA,NYA,CHI12,12,4,16
CHA200005250,2000,525,CHA,NYA,CHI12,7,0,7
CHA200005260,2000,526,CHA,CLE,CHI12,3,5,8
CHA200005270,2000,527,CHA,CLE,CHI12,3,14,17
CHA200005280,2000,528,CHA,CLE,CHI12,12,3,15
CHA200006090,2000,609,CHA,CHN,CHI12,5,6,11
CHA200006100,2000,610,CHA,CHN,CHI12,3,4,7
CHA200006110,2000,611,CHA,CHN,CHI12,6,5,11
CHA200006190,2000,619,CHA,CLE,CHI12,1,6,7
CHA200006200,2000,620,CHA,CLE,CHI12,4,1,5
CHA200006210,2000,621,CHA,CLE,CHI12,8,6,14
CHA200006220,2000,622,CHA,CLE,CHI12,0,6,6
CHA200006230,2000,623,CHA,NYA,CHI12,3,4,7
CHA200006240,2000,624,CHA,NYA,CHI12,12,8,20
CHA200006250,2000,625,CHA,NYA,CHI12,7,8,15
CHA200006270,2000,627,CHA,MIN,CHI12,7,4,11
CHA200006280,2000,628,CHA,MIN,CHI12,3,7,10
CHA200006290,2000,629,CHA,MIN,CHI12,10,1,11
CHA200006300,2000,630,CHA,BOS,CHI12,4,10,14
CHA200007010,2000,701,CHA,BOS,CHI12,2,7,9
CHA200007020,2000,702,CHA,BOS,CHI12,2,8,10
CHA200007130,2000,713,CHA,SLN,CHI12,13,5,18
CHA200007140,2000,714,CHA,SLN,CHI12,9,4,13
CHA200007150,2000,715,CHA,SLN,CHI12,7,15,22
CHA200007160,2000,716,CHA,MIL,CHI12,5,11,16
CHA200007170,2000,717,CHA,MIL,CHI12,2,11,13
CHA200007180,2000,718,CHA,MIL,CHI12,5,7,12
CHA200007240,2000,724,CHA,KCA,CHI12,6,7,13
CHA200007250,2000,725,CHA,KCA,CHI12,6,1,7
CHA200007260,2000,726,CHA,KCA,CHI12,7,6,13
CHA200008040,2000,804,CHA,OAK,CHI12,5,3,8
CHA200008050,2000,805,CHA,OAK,CHI12,3,4,7
CHA200008060,2000,806,CHA,OAK,CHI12,0,13,13
CHA200008081,2000,808,CHA,SEA,CHI12,12,4,16
CHA200008082,2000,808,CHA,SEA,CHI12,7,5,12
CHA200008090,2000,809,CHA,SEA,CHI12,3,19,22
CHA200008100,2000,810,CHA,SEA,CHI12,6,3,9
CHA200008180,2000,818,CHA,TBA,CHI12,2,5,7
CHA200008190,2000,819,CHA,TBA,CHI12,0,7,7
CHA200008200,2000,820,CHA,TBA,CHI12,12,11,23
CHA200008210,2000,821,CHA,TBA,CHI12,11,4,15
CHA200008230,2000,823,CHA,BAL,CHI12,4,8,12
CHA200008240,2000,824,CHA,BAL,CHI12,8,5,13
CHA200009010,2000,901,CHA,ANA,CHI12,8,9,17
CHA200009020,2000,902,CHA,ANA,CHI12,6,13,19
CHA200009030,2000,903,CHA,ANA,CHI12,12,13,25
CHA200009040,2000,904,CHA,TEX,CHI12,5,4,9
CHA200009050,2000,905,CHA,TEX,CHI12,2,1,3
CHA200009060,2000,906,CHA,TEX,CHI12,1,13,14
CHA200009070,2000,907,CHA,TEX,CHI12,6,10,16
CHA200009110,2000,911,CHA,DET,CHI12,3,10,13
CHA200009120,2000,912,CHA,DET,CHI12,10,3,13
CHA200009130,2000,913,CHA,DET,CHI12,0,1,1
CHA200009150,2000,915,CHA,TOR,CHI12,6,5,11
CHA200009160,2000,916,CHA,TOR,CHI12,3,6,9
CHA200009170,2000,917,CHA,TOR,CHI12,14,1,15
CHA200009260,2000,926,CHA,BOS,CHI12,4,3,7
CHA200009270,2000,927,CHA,BOS,CHI12,2,1,3
CHA200009280,2000,928,CHA,BOS,CHI12,7,6,13
CHA200009290,2000,929,CHA,KCA,CHI12,4,6,10
CHA200009300,2000,930,CHA,KCA,CHI12,1,9,10
CHA200010010,2000,1001,CHA,KCA,CHI12,6,2,8
CHA200010030,2000,1003,CHA,SEA,CHI12,7,4,11
CHA200010040,2000,1004,CHA,SEA,CHI12,5,2,7
CHA200104060,2001,10406,CHA,DET,CHI12,10,9,19
CHA200104070,2001,10407,CHA,DET,CHI12,5,3,8
CHA200104080,2001,10408,CHA,DET,CHI12,5,3,8
CHA200104090,2001,10409,CHA,CLE,CHI12,2,9,11
CHA200104100,2001,10410,CHA,CLE,CHI12,7,8,15
CHA200104110,2001,10411,CHA,CLE,CHI12,6,7,13
CHA200104200,2001,10420,CHA,MIN,CHI12,4,1,5
CHA200104210,2001,10421,CHA,MIN,CHI12,4,3,7
CHA200104220,2001,10422,CHA,MIN,CHI12,4,2,6
CHA200104240,2001,10424,CHA,OAK,CHI12,6,4,10
CHA200104250,2001,10425,CHA,OAK,CHI12,1,2,3
CHA200104260,2001,10426,CHA,OAK,CHI12,16,6,22
CHA200104270,2001,10427,CHA,SEA,CHI12,8,3,11
CHA200104280,2001,10428,CHA,SEA,CHI12,8,5,13
CHA200104290,2001,10429,CHA,SEA,CHI12,1,2,3
CHA200105080,2001,10508,CHA,ANA,CHI12,0,2,2
CHA200105090,2001,10509,CHA,ANA,CHI12,5,6,11
CHA200105100,2001,10510,CHA,ANA,CHI12,7,6,13
CHA200105110,2001,10511,CHA,TEX,CHI12,5,6,11
CHA200105120,2001,10512,CHA,TEX,CHI12,16,6,22
CHA200105130,2001,10513,CHA,TEX,CHI12,3,6,9
CHA200105280,2001,10528,CHA,TOR,CHI12,3,6,9
CHA200105290,2001,10529,CHA,TOR,CHI12,4,0,4
CHA200105300,2001,10530,CHA,TOR,CHI12,3,4,7
CHA200106010,2001,10601,CHA,DET,CHI12,0,3,3
CHA200106020,2001,10602,CHA,DET,CHI12,3,5,8
CHA200106030,2001,10603,CHA,DET,CHI12,6,9,15
CHA200106080,2001,10608,CHA,CHN,CHI12,3,7,10
CHA200106090,2001,10609,CHA,CHN,CHI12,4,3,7
CHA200106100,2001,10610,CHA,CHN,CHI12,1,3,4
CHA200106120,2001,10612,CHA,CIN,CHI12,0,5,5
CHA200106130,2001,10613,CHA,CIN,CHI12,2,4,6
CHA200106140,2001,10614,CHA,CIN,CHI12,5,7,12
CHA200106180,2001,10618,CHA,KCA,CHI12,4,5,9
CHA200106190,2001,10619,CHA,KCA,CHI12,3,5,8
CHA200106200,2001,10620,CHA,KCA,CHI12,1,2,3
CHA200106290,2001,10629,CHA,BAL,CHI12,4,0,4
CHA200106300,2001,10630,CHA,BAL,CHI12,1,4,5
CHA200107010,2001,10701,CHA,BAL,CHI12,11,3,14
CHA200107020,2001,10702,CHA,MIN,CHI12,7,5,12
CHA200107030,2001,10703,CHA,MIN,CHI12,5,3,8
CHA200107040,2001,10704,CHA,MIN,CHI12,3,4,7
CHA200107050,2001,10705,CHA,MIN,CHI12,12,2,14
CHA200107060,2001,10706,CHA,PIT,CHI12,10,6,16
CHA200107070,2001,10707,CHA,PIT,CHI12,1,4,5
CHA200107080,2001,10708,CHA,PIT,CHI12,2,9,11
CHA200107180,2001,10718,CHA,CLE,CHI12,9,4,13
CHA200107190,2001,10719,CHA,CLE,CHI12,10,3,13
CHA200107200,2001,10720,CHA,BOS,CHI12,7,2,9
CHA200107210,2001,10721,CHA,BOS,CHI12,3,10,13
CHA200107220,2001,10722,CHA,BOS,CHI12,8,13,21
CHA200107310,2001,10731,CHA,KCA,CHI12,2,1,3
CHA200108010,2001,10801,CHA,KCA,CHI12,6,7,13
CHA200108020,2001,10802,CHA,KCA,CHI12,6,3,9
CHA200108030,2001,10803,CHA,TBA,CHI12,0,4,4
CHA200108040,2001,10804,CHA,TBA,CHI12,6,8,14
CHA200108050,2001,10805,CHA,TBA,CHI12,6,4,10
CHA200108060,2001,10806,CHA,TBA,CHI12,2,5,7
CHA200108140,2001,10814,CHA,TEX,CHI12,4,7,11
CHA200108150,2001,10815,CHA,TEX,CHI12,5,6,11
CHA200108160,2001,10816,CHA,TEX,CHI12,5,7,12
CHA200108170,2001,10817,CHA,OAK,CHI12,9,2,11
CHA200108180,2001,10818,CHA,OAK,CHI12,5,4,9
CHA200108190,2001,10819,CHA,OAK,CHI12,8,7,15
CHA200108310,2001,10831,CHA,CLE,CHI12,8,11,19
CHA200109010,2001,10901,CHA,CLE,CHI12,4,3,7
CHA200109020,2001,10902,CHA,CLE,CHI12,10,19,29
CHA200109030,2001,10903,CHA,CLE,CHI12,6,3,9
CHA200109041,2001,10904,CHA,DET,CHI12,1,10,11
CHA200109042,2001,10904,CHA,DET,CHI12,0,4,4
CHA200109050,2001,10905,CHA,DET,CHI12,3,5,8
CHA200109060,2001,10906,CHA,DET,CHI12,6,2,8
CHA200109180,2001,10918,CHA,NYA,CHI12,11,3,14
CHA200109190,2001,10919,CHA,NYA,CHI12,6,3,9
CHA200109200,2001,10920,CHA,NYA,CHI12,5,7,12
CHA200109210,2001,10921,CHA,KCA,CHI12,7,8,15
CHA200109220,2001,10922,CHA,KCA,CHI12,4,5,9
CHA200109230,2001,10923,CHA,KCA,CHI12,2,10,12
CHA200109250,2001,10925,CHA,MIN,CHI12,4,2,6
CHA200109260,2001,10926,CHA,MIN,CHI12,3,6,9
CHA200109270,2001,10927,CHA,MIN,CHI12,3,9,12
CHA200204120,2002,20412,CHA,BAL,CHI12,2,5,7
CHA200204130,2002,20413,CHA,BAL,CHI12,3,4,7
CHA200204140,2002,20414,CHA,BAL,CHI12,9,4,13
CHA200204150,2002,20415,CHA,BAL,CHI12,4,13,17
CHA200204160,2002,20416,CHA,CLE,CHI12,5,10,15
CHA200204170,2002,20417,CHA,CLE,CHI12,2,7,9
CHA200204180,2002,20418,CHA,CLE,CHI12,1,7,8
CHA200204190,2002,20419,CHA,DET,CHI12,8,2,10
CHA200204200,2002,20420,CHA,DET,CHI12,5,12,17
CHA200204210,2002,20421,CHA,DET,CHI12,8,11,19
CHA200204300,2002,20430,CHA,SEA,CHI12,4,8,12
CHA200205010,2002,20501,CHA,SEA,CHI12,2,9,11
CHA200205020,2002,20502,CHA,SEA,CHI12,15,4,19
CHA200205030,2002,20503,CHA,OAK,CHI12,1,6,7
CHA200205040,2002,20504,CHA,OAK,CHI12,2,10,12
CHA200205050,2002,20505,CHA,OAK,CHI12,3,2,5
CHA200205140,2002,20514,CHA,TEX,CHI12,4,15,19
CHA200205150,2002,20515,CHA,TEX,CHI12,5,2,7
CHA200205160,2002,20516,CHA,TEX,CHI12,0,4,4
CHA200205170,2002,20517,CHA,ANA,CHI12,8,4,12
CHA200205180,2002,20518,CHA,ANA,CHI12,4,10,14
CHA200205190,2002,20519,CHA,ANA,CHI12,6,1,7
CHA200205240,2002,20524,CHA,DET,CHI12,1,12,13
CHA200205250,2002,20525,CHA,DET,CHI12,4,6,10
CHA200205260,2002,20526,CHA,DET,CHI12,9,2,11
CHA200205270,2002,20527,CHA,NYA,CHI12,10,6,16
CHA200205280,2002,20528,CHA,NYA,CHI12,4,2,6
CHA200205290,2002,20529,CHA,NYA,CHI12,6,3,9
CHA200206030,2002,20603,CHA,KCA,CHI12,0,4,4
CHA200206040,2002,20604,CHA,KCA,CHI12,3,2,5
CHA200206050,2002,20605,CHA,KCA,CHI12,1,6,7
CHA200206060,2002,20606,CHA,KCA,CHI12,4,3,7
CHA200206070,2002,20607,CHA,MON,CHI12,4,3,7
CHA200206080,2002,20608,CHA,MON,CHI12,2,1,3
CHA200206090,2002,20609,CHA,MON,CHI12,2,13,15
CHA200206100,2002,20610,CHA,NYN,CHI12,3,1,4
CHA200206110,2002,20611,CHA,NYN,CHI12,8,10,18
CHA200206120,2002,20612,CHA,NYN,CHI12,1,2,3
CHA200206280,2002,20628,CHA,CHN,CHI12,9,13,22
CHA200206290,2002,20629,CHA,CHN,CHI12,4,5,9
CHA200206300,2002,20630,CHA,CHN,CHI12,9,2,11
CHA200207020,2002,20702,CHA,DET,CHI12,9,17,26
CHA200207030,2002,20703,CHA,DET,CHI12,5,4,9
CHA200207040,2002,20704,CHA,DET,CHI12,6,5,11
CHA200207050,2002,20705,CHA,CLE,CHI12,4,2,6
CHA200207060,2002,20706,CHA,CLE,CHI12,3,7,10
CHA200207070,2002,20707,CHA,CLE,CHI12,9,3,12
CHA200207220,2002,20722,CHA,MIN,CHI12,11,6,17
CHA200207230,2002,20723,CHA,MIN,CHI12,7,8,15
CHA200207240,2002,20724,CHA,MIN,CHI12,8,1,9
CHA200207260,2002,20726,CHA,KCA,CHI12,2,10,12
CHA200207270,2002,20727,CHA,KCA,CHI12,1,9,10
CHA200207280,2002,20728,CHA,KCA,CHI12,2,4,6
CHA200208060,2002,20806,CHA,ANA,CHI12,11,2,13
CHA200208070,2002,20807,CHA,ANA,CHI12,6,7,13
CHA200208080,2002,20808,CHA,ANA,CHI12,2,3,5
CHA200208090,2002,20809,CHA,SEA,CHI12,2,10,12
CHA200208100,2002,20810,CHA,SEA,CHI12,7,3,10
CHA200208110,2002,20811,CHA,SEA,CHI12,5,6,11
CHA200208190,2002,20819,CHA,MIN,CHI12,7,3,10
CHA200208200,2002,20820,CHA,MIN,CHI12,5,0,5
CHA200208210,2002,20821,CHA,MIN,CHI12,1,10,11
CHA200208230,2002,20823,CHA,TBA,CHI12,8,2,10
CHA200208240,2002,20824,CHA,TBA,CHI12,2,5,7
CHA200208250,2002,20825,CHA,TBA,CHI12,3,8,11
CHA200208260,2002,20826,CHA,TOR,CHI12,8,4,12
CHA200208270,2002,20827,CHA,TOR,CHI12,4,8,12
CHA200208280,2002,20828,CHA,TOR,CHI12,0,8,8
CHA200209050,2002,20905,CHA,CLE,CHI12,11,6,17
CHA200209060,2002,20906,CHA,CLE,CHI12,9,7,16
CHA200209070,2002,20907,CHA,CLE,CHI12,4,2,6
CHA200209080,2002,20908,CHA,CLE,CHI12,6,7,13
CHA200209170,2002,20917,CHA,KCA,CHI12,1,6,7
CHA200209180,2002,20918,CHA,KCA,CHI12,1,3,4
CHA200209190,2002,20919,CHA,KCA,CHI12,2,1,3
CHA200209200,2002,20920,CHA,MIN,CHI12,2,10,12
CHA200209210,2002,20921,CHA,MIN,CHI12,4,14,18
CHA200209220,2002,20922,CHA,MIN,CHI12,2,8,10
CHA200209240,2002,20924,CHA,BOS,CHI12,4,2,6
CHA200209250,2002,20925,CHA,BOS,CHI12,2,7,9
CHA200209260,2002,20926,CHA,BOS,CHI12,2,3,5
CHA200304040,2003,30404,CHA,DET,CHI12,2,5,7
CHA200304050,2003,30405,CHA,DET,CHI12,0,7,7
CHA200304060,2003,30406,CHA,DET,CHI12,2,10,12
CHA200304150,2003,30415,CHA,KCA,CHI12,8,5,13
CHA200304160,2003,30416,CHA,KCA,CHI12,3,4,7
CHA200304170,2003,30417,CHA,KCA,CHI12,2,8,10
CHA200304180,2003,30418,CHA,CLE,CHI12,3,5,8
CHA200304190,2003,30419,CHA,CLE,CHI12,3,12,15
CHA200304200,2003,30420,CHA,CLE,CHI12,7,4,11
CHA200304210,2003,30421,CHA,CLE,CHI12,9,2,11
CHA200304250,2003,30425,CHA,MIN,CHI12,6,1,7
CHA200304260,2003,30426,CHA,MIN,CHI12,4,7,11
CHA200304270,2003,30427,CHA,MIN,CHI12,1,3,4
CHA200304290,2003,30429,CHA,OAK,CHI12,3,2,5
CHA200304300,2003,30430,CHA,OAK,CHI12,4,1,5
CHA200305010,2003,30501,CHA,OAK,CHI12,5,7,12
CHA200305020,2003,30502,CHA,SEA,CHI12,9,2,11
CHA200305030,2003,30503,CHA,SEA,CHI12,12,2,14
CHA200305040,2003,30504,CHA,SEA,CHI12,5,1,6
CHA200305130,2003,30513,CHA,BAL,CHI12,0,1,1
CHA200305140,2003,30514,CHA,BAL,CHI12,1,5,6
CHA200305150,2003,30515,CHA,BAL,CHI12,2,8,10
CHA200305190,2003,30519,CHA,TOR,CHI12,12,2,14
CHA200305200,2003,30520,CHA,TOR,CHI12,1,4,5
CHA200305210,2003,30521,CHA,TOR,CHI12,5,6,11
CHA200305230,2003,30523,CHA,DET,CHI12,3,2,5
CHA200305240,2003,30524,CHA,DET,CHI12,1,0,1
CHA200305250,2003,30525,CHA,DET,CHI12,5,8,13
CHA200306100,2003,30610,CHA,SFN,CHI12,3,5,8
CHA200306110,2003,30611,CHA,SFN,CHI12,11,4,15
CHA200306120,2003,30612,CHA,SFN,CHI12,8,4,12
CHA200306130,2003,30613,CHA,SDN,CHI12,3,5,8
CHA200306140,2003,30614,CHA,SDN,CHI12,5,6,11
CHA200306150,2003,30615,CHA,SDN,CHI12,1,0,1
CHA200306160,2003,30616,CHA,BOS,CHI12,2,4,6
CHA200306170,2003,30617,CHA,BOS,CHI12,7,4,11
CHA200306180,2003,30618,CHA,BOS,CHI12,1,3,4
CHA200306190,2003,30619,CHA,BOS,CHI12,4,3,7
CHA200306270,2003,30627,CHA,CHN,CHI12,3,4,7
CHA200306280,2003,30628,CHA,CHN,CHI12,6,7,13
CHA200306290,2003,30629,CHA,CHN,CHI12,5,2,7
CHA200306300,2003,30630,CHA,MIN,CHI12,3,10,13
CHA200307010,2003,30701,CHA,MIN,CHI12,1,6,7
CHA200307020,2003,30702,CHA,MIN,CHI12,6,8,14
CHA200307170,2003,30717,CHA,DET,CHI12,10,9,19
CHA200307180,2003,30718,CHA,DET,CHI12,5,7,12
CHA200307190,2003,30719,CHA,DET,CHI12,2,6,8
CHA200307200,2003,30720,CHA,DET,CHI12,1,10,11
CHA200307210,2003,30721,CHA,CLE,CHI12,3,4,7
CHA200307220,2003,30722,CHA,CLE,CHI12,2,5,7
CHA200307250,2003,30725,CHA,TBA,CHI12,2,7,9
CHA200307260,2003,30726,CHA,TBA,CHI12,10,6,16
CHA200307270,2003,30727,CHA,TBA,CHI12,1,9,10
CHA200308040,2003,30804,CHA,KCA,CHI12,13,9,22
CHA200308050,2003,30805,CHA,KCA,CHI12,4,5,9
CHA200308060,2003,30806,CHA,KCA,CHI12,3,4,7
CHA200308080,2003,30808,CHA,OAK,CHI12,2,3,5
CHA200308090,2003,30809,CHA,OAK,CHI12,7,2,9
CHA200308100,2003,30810,CHA,OAK,CHI12,1,5,6
CHA200308180,2003,30818,CHA,ANA,CHI12,2,4,6
CHA200308190,2003,30819,CHA,ANA,CHI12,2,5,7
CHA200308200,2003,30820,CHA,ANA,CHI12,3,5,8
CHA200308210,2003,30821,CHA,TEX,CHI12,3,7,10
CHA200308220,2003,30822,CHA,TEX,CHI12,1,7,8
CHA200308230,2003,30823,CHA,TEX,CHI12,2,13,15
CHA200308240,2003,30824,CHA,TEX,CHI12,5,0,5
CHA200309020,2003,30902,CHA,BOS,CHI12,2,1,3
CHA200309030,2003,30903,CHA,BOS,CHI12,5,4,9
CHA200309050,2003,30905,CHA,CLE,CHI12,3,5,8
CHA200309060,2003,30906,CHA,CLE,CHI12,5,8,13
CHA200309070,2003,30907,CHA,CLE,CHI12,3,7,10
CHA200309080,2003,30908,CHA,MIN,CHI12,2,5,7
CHA200309090,2003,30909,CHA,MIN,CHI12,6,8,14
CHA200309100,2003,30910,CHA,MIN,CHI12,4,1,5
CHA200309110,2003,30911,CHA,MIN,CHI12,5,2,7
CHA200309190,2003,30919,CHA,KCA,CHI12,5,8,13
CHA200309200,2003,30920,CHA,KCA,CHI12,7,1,8
CHA200309210,2003,30921,CHA,KCA,CHI12,10,4,14
CHA200309220,2003,30922,CHA,NYA,CHI12,3,6,9
CHA200309230,2003,30923,CHA,NYA,CHI12,7,0,7
CHA200309240,2003,30924,CHA,NYA,CHI12,4,9,13
CHA200404130,2004,40413,CHA,KCA,CHI12,5,12,17
CHA200404140,2004,40414,CHA,KCA,CHI12,9,10,19
CHA200404150,2004,40415,CHA,KCA,CHI12,5,6,11
CHA200404200,2004,40420,CHA,NYA,CHI12,11,8,19
CHA200404210,2004,40421,CHA,NYA,CHI12,3,1,4
CHA200404220,2004,40422,CHA,NYA,CHI12,3,4,7
CHA200404230,2004,40423,CHA,TBA,CHI12,2,3,5
CHA200404240,2004,40424,CHA,TBA,CHI12,4,1,5
CHA200404250,2004,40425,CHA,TBA,CHI12,5,6,11
CHA200404270,2004,40427,CHA,CLE,CHI12,11,7,18
CHA200404280,2004,40428,CHA,CLE,CHI12,8,9,17
CHA200404290,2004,40429,CHA,TOR,CHI12,4,6,10
CHA200405011,2004,40501,CHA,TOR,CHI12,3,4,7
CHA200405012,2004,40501,CHA,TOR,CHI12,10,6,16
CHA200405020,2004,40502,CHA,TOR,CHI12,2,3,5
CHA200405110,2004,40511,CHA,BAL,CHI12,0,15,15
CHA200405131,2004,40513,CHA,BAL,CHI12,1,0,1
CHA200405132,2004,40513,CHA,BAL,CHI12,5,6,11
CHA200405140,2004,40514,CHA,MIN,CHI12,3,2,5
CHA200405150,2004,40515,CHA,MIN,CHI12,4,1,5
CHA200405160,2004,40516,CHA,MIN,CHI12,0,11,11
CHA200405250,2004,40525,CHA,TEX,CHI12,7,4,11
CHA200405260,2004,40526,CHA,TEX,CHI12,0,4,4
CHA200405270,2004,40527,CHA,TEX,CHI12,0,9,9
CHA200405280,2004,40528,CHA,ANA,CHI12,3,4,7
CHA200405290,2004,40529,CHA,ANA,CHI12,5,1,6
CHA200405300,2004,40530,CHA,ANA,CHI12,2,11,13
CHA200406080,2004,40608,CHA,PHI,CHI12,11,14,25
CHA200406090,2004,40609,CHA,PHI,CHI12,13,10,23
CHA200406110,2004,40611,CHA,ATL,CHI12,6,4,10
CHA200406120,2004,40612,CHA,ATL,CHI12,8,10,18
CHA200406130,2004,40613,CHA,ATL,CHI12,3,10,13
CHA200406210,2004,40621,CHA,CLE,CHI12,5,1,6
CHA200406220,2004,40622,CHA,CLE,CHI12,9,11,20
CHA200406230,2004,40623,CHA,CLE,CHI12,9,5,14
CHA200406240,2004,40624,CHA,CLE,CHI12,1,7,8
CHA200406250,2004,40625,CHA,CHN,CHI12,7,4,11
CHA200406260,2004,40626,CHA,CHN,CHI12,3,6,9
CHA200406270,2004,40627,CHA,CHN,CHI12,4,9,13
CHA200407060,2004,40706,CHA,ANA,CHI12,6,2,8
CHA200407070,2004,40707,CHA,ANA,CHI12,12,0,12
CHA200407080,2004,40708,CHA,ANA,CHI12,8,9,17
CHA200407090,2004,40709,CHA,SEA,CHI12,2,6,8
CHA200407100,2004,40710,CHA,SEA,CHI12,2,3,5
CHA200407110,2004,40711,CHA,SEA,CHI12,3,4,7
CHA200407230,2004,40723,CHA,DET,CHI12,4,6,10
CHA200407240,2004,40724,CHA,DET,CHI12,6,7,13
CHA200407250,2004,40725,CHA,DET,CHI12,9,2,11
CHA200407260,2004,40726,CHA,MIN,CHI12,6,2,8
CHA200407270,2004,40727,CHA,MIN,CHI12,7,3,10
CHA200407280,2004,40728,CHA,MIN,CHI12,5,4,9
CHA200408060,2004,40806,CHA,CLE,CHI12,3,2,5
CHA200408070,2004,40807,CHA,CLE,CHI12,6,5,11
CHA200408080,2004,40808,CHA,CLE,CHI12,2,3,5
CHA200408090,2004,40809,CHA,CLE,CHI12,13,11,24
CHA200408100,2004,40810,CHA,KCA,CHI12,3,9,12
CHA200408110,2004,40811,CHA,KCA,CHI12,4,2,6
CHA200408120,2004,40812,CHA,KCA,CHI12,2,3,5
CHA200408170,2004,40817,CHA,DET,CHI12,11,8,19
CHA200408180,2004,40818,CHA,DET,CHI12,2,9,11
CHA200408190,2004,40819,CHA,DET,CHI12,8,4,12
CHA200408200,2004,40820,CHA,BOS,CHI12,10,1,11
CHA200408210,2004,40821,CHA,BOS,CHI12,10,7,17
CHA200408220,2004,40822,CHA,BOS,CHI12,6,5,11
CHA200408300,2004,40830,CHA,PHI,CHI12,8,9,17
CHA200408310,2004,40831,CHA,OAK,CHI12,7,2,9
CHA200409010,2004,40901,CHA,OAK,CHI12,4,5,9
CHA200409020,2004,40902,CHA,OAK,CHI12,4,2,6
CHA200409030,2004,40903,CHA,SEA,CHI12,5,7,12
CHA200409040,2004,40904,CHA,SEA,CHI12,7,8,15
CHA200409050,2004,40905,CHA,SEA,CHI12,2,6,8
CHA200409170,2004,40917,CHA,DET,CHI12,11,10,21
CHA200409180,2004,40918,CHA,DET,CHI12,8,9,17
CHA200409190,2004,40919,CHA,DET,CHI12,1,6,7
CHA200409200,2004,40920,CHA,MIN,CHI12,8,2,10
CHA200409210,2004,40921,CHA,MIN,CHI12,6,8,14
CHA200409220,2004,40922,CHA,MIN,CHI12,6,7,13
CHA200409230,2004,40923,CHA,KCA,CHI12,6,7,13
CHA200409240,2004,40924,CHA,KCA,CHI12,8,6,14
CHA200409250,2004,40925,CHA,KCA,CHI12,1,5,6
CHA200409260,2004,40926,CHA,KCA,CHI12,1,5,6
CHA200504040,2005,50404,CHA,CLE,CHI12,0,1,1
CHA200504060,2005,50406,CHA,CLE,CHI12,3,4,7
CHA200504070,2005,50407,CHA,CLE,CHI12,11,5,16
CHA200504150,2005,50415,CHA,SEA,CHI12,4,6,10
CHA200504160,2005,50416,CHA,SEA,CHI12,1,2,3
CHA200504170,2005,50417,CHA,SEA,CHI12,5,4,9
CHA200504180,2005,50418,CHA,MIN,CHI12,4,5,9
CHA200504190,2005,50419,CHA,MIN,CHI12,1,3,4
CHA200504290,2005,50429,CHA,DET,CHI12,3,2,5
CHA200504300,2005,50430,CHA,DET,CHI12,3,4,7
CHA200505010,2005,50501,CHA,DET,CHI12,0,8,8
CHA200505030,2005,50503,CHA,KCA,CHI12,4,5,9
CHA200505040,2005,50504,CHA,KCA,CHI12,2,4,6
CHA200505050,2005,50505,CHA,KCA,CHI12,1,2,3
CHA200505120,2005,50512,CHA,BAL,CHI12,2,3,5
CHA200505130,2005,50513,CHA,BAL,CHI12,3,5,8
CHA200505140,2005,50514,CHA,BAL,CHI12,9,6,15
CHA200505150,2005,50515,CHA,BAL,CHI12,6,2,8
CHA200505160,2005,50516,CHA,TEX,CHI12,7,6,13
CHA200505170,2005,50517,CHA,TEX,CHI12,2,5,7
CHA200505180,2005,50518,CHA,TEX,CHI12,0,7,7
CHA200505300,2005,50530,CHA,ANA,CHI12,4,5,9
CHA200505310,2005,50531,CHA,ANA,CHI12,4,5,9
CHA200506010,2005,50601,CHA,ANA,CHI12,10,7,17
CHA200506030,2005,50603,CHA,CLE,CHI12,4,6,10
CHA200506040,2005,50604,CHA,CLE,CHI12,5,6,11
CHA200506050,2005,50605,CHA,CLE,CHI12,6,4,10
CHA200506130,2005,50613,CHA,ARI,CHI12,8,1,9
CHA200506140,2005,50614,CHA,ARI,CHI12,10,4,14
CHA200506150,2005,50615,CHA,ARI,CHI12,6,12,18
CHA200506170,2005,50617,CHA,LAN,CHI12,0,6,6
CHA200506180,2005,50618,CHA,LAN,CHI12,3,5,8
CHA200506190,2005,50619,CHA,LAN,CHI12,3,4,7
CHA200506200,2005,50620,CHA,KCA,CHI12,8,11,19
CHA200506210,2005,50621,CHA,KCA,CHI12,1,5,6
CHA200506220,2005,50622,CHA,KCA,CHI12,1,5,6
CHA200506240,2005,50624,CHA,CHN,CHI12,2,12,14
CHA200506250,2005,50625,CHA,CHN,CHI12,6,2,8
CHA200506260,2005,50626,CHA,CHN,CHI12,2,0,2
CHA200507040,2005,50704,CHA,TBA,CHI12,8,10,18
CHA200507050,2005,50705,CHA,TBA,CHI12,4,6,10
CHA200507060,2005,50706,CHA,TBA,CHI12,2,7,9
CHA200507080,2005,50708,CHA,OAK,CHI12,4,2,6
CHA200507090,2005,50709,CHA,OAK,CHI12,10,1,11
CHA200507100,2005,50710,CHA,OAK,CHI12,9,8,17
CHA200507180,2005,50718,CHA,DET,CHI12,5,7,12
CHA200507190,2005,50719,CHA,DET,CHI12,7,1,8
CHA200507200,2005,50720,CHA,DET,CHI12,8,6,14
CHA200507210,2005,50721,CHA,BOS,CHI12,6,5,11
CHA200507220,2005,50722,CHA,BOS,CHI12,4,8,12
CHA200507230,2005,50723,CHA,BOS,CHI12,3,0,3
CHA200507240,2005,50724,CHA,BOS,CHI12,4,6,10
CHA200508020,2005,50802,CHA,TOR,CHI12,7,3,10
CHA200508030,2005,50803,CHA,TOR,CHI12,4,3,7
CHA200508040,2005,50804,CHA,TOR,CHI12,4,5,9
CHA200508050,2005,50805,CHA,SEA,CHI12,4,2,6
CHA200508060,2005,50806,CHA,SEA,CHI12,2,4,6
CHA200508070,2005,50807,CHA,SEA,CHI12,1,3,4
CHA200508150,2005,50815,CHA,MIN,CHI12,4,2,6
CHA200508160,2005,50816,CHA,MIN,CHI12,9,4,13
CHA200508170,2005,50817,CHA,MIN,CHI12,5,1,6
CHA200508190,2005,50819,CHA,NYA,CHI12,3,1,4
CHA200508200,2005,50820,CHA,NYA,CHI12,5,0,5
CHA200508210,2005,50821,CHA,NYA,CHI12,2,6,8
CHA200509010,2005,50901,CHA,DET,CHI12,3,12,15
CHA200509020,2005,50902,CHA,DET,CHI12,1,9,10
CHA200509030,2005,50903,CHA,DET,CHI12,2,6,8
CHA200509040,2005,50904,CHA,DET,CHI12,0,2,2
CHA200509060,2005,50906,CHA,KCA,CHI12,5,6,11
CHA200509070,2005,50907,CHA,KCA,CHI12,0,1,1
CHA200509080,2005,50908,CHA,KCA,CHI12,4,2,6
CHA200509090,2005,50909,CHA,ANA,CHI12,6,5,11
CHA200509100,2005,50910,CHA,ANA,CHI12,10,5,15
CHA200509110,2005,50911,CHA,ANA,CHI12,6,1,7
CHA200509190,2005,50919,CHA,CLE,CHI12,7,5,12
CHA200509200,2005,50920,CHA,CLE,CHI12,6,7,13
CHA200509210,2005,50921,CHA,CLE,CHI12,8,0,8
CHA200509220,2005,50922,CHA,MIN,CHI12,4,1,5
CHA200509230,2005,50923,CHA,MIN,CHI12,1,3,4
CHA200509240,2005,50924,CHA,MIN,CHI12,1,8,9
CHA200509250,2005,50925,CHA,MIN,CHI12,1,4,5
CHA200510040,2005,51004,CHA,BOS,CHI12,2,14,16
CHA200510050,2005,51005,CHA,BOS,CHI12,4,5,9
CHA200510110,2005,51011,CHA,ANA,CHI12,3,2,5
CHA200510120,2005,51012,CHA,ANA,CHI12,1,2,3
CHA200510220,2005,51022,CHA,HOU,CHI12,3,5,8
CHA200510230,2005,51023,CHA,HOU,CHI12,6,7,13
CHA200604020,2006,60402,CHA,CLE,CHI12,4,10,14
CHA200604040,2006,60404,CHA,CLE,CHI12,8,2,10
CHA200604050,2006,60405,CHA,CLE,CHI12,4,3,7
CHA200604140,2006,60414,CHA,TOR,CHI12,13,7,20
CHA200604150,2006,60415,CHA,TOR,CHI12,2,4,6
CHA200604160,2006,60416,CHA,TOR,CHI12,4,6,10
CHA200604170,2006,60417,CHA,KCA,CHI12,0,9,9
CHA200604180,2006,60418,CHA,KCA,CHI12,1,4,5
CHA200604190,2006,60419,CHA,KCA,CHI12,0,4,4
CHA200604210,2006,60421,CHA,MIN,CHI12,1,7,8
CHA200604220,2006,60422,CHA,MIN,CHI12,2,9,11
CHA200604230,2006,60423,CHA,MIN,CHI12,3,7,10
CHA200605030,2006,60503,CHA,SEA,CHI12,5,6,11
CHA200605040,2006,60504,CHA,SEA,CHI12,1,4,5
CHA200605050,2006,60505,CHA,KCA,CHI12,5,4,9
CHA200605060,2006,60506,CHA,KCA,CHI12,2,9,11
CHA200605070,2006,60507,CHA,KCA,CHI12,2,3,5
CHA200605090,2006,60509,CHA,ANA,CHI12,1,9,10
CHA200605100,2006,60510,CHA,ANA,CHI12,12,5,17
CHA200605190,2006,60519,CHA,CHN,CHI12,1,6,7
CHA200605200,2006,60520,CHA,CHN,CHI12,0,7,7
CHA200605210,2006,60521,CHA,CHN,CHI12,7,4,11
CHA200605220,2006,60522,CHA,OAK,CHI12,4,5,9
CHA200605230,2006,60523,CHA,OAK,CHI12,3,9,12
CHA200605240,2006,60524,CHA,OAK,CHI12,2,3,5
CHA200606020,2006,60602,CHA,TEX,CHI12,4,3,7
CHA200606030,2006,60603,CHA,TEX,CHI12,6,8,14
CHA200606040,2006,60604,CHA,TEX,CHI12,10,2,12
CHA200606060,2006,60606,CHA,DET,CHI12,3,4,7
CHA200606070,2006,60607,CHA,DET,CHI12,3,4,7
CHA200606080,2006,60608,CHA,DET,CHI12,6,2,8
CHA200606090,2006,60609,CHA,CLE,CHI12,4,5,9
CHA200606100,2006,60610,CHA,CLE,CHI12,3,4,7
CHA200606110,2006,60611,CHA,CLE,CHI12,10,8,18
CHA200606200,2006,60620,CHA,SLN,CHI12,6,20,26
CHA200606210,2006,60621,CHA,SLN,CHI12,5,13,18
CHA200606220,2006,60622,CHA,SLN,CHI12,0,1,1
CHA200606230,2006,60623,CHA,HOU,CHI12,4,7,11
CHA200606240,2006,60624,CHA,HOU,CHI12,5,6,11
CHA200606250,2006,60625,CHA,HOU,CHI12,10,9,19
CHA200607030,2006,60703,CHA,BAL,CHI12,8,1,9
CHA200607040,2006,60704,CHA,BAL,CHI12,0,13,13
CHA200607050,2006,60705,CHA,BAL,CHI12,2,4,6
CHA200607060,2006,60706,CHA,BAL,CHI12,8,11,19
CHA200607070,2006,60707,CHA,BOS,CHI12,7,2,9
CHA200607080,2006,60708,CHA,BOS,CHI12,9,6,15
CHA200607090,2006,60709,CHA,BOS,CHI12,5,6,11
CHA200607210,2006,60721,CHA,TEX,CHI12,10,3,13
CHA200607220,2006,60722,CHA,TEX,CHI12,3,1,4
CHA200607230,2006,60723,CHA,TEX,CHI12,0,5,5
CHA200607240,2006,60724,CHA,MIN,CHI12,7,4,11
CHA200607250,2006,60725,CHA,MIN,CHI12,4,3,7
CHA200607260,2006,60726,CHA,MIN,CHI12,7,4,11
CHA200608070,2006,60807,CHA,ANA,CHI12,6,3,9
CHA200608080,2006,60808,CHA,NYA,CHI12,5,6,11
CHA200608090,2006,60809,CHA,NYA,CHI12,7,6,13
CHA200608100,2006,60810,CHA,NYA,CHI12,4,5,9
CHA200608110,2006,60811,CHA,DET,CHI12,0,5,5
CHA200608120,2006,60812,CHA,DET,CHI12,3,4,7
CHA200608130,2006,60813,CHA,DET,CHI12,3,7,10
CHA200608140,2006,60814,CHA,KCA,CHI12,2,12,14
CHA200608150,2006,60815,CHA,KCA,CHI12,4,2,6
CHA200608160,2006,60816,CHA,KCA,CHI12,10,4,14
CHA200608170,2006,60817,CHA,KCA,CHI12,4,5,9
CHA200608250,2006,60825,CHA,MIN,CHI12,5,4,9
CHA200608260,2006,60826,CHA,MIN,CHI12,8,7,15
CHA200608270,2006,60827,CHA,MIN,CHI12,1,6,7
CHA200608290,2006,60829,CHA,TBA,CHI12,9,12,21
CHA200608300,2006,60830,CHA,TBA,CHI12,4,5,9
CHA200608310,2006,60831,CHA,TBA,CHI12,5,3,8
CHA200609070,2006,60907,CHA,CLE,CHI12,9,1,10
CHA200609080,2006,60908,CHA,CLE,CHI12,6,7,13
CHA200609090,2006,60909,CHA,CLE,CHI12,8,10,18
CHA200609100,2006,60910,CHA,CLE,CHI12,5,2,7
CHA200609180,2006,60918,CHA,DET,CHI12,8,2,10
CHA200609190,2006,60919,CHA,DET,CHI12,0,7,7
CHA200609200,2006,60920,CHA,DET,CHI12,6,2,8
CHA200609210,2006,60921,CHA,SEA,CHI12,9,0,9
CHA200609220,2006,60922,CHA,SEA,CHI12,11,6,17
CHA200609230,2006,60923,CHA,SEA,CHI12,7,11,18
CHA200609240,2006,60924,CHA,SEA,CHI12,7,12,19
CHA200704020,2007,70402,CHA,CLE,CHI12,12,5,17
CHA200704040,2007,70404,CHA,CLE,CHI12,8,7,15
CHA200704050,2007,70405,CHA,CLE,CHI12,3,4,7
CHA200704070,2007,70407,CHA,MIN,CHI12,0,3,3
CHA200704080,2007,70408,CHA,MIN,CHI12,3,1,4
CHA200704170,2007,70417,CHA,TEX,CHI12,8,1,9
CHA200704180,2007,70418,CHA,TEX,CHI12,0,6,6
CHA200704190,2007,70419,CHA,TEX,CHI12,4,6,10
CHA200704250,2007,70425,CHA,DET,CHI12,6,2,8
CHA200704270,2007,70427,CHA,ANA,CHI12,3,7,10
CHA200704280,2007,70428,CHA,ANA,CHI12,3,0,3
CHA200704290,2007,70429,CHA,ANA,CHI12,5,2,7
CHA200705110,2007,70511,CHA,KCA,CHI12,1,2,3
CHA200705120,2007,70512,CHA,KCA,CHI12,4,5,9
CHA200705130,2007,70513,CHA,KCA,CHI12,11,1,12
CHA200705161,2007,70516,CHA,NYA,CHI12,3,5,8
CHA200705162,2007,70516,CHA,NYA,CHI12,8,1,9
CHA200705170,2007,70517,CHA,NYA,CHI12,1,4,5
CHA200705210,2007,70521,CHA,OAK,CHI12,5,8,13
CHA200705220,2007,70522,CHA,OAK,CHI12,4,10,14
CHA200705230,2007,70523,CHA,OAK,CHI12,4,0,4
CHA200705250,2007,70525,CHA,TBA,CHI12,4,5,9
CHA200705270,2007,70527,CHA,TBA,CHI12,11,5,16
CHA200706040,2007,70604,CHA,NYA,CHI12,4,6,10
CHA200706050,2007,70605,CHA,NYA,CHI12,7,3,10
CHA200706060,2007,70606,CHA,NYA,CHI12,5,1,6
CHA200706070,2007,70607,CHA,NYA,CHI12,10,3,13
CHA200706080,2007,70608,CHA,HOU,CHI12,5,2,7
CHA200706090,2007,70609,CHA,HOU,CHI12,3,2,5
CHA200706100,2007,70610,CHA,HOU,CHI12,3,6,9
CHA200706180,2007,70618,CHA,FLO,CHI12,6,10,16
CHA200706190,2007,70619,CHA,FLO,CHI12,7,5,12
CHA200706200,2007,70620,CHA,FLO,CHI12,5,4,9
CHA200706220,2007,70622,CHA,CHN,CHI12,5,1,6
CHA200706230,2007,70623,CHA,CHN,CHI12,2,1,3
CHA200706240,2007,70624,CHA,CHN,CHI12,3,0,3
CHA200707020,2007,70702,CHA,BAL,CHI12,7,6,13
CHA200707030,2007,70703,CHA,BAL,CHI12,1,5,6
CHA200707040,2007,70704,CHA,BAL,CHI12,9,6,15
CHA200707050,2007,70705,CHA,BAL,CHI12,6,11,17
CHA200707061,2007,70706,CHA,MIN,CHI12,20,14,34
CHA200707062,2007,70706,CHA,MIN,CHI12,12,0,12
CHA200707070,2007,70707,CHA,MIN,CHI12,1,3,4
CHA200707080,2007,70708,CHA,MIN,CHI12,3,6,9
CHA200707230,2007,70723,CHA,DET,CHI12,9,6,15
CHA200707241,2007,70724,CHA,DET,CHI12,3,5,8
CHA200707242,2007,70724,CHA,DET,CHI12,7,8,15
CHA200707250,2007,70725,CHA,DET,CHI12,13,9,22
CHA200707260,2007,70726,CHA,DET,CHI12,3,4,7
CHA200707270,2007,70727,CHA,TOR,CHI12,3,4,7
CHA200707280,2007,70728,CHA,TOR,CHI12,0,2,2
CHA200707290,2007,70729,CHA,TOR,CHI12,4,1,5
CHA200708070,2007,70807,CHA,CLE,CHI12,2,1,3
CHA200708080,2007,70808,CHA,CLE,CHI12,4,6,10
CHA200708090,2007,70809,CHA,CLE,CHI12,7,5,12
CHA200708100,2007,70810,CHA,SEA,CHI12,3,5,8
CHA200708110,2007,70811,CHA,SEA,CHI12,7,6,13
CHA200708120,2007,70812,CHA,SEA,CHI12,6,0,6
CHA200708200,2007,70820,CHA,KCA,CHI12,3,4,7
CHA200708210,2007,70821,CHA,KCA,CHI12,2,5,7
CHA200708220,2007,70822,CHA,KCA,CHI12,7,6,13
CHA200708241,2007,70824,CHA,BOS,CHI12,11,3,14
CHA200708242,2007,70824,CHA,BOS,CHI12,10,1,11
CHA200708250,2007,70825,CHA,BOS,CHI12,14,2,16
CHA200708260,2007,70826,CHA,BOS,CHI12,11,1,12
CHA200708270,2007,70827,CHA,TBA,CHI12,4,5,9
CHA200709070,2007,70907,CHA,MIN,CHI12,10,11,21
CHA200709080,2007,70908,CHA,MIN,CHI12,7,8,15
CHA200709090,2007,70909,CHA,MIN,CHI12,5,2,7
CHA200709100,2007,70910,CHA,CLE,CHI12,6,2,8
CHA200709110,2007,70911,CHA,CLE,CHI12,8,3,11
CHA200709120,2007,70912,CHA,CLE,CHI12,4,7,11
CHA200709140,2007,70914,CHA,ANA,CHI12,3,5,8
CHA200709150,2007,70915,CHA,ANA,CHI12,2,1,3
CHA200709160,2007,70916,CHA,ANA,CHI12,7,9,16
CHA200709250,2007,70925,CHA,KCA,CHI12,9,5,14
CHA200709260,2007,70926,CHA,KCA,CHI12,0,3,3
CHA200709270,2007,70927,CHA,KCA,CHI12,0,10,10
CHA200709280,2007,70928,CHA,DET,CHI12,2,5,7
CHA200709290,2007,70929,CHA,DET,CHI12,2,3,5
CHA200709300,2007,70930,CHA,DET,CHI12,13,3,16
CHA200804070,2008,80407,CHA,MIN,CHI12,4,7,11
CHA200804090,2008,80409,CHA,MIN,CHI12,12,5,17
CHA200804110,2008,80411,CHA,DET,CHI12,5,2,7
CHA200804120,2008,80412,CHA,DET,CHI12,0,7,7
CHA200804130,2008,80413,CHA,DET,CHI12,0,11,11
CHA200804140,2008,80414,CHA,OAK,CHI12,2,1,3
CHA200804150,2008,80415,CHA,OAK,CHI12,1,4,5
CHA200804220,2008,80422,CHA,NYA,CHI12,9,5,14
CHA200804230,2008,80423,CHA,NYA,CHI12,6,4,10
CHA200804240,2008,80424,CHA,NYA,CHI12,6,7,13
CHA200804261,2008,80426,CHA,BAL,CHI12,5,1,6
CHA200804262,2008,80426,CHA,BAL,CHI12,5,6,11
CHA200804270,2008,80427,CHA,BAL,CHI12,1,6,7
CHA200804280,2008,80428,CHA,BAL,CHI12,4,3,7
CHA200805060,2008,80506,CHA,MIN,CHI12,1,7,8
CHA200805070,2008,80507,CHA,MIN,CHI12,13,1,14
CHA200805080,2008,80508,CHA,MIN,CHI12,2,6,8
CHA200805200,2008,80520,CHA,CLE,CHI12,1,4,5
CHA200805210,2008,80521,CHA,CLE,CHI12,2,7,9
CHA200805220,2008,80522,CHA,CLE,CHI12,1,3,4
CHA200805230,2008,80523,CHA,ANA,CHI12,3,1,4
CHA200805240,2008,80524,CHA,ANA,CHI12,2,0,2
CHA200805250,2008,80525,CHA,ANA,CHI12,2,3,5
CHA200806030,2008,80603,CHA,KCA,CHI12,5,9,14
CHA200806040,2008,80604,CHA,KCA,CHI12,4,6,10
CHA200806050,2008,80605,CHA,KCA,CHI12,2,6,8
CHA200806060,2008,80606,CHA,MIN,CHI12,6,10,16
CHA200806070,2008,80607,CHA,MIN,CHI12,2,11,13
CHA200806080,2008,80608,CHA,MIN,CHI12,2,12,14
CHA200806090,2008,80609,CHA,MIN,CHI12,5,7,12
CHA200806130,2008,80613,CHA,COL,CHI12,4,5,9
CHA200806140,2008,80614,CHA,COL,CHI12,2,0,2
CHA200806150,2008,80615,CHA,COL,CHI12,5,3,8
CHA200806170,2008,80617,CHA,PIT,CHI12,5,16,21
CHA200806180,2008,80618,CHA,PIT,CHI12,2,8,10
CHA200806190,2008,80619,CHA,PIT,CHI12,8,13,21
CHA200806270,2008,80627,CHA,CHN,CHI12,3,10,13
CHA200806280,2008,80628,CHA,CHN,CHI12,5,6,11
CHA200806290,2008,80629,CHA,CHN,CHI12,1,5,6
CHA200806300,2008,80630,CHA,CLE,CHI12,7,9,16
CHA200807010,2008,80701,CHA,CLE,CHI12,2,3,5
CHA200807020,2008,80702,CHA,CLE,CHI12,5,6,11
CHA200807030,2008,80703,CHA,OAK,CHI12,3,2,5
CHA200807040,2008,80704,CHA,OAK,CHI12,7,1,8
CHA200807050,2008,80705,CHA,OAK,CHI12,1,6,7
CHA200807060,2008,80706,CHA,OAK,CHI12,3,4,7
CHA200807180,2008,80718,CHA,KCA,CHI12,5,9,14
CHA200807190,2008,80719,CHA,KCA,CHI12,9,1,10
CHA200807200,2008,80720,CHA,KCA,CHI12,8,7,15
CHA200807210,2008,80721,CHA,TEX,CHI12,6,1,7
CHA200807220,2008,80722,CHA,TEX,CHI12,2,10,12
CHA200807230,2008,80723,CHA,TEX,CHI12,8,10,18
CHA200808050,2008,80805,CHA,DET,CHI12,8,10,18
CHA200808060,2008,80806,CHA,DET,CHI12,1,5,6
CHA200808070,2008,80807,CHA,DET,CHI12,8,3,11
CHA200808080,2008,80808,CHA,BOS,CHI12,3,5,8
CHA200808090,2008,80809,CHA,BOS,CHI12,6,2,8
CHA200808100,2008,80810,CHA,BOS,CHI12,5,6,11
CHA200808110,2008,80811,CHA,BOS,CHI12,5,1,6
CHA200808120,2008,80812,CHA,KCA,CHI12,0,9,9
CHA200808130,2008,80813,CHA,KCA,CHI12,0,4,4
CHA200808140,2008,80814,CHA,KCA,CHI12,2,9,11
CHA200808180,2008,80818,CHA,SEA,CHI12,5,13,18
CHA200808190,2008,80819,CHA,SEA,CHI12,0,5,5
CHA200808200,2008,80820,CHA,SEA,CHI12,3,15,18
CHA200808220,2008,80822,CHA,TBA,CHI12,9,4,13
CHA200808230,2008,80823,CHA,TBA,CHI12,5,3,8
CHA200808240,2008,80824,CHA,TBA,CHI12,5,6,11
CHA200809050,2008,80905,CHA,ANA,CHI12,2,10,12
CHA200809060,2008,80906,CHA,ANA,CHI12,6,7,13
CHA200809070,2008,80907,CHA,ANA,CHI12,3,2,5
CHA200809091,2008,80909,CHA,TOR,CHI12,3,1,4
CHA200809092,2008,80909,CHA,TOR,CHI12,8,2,10
CHA200809100,2008,80910,CHA,TOR,CHI12,5,6,11
CHA200809110,2008,80911,CHA,TOR,CHI12,6,4,10
CHA200809141,2008,80914,CHA,DET,CHI12,2,4,6
CHA200809142,2008,80914,CHA,DET,CHI12,7,11,18
CHA200809260,2008,80926,CHA,CLE,CHI12,11,8,19
CHA200809270,2008,80927,CHA,CLE,CHI12,12,6,18
CHA200809280,2008,80928,CHA,CLE,CHI12,1,5,6
CHA200809290,2008,80929,CHA,DET,CHI12,2,8,10
CHA200809300,2008,80930,CHA,MIN,CHI12,0,1,1
CHA200810050,2008,81005,CHA,TBA,CHI12,3,5,8
CHA200810060,2008,81006,CHA,TBA,CHI12,6,2,8
CHA200904070,2009,90407,CHA,KCA,CHI12,2,4,6
CHA200904080,2009,90408,CHA,KCA,CHI12,2,0,2
CHA200904090,2009,90409,CHA,KCA,CHI12,2,1,3
CHA200904100,2009,90410,CHA,MIN,CHI12,12,5,17
CHA200904110,2009,90411,CHA,MIN,CHI12,0,8,8
CHA200904120,2009,90412,CHA,MIN,CHI12,1,6,7
CHA200904240,2009,90424,CHA,TOR,CHI12,14,0,14
CHA200904250,2009,90425,CHA,TOR,CHI12,2,10,12
CHA200904260,2009,90426,CHA,TOR,CHI12,4,3,7
CHA200904281,2009,90428,CHA,SEA,CHI12,1,2,3
CHA200904282,2009,90428,CHA,SEA,CHI12,9,1,10
CHA200904290,2009,90429,CHA,SEA,CHI12,3,6,9
CHA200905070,2009,90507,CHA,DET,CHI12,0,6,6
CHA200905080,2009,90508,CHA,TEX,CHI12,6,0,6
CHA200905090,2009,90509,CHA,TEX,CHI12,2,3,5
CHA200905100,2009,90510,CHA,TEX,CHI12,7,1,8
CHA200905190,2009,90519,CHA,MIN,CHI12,2,6,8
CHA200905200,2009,90520,CHA,MIN,CHI12,4,7,11
CHA200905210,2009,90521,CHA,MIN,CHI12,20,1,21
CHA200905220,2009,90522,CHA,PIT,CHI12,0,2,2
CHA200905230,2009,90523,CHA,PIT,CHI12,0,4,4
CHA200905240,2009,90524,CHA,PIT,CHI12,4,3,7
CHA200906010,2009,90601,CHA,OAK,CHI12,2,6,8
CHA200906020,2009,90602,CHA,OAK,CHI12,5,0,5
CHA200906030,2009,90603,CHA,OAK,CHI12,5,3,8
CHA200906040,2009,90604,CHA,OAK,CHI12,7,0,7
CHA200906050,2009,90605,CHA,CLE,CHI12,6,0,6
CHA200906060,2009,90606,CHA,CLE,CHI12,2,4,6
CHA200906070,2009,90607,CHA,CLE,CHI12,8,4,12
CHA200906081,2009,90608,CHA,DET,CHI12,5,4,9
CHA200906082,2009,90608,CHA,DET,CHI12,1,6,7
CHA200906090,2009,90609,CHA,DET,CHI12,7,6,13
CHA200906100,2009,90610,CHA,DET,CHI12,2,1,3
CHA200906110,2009,90611,CHA,DET,CHI12,3,4,7
CHA200906230,2009,90623,CHA,LAN,CHI12,5,2,7
CHA200906240,2009,90624,CHA,LAN,CHI12,7,10,17
CHA200906250,2009,90625,CHA,LAN,CHI12,5,6,11
CHA200906260,2009,90626,CHA,CHN,CHI12,5,4,9
CHA200906270,2009,90627,CHA,CHN,CHI12,7,8,15
CHA200906280,2009,90628,CHA,CHN,CHI12,0,6,6
CHA200907070,2009,90707,CHA,CLE,CHI12,6,10,16
CHA200907080,2009,90708,CHA,CLE,CHI12,1,5,6
CHA200907090,2009,90709,CHA,CLE,CHI12,10,8,18
CHA200907170,2009,90717,CHA,BAL,CHI12,8,12,20
CHA200907180,2009,90718,CHA,BAL,CHI12,3,4,7
CHA200907190,2009,90719,CHA,BAL,CHI12,10,2,12
CHA200907200,2009,90720,CHA,TBA,CHI12,3,4,7
CHA200907210,2009,90721,CHA,TBA,CHI12,3,2,5
CHA200907220,2009,90722,CHA,TBA,CHI12,3,4,7
CHA200907230,2009,90723,CHA,TBA,CHI12,0,5,5
CHA200907300,2009,90730,CHA,NYA,CHI12,2,3,5
CHA200907310,2009,90731,CHA,NYA,CHI12,5,10,15
CHA200908010,2009,90801,CHA,NYA,CHI12,4,14,18
CHA200908020,2009,90802,CHA,NYA,CHI12,8,5,13
CHA200908040,2009,90804,CHA,ANA,CHI12,4,5,9
CHA200908050,2009,90805,CHA,ANA,CHI12,2,6,8
CHA200908060,2009,90806,CHA,ANA,CHI12,9,5,14
CHA200908070,2009,90807,CHA,CLE,CHI12,6,2,8
CHA200908080,2009,90808,CHA,CLE,CHI12,5,8,13
CHA200908090,2009,90809,CHA,CLE,CHI12,8,4,12
CHA200908170,2009,90817,CHA,KCA,CHI12,7,8,15
CHA200908180,2009,90818,CHA,KCA,CHI12,5,4,9
CHA200908190,2009,90819,CHA,KCA,CHI12,2,4,6
CHA200908210,2009,90821,CHA,BAL,CHI12,5,1,6
CHA200908220,2009,90822,CHA,BAL,CHI12,1,4,5
CHA200908230,2009,90823,CHA,BAL,CHI12,5,4,9
CHA200909040,2009,90904,CHA,BOS,CHI12,2,12,14
CHA200909050,2009,90905,CHA,BOS,CHI12,1,5,6
CHA200909060,2009,90906,CHA,BOS,CHI12,6,1,7
CHA200909070,2009,90907,CHA,BOS,CHI12,1,5,6
CHA200909080,2009,90908,CHA,OAK,CHI12,11,3,14
CHA200909090,2009,90909,CHA,OAK,CHI12,3,4,7
CHA200909180,2009,90918,CHA,KCA,CHI12,11,0,11
CHA200909190,2009,90919,CHA,KCA,CHI12,3,13,16
CHA200909200,2009,90920,CHA,KCA,CHI12,2,1,3
CHA200909210,2009,90921,CHA,MIN,CHI12,7,0,7
CHA200909220,2009,90922,CHA,MIN,CHI12,8,6,14
CHA200909230,2009,90923,CHA,MIN,CHI12,8,6,14
CHA200909250,2009,90925,CHA,DET,CHI12,0,2,2
CHA200909260,2009,90926,CHA,DET,CHI12,12,5,17
CHA200909270,2009,90927,CHA,DET,CHI12,4,8,12
CHN200003300,2000,330,CHN,NYN,TOK01,5,1,6
CHN200004100,2000,410,CHN,ATL,CHI11,3,4,7
CHN200004120,2000,412,CHN,ATL,CHI11,4,11,15
CHN200004130,2000,413,CHN,ATL,CHI11,2,3,5
CHN200004140,2000,414,CHN,FLO,CHI11,9,4,13
CHN200004150,2000,415,CHN,FLO,CHI11,2,4,6
CHN200004160,2000,416,CHN,FLO,CHI11,6,5,11
CHN200004170,2000,417,CHN,FLO,CHI11,6,5,11
CHN200004280,2000,428,CHN,ARI,CHI11,5,6,11
CHN200004290,2000,429,CHN,ARI,CHI11,7,4,11
CHN200004300,2000,430,CHN,ARI,CHI11,6,0,6
CHN200005020,2000,502,CHN,HOU,CHI11,1,11,12
CHN200005030,2000,503,CHN,HOU,CHI11,3,4,7
CHN200005040,2000,504,CHN,HOU,CHI11,6,2,8
CHN200005050,2000,505,CHN,PIT,CHI11,4,2,6
CHN200005060,2000,506,CHN,PIT,CHI11,11,9,20
CHN200005070,2000,507,CHN,PIT,CHI11,11,3,14
CHN200005080,2000,508,CHN,MIL,CHI11,11,12,23
CHN200005090,2000,509,CHN,MIL,CHI11,4,3,7
CHN200005100,2000,510,CHN,MIL,CHI11,8,9,17
CHN200005110,2000,511,CHN,MIL,CHI11,14,8,22
CHN200005160,2000,516,CHN,LAN,CHI11,6,5,11
CHN200005170,2000,517,CHN,LAN,CHI11,8,6,14
CHN200005190,2000,519,CHN,CIN,CHI11,1,4,5
CHN200005200,2000,520,CHN,CIN,CHI11,5,3,8
CHN200005210,2000,521,CHN,CIN,CHI11,2,4,6
CHN200005290,2000,529,CHN,ATL,CHI11,1,0,1
CHN200005300,2000,530,CHN,ATL,CHI11,5,2,7
CHN200006010,2000,601,CHN,ATL,CHI11,3,5,8
CHN200006020,2000,602,CHN,DET,CHI11,0,2,2
CHN200006030,2000,603,CHN,DET,CHI11,5,3,8
CHN200006040,2000,604,CHN,DET,CHI11,3,2,5
CHN200006050,2000,605,CHN,ARI,CHI11,3,4,7
CHN200006060,2000,606,CHN,ARI,CHI11,1,4,5
CHN200006070,2000,607,CHN,ARI,CHI11,4,9,13
CHN200006130,2000,613,CHN,NYN,CHI11,3,4,7
CHN200006140,2000,614,CHN,NYN,CHI11,10,8,18
CHN200006160,2000,616,CHN,MON,CHI11,8,9,17
CHN200006170,2000,617,CHN,MON,CHI11,0,1,1
CHN200006180,2000,618,CHN,MON,CHI11,4,3,7
CHN200007030,2000,703,CHN,PIT,CHI11,0,3,3
CHN200007040,2000,704,CHN,PIT,CHI11,10,4,14
CHN200007050,2000,705,CHN,PIT,CHI11,9,6,15
CHN200007070,2000,707,CHN,CHA,CHI11,4,2,6
CHN200007080,2000,708,CHN,CHA,CHI11,2,9,11
CHN200007090,2000,709,CHN,CHA,CHI11,6,9,15
CHN200007190,2000,719,CHN,PHI,CHI11,4,5,9
CHN200007200,2000,720,CHN,PHI,CHI11,3,2,5
CHN200007210,2000,721,CHN,MIL,CHI11,2,4,6
CHN200007220,2000,722,CHN,MIL,CHI11,2,3,5
CHN200007230,2000,723,CHN,MIL,CHI11,4,5,9
CHN200007280,2000,728,CHN,SFN,CHI11,2,0,2
CHN200007290,2000,729,CHN,SFN,CHI11,1,8,9
CHN200007300,2000,730,CHN,SFN,CHI11,1,3,4
CHN200007310,2000,731,CHN,COL,CHI11,0,2,2
CHN200008010,2000,801,CHN,COL,CHI11,2,1,3
CHN200008020,2000,802,CHN,COL,CHI11,2,3,5
CHN200008110,2000,811,CHN,CIN,CHI11,6,4,10
CHN200008120,2000,812,CHN,CIN,CHI11,3,0,3
CHN200008130,2000,813,CHN,CIN,CHI11,3,0,3
CHN200008140,2000,814,CHN,SLN,CHI11,3,7,10
CHN200008150,2000,815,CHN,SLN,CHI11,4,2,6
CHN200008160,2000,816,CHN,SLN,CHI11,5,1,6
CHN200008251,2000,825,CHN,LAN,CHI11,5,3,8
CHN200008252,2000,825,CHN,LAN,CHI11,3,1,4
CHN200008260,2000,826,CHN,LAN,CHI11,4,6,10
CHN200008270,2000,827,CHN,LAN,CHI11,7,6,13
CHN200008280,2000,828,CHN,SDN,CHI11,8,2,10
CHN200008290,2000,829,CHN,SDN,CHI11,6,7,13
CHN200008300,2000,830,CHN,SDN,CHI11,1,5,6
CHN200008310,2000,831,CHN,SDN,CHI11,11,5,16
CHN200009080,2000,908,CHN,HOU,CHI11,13,10,23
CHN200009090,2000,909,CHN,HOU,CHI11,14,4,18
CHN200009100,2000,910,CHN,HOU,CHI11,7,6,13
CHN200009220,2000,922,CHN,SLN,CHI11,4,5,9
CHN200009230,2000,923,CHN,SLN,CHI11,6,5,11
CHN200009240,2000,924,CHN,SLN,CHI11,5,10,15
CHN200009250,2000,925,CHN,PHI,CHI11,3,4,7
CHN200009260,2000,926,CHN,PHI,CHI11,10,4,14
CHN200009270,2000,927,CHN,PHI,CHI11,0,1,1
CHN200009280,2000,928,CHN,PHI,CHI11,4,2,6
CHN200104020,2001,10402,CHN,MON,CHI11,5,4,9
CHN200104040,2001,10404,CHN,MON,CHI11,3,2,5
CHN200104050,2001,10405,CHN,MON,CHI11,1,2,3
CHN200104130,2001,10413,CHN,PIT,CHI11,2,4,6
CHN200104140,2001,10414,CHN,PIT,CHI11,6,7,13
CHN200104150,2001,10415,CHN,PIT,CHI11,1,5,6
CHN200104170,2001,10417,CHN,PHI,CHI11,6,3,9
CHN200104181,2001,10418,CHN,PHI,CHI11,3,4,7
CHN200104182,2001,10418,CHN,PHI,CHI11,3,5,8
CHN200105010,2001,10501,CHN,SDN,CHI11,10,3,13
CHN200105020,2001,10502,CHN,SDN,CHI11,3,8,11
CHN200105030,2001,10503,CHN,SDN,CHI11,5,3,8
CHN200105040,2001,10504,CHN,LAN,CHI11,0,4,4
CHN200105050,2001,10505,CHN,LAN,CHI11,1,20,21
CHN200105060,2001,10506,CHN,LAN,CHI11,2,3,5
CHN200105150,2001,10515,CHN,HOU,CHI11,9,7,16
CHN200105160,2001,10516,CHN,HOU,CHI11,6,2,8
CHN200105170,2001,10517,CHN,HOU,CHI11,4,2,6
CHN200105180,2001,10518,CHN,ARI,CHI11,4,0,4
CHN200105190,2001,10519,CHN,ARI,CHI11,2,6,8
CHN200105200,2001,10520,CHN,ARI,CHI11,5,6,11
CHN200105220,2001,10522,CHN,CIN,CHI11,3,5,8
CHN200105230,2001,10523,CHN,CIN,CHI11,2,4,6
CHN200105240,2001,10524,CHN,CIN,CHI11,0,3,3
CHN200105250,2001,10525,CHN,MIL,CHI11,0,1,1
CHN200105270,2001,10527,CHN,MIL,CHI11,1,4,5
CHN200106050,2001,10605,CHN,SLN,CHI11,6,12,18
CHN200106060,2001,10606,CHN,SLN,CHI11,1,4,5
CHN200106070,2001,10607,CHN,SLN,CHI11,3,4,7
CHN200106150,2001,10615,CHN,MIN,CHI11,3,5,8
CHN200106160,2001,10616,CHN,MIN,CHI11,4,11,15
CHN200106170,2001,10617,CHN,MIN,CHI11,4,5,9
CHN200106220,2001,10622,CHN,MIL,CHI11,2,1,3
CHN200106230,2001,10623,CHN,MIL,CHI11,4,0,4
CHN200106240,2001,10624,CHN,MIL,CHI11,6,3,9
CHN200106250,2001,10625,CHN,NYN,CHI11,1,2,3
CHN200106260,2001,10626,CHN,NYN,CHI11,2,4,6
CHN200106270,2001,10627,CHN,NYN,CHI11,5,4,9
CHN200107120,2001,10712,CHN,CHA,CHI11,1,5,6
CHN200107130,2001,10713,CHN,CHA,CHI11,7,2,9
CHN200107140,2001,10714,CHN,CHA,CHI11,3,1,4
CHN200107150,2001,10715,CHN,KCA,CHI11,1,2,3
CHN200107160,2001,10716,CHN,KCA,CHI11,4,2,6
CHN200107170,2001,10717,CHN,KCA,CHI11,4,7,11
CHN200107240,2001,10724,CHN,PIT,CHI11,2,10,12
CHN200107250,2001,10725,CHN,PIT,CHI11,5,6,11
CHN200107260,2001,10726,CHN,SLN,CHI11,3,1,4
CHN200107270,2001,10727,CHN,SLN,CHI11,3,4,7
CHN200107280,2001,10728,CHN,SLN,CHI11,7,4,11
CHN200107290,2001,10729,CHN,SLN,CHI11,5,7,12
CHN200108070,2001,10807,CHN,COL,CHI11,4,5,9
CHN200108080,2001,10808,CHN,COL,CHI11,1,2,3
CHN200108090,2001,10809,CHN,COL,CHI11,14,5,19
CHN200108100,2001,10810,CHN,SFN,CHI11,3,9,12
CHN200108110,2001,10811,CHN,SFN,CHI11,9,4,13
CHN200108120,2001,10812,CHN,SFN,CHI11,7,6,13
CHN200108201,2001,10820,CHN,MIL,CHI11,4,7,11
CHN200108202,2001,10820,CHN,MIL,CHI11,10,2,12
CHN200108210,2001,10821,CHN,MIL,CHI11,3,1,4
CHN200108220,2001,10822,CHN,MIL,CHI11,3,16,19
CHN200108230,2001,10823,CHN,MIL,CHI11,8,1,9
CHN200108240,2001,10824,CHN,SLN,CHI11,10,8,18
CHN200108250,2001,10825,CHN,SLN,CHI11,4,6,10
CHN200108260,2001,10826,CHN,SLN,CHI11,1,6,7
CHN200108280,2001,10828,CHN,FLO,CHI11,4,3,7
CHN200108290,2001,10829,CHN,FLO,CHI11,1,5,6
CHN200108300,2001,10830,CHN,FLO,CHI11,4,5,9
CHN200109070,2001,10907,CHN,ATL,CHI11,3,2,5
CHN200109080,2001,10908,CHN,ATL,CHI11,5,3,8
CHN200109090,2001,10909,CHN,ATL,CHI11,9,5,14
CHN200109100,2001,10910,CHN,CIN,CHI11,2,8,10
CHN200109270,2001,10927,CHN,HOU,CHI11,6,5,11
CHN200109280,2001,10928,CHN,HOU,CHI11,2,6,8
CHN200109290,2001,10929,CHN,HOU,CHI11,2,6,8
CHN200109300,2001,10930,CHN,HOU,CHI11,6,7,13
CHN200110020,2001,11002,CHN,CIN,CHI11,5,4,9
CHN200110030,2001,11003,CHN,CIN,CHI11,7,13,20
CHN200110040,2001,11004,CHN,CIN,CHI11,0,2,2
CHN200110050,2001,11005,CHN,PIT,CHI11,3,2,5
CHN200110060,2001,11006,CHN,PIT,CHI11,2,13,15
CHN200110070,2001,11007,CHN,PIT,CHI11,4,3,7
CHN200204050,2002,20405,CHN,PIT,CHI11,2,1,3
CHN200204060,2002,20406,CHN,PIT,CHI11,6,1,7
CHN200204090,2002,20409,CHN,NYN,CHI11,0,2,2
CHN200204100,2002,20410,CHN,NYN,CHI11,3,2,5
CHN200204110,2002,20411,CHN,NYN,CHI11,3,2,5
CHN200204190,2002,20419,CHN,CIN,CHI11,2,5,7
CHN200204200,2002,20420,CHN,CIN,CHI11,6,1,7
CHN200204210,2002,20421,CHN,CIN,CHI11,5,3,8
CHN200204230,2002,20423,CHN,SFN,CHI11,12,4,16
CHN200204240,2002,20424,CHN,SFN,CHI11,4,10,14
CHN200204250,2002,20425,CHN,SFN,CHI11,1,2,3
CHN200204260,2002,20426,CHN,LAN,CHI11,10,0,10
CHN200204281,2002,20428,CHN,LAN,CHI11,5,4,9
CHN200204282,2002,20428,CHN,LAN,CHI11,4,1,5
CHN200205060,2002,20506,CHN,SLN,CHI11,5,6,11
CHN200205070,2002,20507,CHN,SLN,CHI11,0,8,8
CHN200205080,2002,20508,CHN,SLN,CHI11,3,2,5
CHN200205090,2002,20509,CHN,MIL,CHI11,9,4,13
CHN200205100,2002,20510,CHN,MIL,CHI11,6,4,10
CHN200205120,2002,20512,CHN,MIL,CHI11,13,4,17
CHN200205211,2002,20521,CHN,PIT,CHI11,12,1,13
CHN200205212,2002,20521,CHN,PIT,CHI11,3,4,7
CHN200205220,2002,20522,CHN,PIT,CHI11,4,7,11
CHN200205230,2002,20523,CHN,PIT,CHI11,6,11,17
CHN200205310,2002,20531,CHN,HOU,CHI11,4,1,5
CHN200206010,2002,20601,CHN,HOU,CHI11,7,3,10
CHN200206020,2002,20602,CHN,HOU,CHI11,2,4,6
CHN200206140,2002,20614,CHN,CHA,CHI11,4,8,12
CHN200206150,2002,20615,CHN,CHA,CHI11,3,7,10
CHN200206160,2002,20616,CHN,CHA,CHI11,10,7,17
CHN200206180,2002,20618,CHN,TEX,CHI11,3,4,7
CHN200206190,2002,20619,CHN,TEX,CHI11,7,4,11
CHN200206200,2002,20620,CHN,TEX,CHI11,7,4,11
CHN200206210,2002,20621,CHN,SLN,CHI11,1,2,3
CHN200206230,2002,20623,CHN,SLN,CHI11,3,8,11
CHN200206240,2002,20624,CHN,CIN,CHI11,4,6,10
CHN200206250,2002,20625,CHN,CIN,CHI11,5,2,7
CHN200206260,2002,20626,CHN,CIN,CHI11,8,6,14
CHN200206270,2002,20627,CHN,CIN,CHI11,5,4,9
CHN200207120,2002,20712,CHN,FLO,CHI11,4,5,9
CHN200207130,2002,20713,CHN,FLO,CHI11,2,9,11
CHN200207140,2002,20714,CHN,FLO,CHI11,3,10,13
CHN200207150,2002,20715,CHN,ATL,CHI11,2,3,5
CHN200207160,2002,20716,CHN,ATL,CHI11,2,0,2
CHN200207190,2002,20719,CHN,HOU,CHI11,0,5,5
CHN200207200,2002,20720,CHN,HOU,CHI11,3,2,5
CHN200207210,2002,20721,CHN,HOU,CHI11,2,3,5
CHN200207220,2002,20722,CHN,PHI,CHI11,6,7,13
CHN200207230,2002,20723,CHN,PHI,CHI11,7,4,11
CHN200207240,2002,20724,CHN,PHI,CHI11,4,2,6
CHN200207250,2002,20725,CHN,PHI,CHI11,6,2,8
CHN200207300,2002,20730,CHN,SDN,CHI11,6,5,11
CHN200207310,2002,20731,CHN,SDN,CHI11,8,6,14
CHN200208010,2002,20801,CHN,SDN,CHI11,7,8,15
CHN200208020,2002,20802,CHN,COL,CHI11,4,6,10
CHN200208030,2002,20803,CHN,COL,CHI11,2,1,3
CHN200208040,2002,20804,CHN,COL,CHI11,1,4,5
CHN200208120,2002,20812,CHN,HOU,CHI11,9,6,15
CHN200208130,2002,20813,CHN,HOU,CHI11,5,4,9
CHN200208140,2002,20814,CHN,HOU,CHI11,4,3,7
CHN200208150,2002,20815,CHN,HOU,CHI11,4,6,10
CHN200208160,2002,20816,CHN,ARI,CHI11,2,1,3
CHN200208170,2002,20817,CHN,ARI,CHI11,6,2,8
CHN200208180,2002,20818,CHN,ARI,CHI11,2,3,5
CHN200208300,2002,20830,CHN,SLN,CHI11,6,3,9
CHN200208311,2002,20831,CHN,SLN,CHI11,8,1,9
CHN200208312,2002,20831,CHN,SLN,CHI11,10,4,14
CHN200209010,2002,20901,CHN,SLN,CHI11,4,5,9
CHN200209021,2002,20902,CHN,MIL,CHI11,4,2,6
CHN200209022,2002,20902,CHN,MIL,CHI11,4,17,21
CHN200209030,2002,20903,CHN,MIL,CHI11,1,10,11
CHN200209040,2002,20904,CHN,MIL,CHI11,0,3,3
CHN200209090,2002,20909,CHN,MON,CHI11,2,3,5
CHN200209100,2002,20910,CHN,MON,CHI11,6,2,8
CHN200209110,2002,20911,CHN,MON,CHI11,3,6,9
CHN200209240,2002,20924,CHN,CIN,CHI11,1,0,1
CHN200209250,2002,20925,CHN,CIN,CHI11,8,2,10
CHN200209260,2002,20926,CHN,CIN,CHI11,1,0,1
CHN200209270,2002,20927,CHN,PIT,CHI11,13,3,16
CHN200209280,2002,20928,CHN,PIT,CHI11,4,5,9
CHN200209290,2002,20929,CHN,PIT,CHI11,3,7,10
CHN200304080,2003,30408,CHN,MON,CHI11,1,6,7
CHN200304090,2003,30409,CHN,MON,CHI11,0,3,3
CHN200304100,2003,30410,CHN,MON,CHI11,7,1,8
CHN200304110,2003,30411,CHN,PIT,CHI11,3,2,5
CHN200304120,2003,30412,CHN,PIT,CHI11,0,4,4
CHN200304130,2003,30413,CHN,PIT,CHI11,3,4,7
CHN200304140,2003,30414,CHN,CIN,CHI11,11,3,14
CHN200304150,2003,30415,CHN,CIN,CHI11,1,11,12
CHN200304160,2003,30416,CHN,CIN,CHI11,4,10,14
CHN200304170,2003,30417,CHN,CIN,CHI11,3,16,19
CHN200304220,2003,30422,CHN,SDN,CHI11,2,7,9
CHN200304230,2003,30423,CHN,SDN,CHI11,2,0,2
CHN200304240,2003,30424,CHN,SDN,CHI11,2,1,3
CHN200305020,2003,30502,CHN,COL,CHI11,4,7,11
CHN200305030,2003,30503,CHN,COL,CHI11,6,4,10
CHN200305040,2003,30504,CHN,COL,CHI11,4,5,9
CHN200305050,2003,30505,CHN,MIL,CHI11,5,3,8
CHN200305060,2003,30506,CHN,MIL,CHI11,9,6,15
CHN200305070,2003,30507,CHN,MIL,CHI11,1,2,3
CHN200305090,2003,30509,CHN,SLN,CHI11,6,3,9
CHN200305100,2003,30510,CHN,SLN,CHI11,2,3,5
CHN200305260,2003,30526,CHN,PIT,CHI11,10,0,10
CHN200305270,2003,30527,CHN,PIT,CHI11,9,4,13
CHN200305280,2003,30528,CHN,PIT,CHI11,4,5,9
CHN200305300,2003,30530,CHN,HOU,CHI11,9,1,10
CHN200305310,2003,30531,CHN,HOU,CHI11,0,1,1
CHN200306010,2003,30601,CHN,HOU,CHI11,9,3,12
CHN200306030,2003,30603,CHN,TBA,CHI11,2,3,5
CHN200306040,2003,30604,CHN,TBA,CHI11,5,2,7
CHN200306050,2003,30605,CHN,TBA,CHI11,1,8,9
CHN200306060,2003,30606,CHN,NYA,CHI11,5,3,8
CHN200306070,2003,30607,CHN,NYA,CHI11,2,5,7
CHN200306080,2003,30608,CHN,NYA,CHI11,7,8,15
CHN200306200,2003,30620,CHN,CHA,CHI11,12,3,15
CHN200306210,2003,30621,CHN,CHA,CHI11,7,6,13
CHN200306220,2003,30622,CHN,CHA,CHI11,1,2,3
CHN200306240,2003,30624,CHN,MIL,CHI11,1,9,10
CHN200306250,2003,30625,CHN,MIL,CHI11,12,6,18
CHN200306260,2003,30626,CHN,MIL,CHI11,5,3,8
CHN200307040,2003,30704,CHN,SLN,CHI11,11,8,19
CHN200307050,2003,30705,CHN,SLN,CHI11,5,6,11
CHN200307060,2003,30706,CHN,SLN,CHI11,4,1,5
CHN200307070,2003,30707,CHN,FLO,CHI11,3,6,9
CHN200307080,2003,30708,CHN,FLO,CHI11,4,3,7
CHN200307090,2003,30709,CHN,FLO,CHI11,1,5,6
CHN200307100,2003,30710,CHN,ATL,CHI11,13,3,16
CHN200307110,2003,30711,CHN,ATL,CHI11,9,5,14
CHN200307120,2003,30712,CHN,ATL,CHI11,3,7,10
CHN200307130,2003,30713,CHN,ATL,CHI11,7,2,9
CHN200307230,2003,30723,CHN,PHI,CHI11,3,0,3
CHN200307240,2003,30724,CHN,PHI,CHI11,14,6,20
CHN200307290,2003,30729,CHN,SFN,CHI11,0,3,3
CHN200307300,2003,30730,CHN,SFN,CHI11,6,3,9
CHN200307310,2003,30731,CHN,SFN,CHI11,4,9,13
CHN200308010,2003,30801,CHN,ARI,CHI11,3,4,7
CHN200308020,2003,30802,CHN,ARI,CHI11,4,3,7
CHN200308030,2003,30803,CHN,ARI,CHI11,1,2,3
CHN200308110,2003,30811,CHN,HOU,CHI11,3,1,4
CHN200308120,2003,30812,CHN,HOU,CHI11,0,3,3
CHN200308130,2003,30813,CHN,HOU,CHI11,4,6,10
CHN200308140,2003,30814,CHN,HOU,CHI11,1,7,8
CHN200308150,2003,30815,CHN,LAN,CHI11,1,2,3
CHN200308160,2003,30816,CHN,LAN,CHI11,10,5,15
CHN200308170,2003,30817,CHN,LAN,CHI11,3,0,3
CHN200308290,2003,30829,CHN,MIL,CHI11,2,4,6
CHN200308300,2003,30830,CHN,MIL,CHI11,9,5,14
CHN200308310,2003,30831,CHN,MIL,CHI11,2,0,2
CHN200309010,2003,30901,CHN,SLN,CHI11,0,7,7
CHN200309021,2003,30902,CHN,SLN,CHI11,2,4,6
CHN200309022,2003,30902,CHN,SLN,CHI11,2,0,2
CHN200309030,2003,30903,CHN,SLN,CHI11,7,8,15
CHN200309040,2003,30904,CHN,SLN,CHI11,6,7,13
CHN200309120,2003,30912,CHN,CIN,CHI11,6,7,13
CHN200309130,2003,30913,CHN,CIN,CHI11,6,9,15
CHN200309140,2003,30914,CHN,CIN,CHI11,1,0,1
CHN200309150,2003,30915,CHN,NYN,CHI11,1,4,5
CHN200309160,2003,30916,CHN,NYN,CHI11,2,3,5
CHN200309170,2003,30917,CHN,NYN,CHI11,0,2,2
CHN200309271,2003,30927,CHN,PIT,CHI11,2,4,6
CHN200309272,2003,30927,CHN,PIT,CHI11,2,7,9
CHN200309280,2003,30928,CHN,PIT,CHI11,3,2,5
CHN200310030,2003,31003,CHN,ATL,CHI11,1,3,4
CHN200310040,2003,31004,CHN,ATL,CHI11,6,4,10
CHN200310070,2003,31007,CHN,FLO,CHI11,9,8,17
CHN200310080,2003,31008,CHN,FLO,CHI11,3,12,15
CHN200310140,2003,31014,CHN,FLO,CHI11,8,3,11
CHN200310150,2003,31015,CHN,FLO,CHI11,9,6,15
CHN200404120,2004,40412,CHN,PIT,CHI11,13,2,15
CHN200404140,2004,40414,CHN,PIT,CHI11,3,8,11
CHN200404150,2004,40415,CHN,PIT,CHI11,5,10,15
CHN200404160,2004,40416,CHN,CIN,CHI11,10,11,21
CHN200404170,2004,40417,CHN,CIN,CHI11,3,2,5
CHN200404180,2004,40418,CHN,CIN,CHI11,11,10,21
CHN200404190,2004,40419,CHN,CIN,CHI11,1,8,9
CHN200404230,2004,40423,CHN,NYN,CHI11,1,3,4
CHN200404240,2004,40424,CHN,NYN,CHI11,0,3,3
CHN200404250,2004,40425,CHN,NYN,CHI11,1,4,5
CHN200405040,2004,40504,CHN,ARI,CHI11,6,3,9
CHN200405050,2004,40505,CHN,ARI,CHI11,2,0,2
CHN200405060,2004,40506,CHN,ARI,CHI11,3,11,14
CHN200405070,2004,40507,CHN,COL,CHI11,0,11,11
CHN200405080,2004,40508,CHN,COL,CHI11,4,3,7
CHN200405090,2004,40509,CHN,COL,CHI11,4,5,9
CHN200405180,2004,40518,CHN,SFN,CHI11,1,0,1
CHN200405190,2004,40519,CHN,SFN,CHI11,3,4,7
CHN200405200,2004,40520,CHN,SFN,CHI11,5,3,8
CHN200405210,2004,40521,CHN,SLN,CHI11,7,6,13
CHN200405220,2004,40522,CHN,SLN,CHI11,1,7,8
CHN200405230,2004,40523,CHN,SLN,CHI11,3,4,7
CHN200405310,2004,40531,CHN,HOU,CHI11,1,3,4
CHN200406010,2004,40601,CHN,HOU,CHI11,5,3,8
CHN200406020,2004,40602,CHN,HOU,CHI11,5,1,6
CHN200406040,2004,40604,CHN,PIT,CHI11,2,1,3
CHN200406050,2004,40605,CHN,PIT,CHI11,1,6,7
CHN200406060,2004,40606,CHN,PIT,CHI11,1,4,5
CHN200406070,2004,40607,CHN,SLN,CHI11,4,3,7
CHN200406080,2004,40608,CHN,SLN,CHI11,3,7,10
CHN200406090,2004,40609,CHN,SLN,CHI11,12,4,16
CHN200406100,2004,40610,CHN,SLN,CHI11,3,12,15
CHN200406180,2004,40618,CHN,OAK,CHI11,2,1,3
CHN200406190,2004,40619,CHN,OAK,CHI11,3,4,7
CHN200406200,2004,40620,CHN,OAK,CHI11,3,5,8
CHN200406290,2004,40629,CHN,HOU,CHI11,5,7,12
CHN200406300,2004,40630,CHN,HOU,CHI11,3,2,5
CHN200407010,2004,40701,CHN,HOU,CHI11,4,5,9
CHN200407020,2004,40702,CHN,CHA,CHI11,2,6,8
CHN200407030,2004,40703,CHN,CHA,CHI11,2,4,6
CHN200407040,2004,40704,CHN,CHA,CHI11,1,2,3
CHN200407150,2004,40715,CHN,MIL,CHI11,1,4,5
CHN200407160,2004,40716,CHN,MIL,CHI11,3,2,5
CHN200407170,2004,40717,CHN,MIL,CHI11,0,5,5
CHN200407180,2004,40718,CHN,MIL,CHI11,4,2,6
CHN200407190,2004,40719,CHN,SLN,CHI11,5,4,9
CHN200407200,2004,40720,CHN,SLN,CHI11,11,8,19
CHN200407210,2004,40721,CHN,CIN,CHI11,4,5,9
CHN200407220,2004,40722,CHN,CIN,CHI11,2,13,15
CHN200407300,2004,40730,CHN,PHI,CHI11,7,10,17
CHN200407310,2004,40731,CHN,PHI,CHI11,4,3,7
CHN200408010,2004,40801,CHN,PHI,CHI11,3,6,9
CHN200408100,2004,40810,CHN,SDN,CHI11,8,6,14
CHN200408110,2004,40811,CHN,SDN,CHI11,1,5,6
CHN200408120,2004,40812,CHN,SDN,CHI11,5,4,9
CHN200408130,2004,40813,CHN,LAN,CHI11,8,1,9
CHN200408140,2004,40814,CHN,LAN,CHI11,0,2,2
CHN200408150,2004,40815,CHN,LAN,CHI11,8,5,13
CHN200408230,2004,40823,CHN,MIL,CHI11,3,8,11
CHN200408240,2004,40824,CHN,MIL,CHI11,4,13,17
CHN200408250,2004,40825,CHN,MIL,CHI11,2,4,6
CHN200408260,2004,40826,CHN,HOU,CHI11,3,8,11
CHN200408270,2004,40827,CHN,HOU,CHI11,15,7,22
CHN200408280,2004,40828,CHN,HOU,CHI11,7,6,13
CHN200408290,2004,40829,CHN,HOU,CHI11,10,3,13
CHN200409060,2004,40906,CHN,MON,CHI11,1,9,10
CHN200409070,2004,40907,CHN,MON,CHI11,7,6,13
CHN200409080,2004,40908,CHN,MON,CHI11,6,0,6
CHN200409101,2004,40910,CHN,FLO,CHI11,7,0,7
CHN200409102,2004,40910,CHN,FLO,CHI11,2,11,13
CHN200409110,2004,40911,CHN,FLO,CHI11,2,5,7
CHN200409120,2004,40912,CHN,FLO,CHI11,11,1,12
CHN200409130,2004,40913,CHN,PIT,CHI11,2,7,9
CHN200409140,2004,40914,CHN,PIT,CHI11,2,3,5
CHN200409150,2004,40915,CHN,PIT,CHI11,5,13,18
CHN200409270,2004,40927,CHN,CIN,CHI11,5,12,17
CHN200409280,2004,40928,CHN,CIN,CHI11,8,3,11
CHN200409290,2004,40929,CHN,CIN,CHI11,4,3,7
CHN200409300,2004,40930,CHN,CIN,CHI11,2,1,3
CHN200410010,2004,41001,CHN,ATL,CHI11,5,4,9
CHN200410020,2004,41002,CHN,ATL,CHI11,8,6,14
CHN200410030,2004,41003,CHN,ATL,CHI11,8,10,18
CHN200504080,2005,50408,CHN,MIL,CHI11,6,3,9
CHN200504090,2005,50409,CHN,MIL,CHI11,0,4,4
CHN200504100,2005,50410,CHN,MIL,CHI11,5,6,11
CHN200504110,2005,50411,CHN,SDN,CHI11,1,0,1
CHN200504131,2005,50413,CHN,SDN,CHI11,8,3,11
CHN200504132,2005,50413,CHN,SDN,CHI11,3,8,11
CHN200504230,2005,50423,CHN,PIT,CHI11,4,3,7
CHN200504240,2005,50424,CHN,PIT,CHI11,2,5,7
CHN200504250,2005,50425,CHN,CIN,CHI11,6,10,16
CHN200504260,2005,50426,CHN,CIN,CHI11,11,9,20
CHN200504270,2005,50427,CHN,CIN,CHI11,7,8,15
CHN200505060,2005,50506,CHN,PHI,CHI11,3,2,5
CHN200505070,2005,50507,CHN,PHI,CHI11,4,1,5
CHN200505080,2005,50508,CHN,PHI,CHI11,1,2,3
CHN200505090,2005,50509,CHN,NYN,CHI11,7,4,11
CHN200505100,2005,50510,CHN,NYN,CHI11,0,7,7
CHN200505110,2005,50511,CHN,NYN,CHI11,3,4,7
CHN200505200,2005,50520,CHN,CHA,CHI11,5,1,6
CHN200505210,2005,50521,CHN,CHA,CHI11,5,3,8
CHN200505220,2005,50522,CHN,CHA,CHI11,3,4,7
CHN200505230,2005,50523,CHN,HOU,CHI11,1,4,5
CHN200505240,2005,50524,CHN,HOU,CHI11,2,4,6
CHN200505250,2005,50525,CHN,HOU,CHI11,5,1,6
CHN200505260,2005,50526,CHN,COL,CHI11,5,2,7
CHN200505270,2005,50527,CHN,COL,CHI11,3,10,13
CHN200505280,2005,50528,CHN,COL,CHI11,1,5,6
CHN200505290,2005,50529,CHN,COL,CHI11,6,11,17
CHN200506060,2005,50606,CHN,TOR,CHI11,4,1,5
CHN200506070,2005,50607,CHN,TOR,CHI11,6,4,10
CHN200506080,2005,50608,CHN,TOR,CHI11,0,2,2
CHN200506100,2005,50610,CHN,BOS,CHI11,6,14,20
CHN200506110,2005,50611,CHN,BOS,CHI11,6,7,13
CHN200506120,2005,50612,CHN,BOS,CHI11,8,1,9
CHN200506130,2005,50613,CHN,FLO,CHI11,9,1,10
CHN200506140,2005,50614,CHN,FLO,CHI11,0,14,14
CHN200506150,2005,50615,CHN,FLO,CHI11,15,5,20
CHN200506280,2005,50628,CHN,MIL,CHI11,0,2,2
CHN200506290,2005,50629,CHN,MIL,CHI11,2,3,5
CHN200506300,2005,50630,CHN,MIL,CHI11,10,6,16
CHN200507010,2005,50701,CHN,WAS,CHI11,4,3,7
CHN200507020,2005,50702,CHN,WAS,CHI11,4,2,6
CHN200507030,2005,50703,CHN,WAS,CHI11,5,4,9
CHN200507140,2005,50714,CHN,PIT,CHI11,1,5,6
CHN200507150,2005,50715,CHN,PIT,CHI11,1,11,12
CHN200507160,2005,50716,CHN,PIT,CHI11,3,0,3
CHN200507170,2005,50717,CHN,PIT,CHI11,2,8,10
CHN200507250,2005,50725,CHN,SFN,CHI11,2,3,5
CHN200507260,2005,50726,CHN,SFN,CHI11,3,2,5
CHN200507270,2005,50727,CHN,SFN,CHI11,3,4,7
CHN200507280,2005,50728,CHN,ARI,CHI11,6,0,6
CHN200507290,2005,50729,CHN,ARI,CHI11,3,4,7
CHN200507300,2005,50730,CHN,ARI,CHI11,3,2,5
CHN200507310,2005,50731,CHN,ARI,CHI11,13,6,19
CHN200508080,2005,50808,CHN,CIN,CHI11,9,4,13
CHN200508090,2005,50809,CHN,CIN,CHI11,8,3,11
CHN200508100,2005,50810,CHN,CIN,CHI11,8,2,10
CHN200508110,2005,50811,CHN,SLN,CHI11,4,11,15
CHN200508120,2005,50812,CHN,SLN,CHI11,1,4,5
CHN200508130,2005,50813,CHN,SLN,CHI11,5,2,7
CHN200508140,2005,50814,CHN,SLN,CHI11,4,5,9
CHN200508220,2005,50822,CHN,ATL,CHI11,4,2,6
CHN200508230,2005,50823,CHN,ATL,CHI11,1,10,11
CHN200508240,2005,50824,CHN,ATL,CHI11,3,1,4
CHN200508260,2005,50826,CHN,FLO,CHI11,7,5,12
CHN200508270,2005,50827,CHN,FLO,CHI11,2,1,3
CHN200508280,2005,50828,CHN,FLO,CHI11,3,14,17
CHN200508290,2005,50829,CHN,LAN,CHI11,9,6,15
CHN200508300,2005,50830,CHN,LAN,CHI11,3,6,9
CHN200508310,2005,50831,CHN,LAN,CHI11,7,0,7
CHN200509120,2005,50912,CHN,CIN,CHI11,5,2,7
CHN200509130,2005,50913,CHN,CIN,CHI11,3,4,7
CHN200509140,2005,50914,CHN,CIN,CHI11,7,4,11
CHN200509150,2005,50915,CHN,SLN,CHI11,6,1,7
CHN200509160,2005,50916,CHN,SLN,CHI11,3,5,8
CHN200509170,2005,50917,CHN,SLN,CHI11,5,1,6
CHN200509180,2005,50918,CHN,SLN,CHI11,4,7,11
CHN200509230,2005,50923,CHN,HOU,CHI11,4,5,9
CHN200509240,2005,50924,CHN,HOU,CHI11,8,3,11
CHN200509250,2005,50925,CHN,HOU,CHI11,2,3,5
CHN200509270,2005,50927,CHN,PIT,CHI11,5,3,8
CHN200509280,2005,50928,CHN,PIT,CHI11,3,2,5
CHN200604070,2006,60407,CHN,SLN,CHI11,1,5,6
CHN200604080,2006,60408,CHN,SLN,CHI11,2,3,5
CHN200604090,2006,60409,CHN,SLN,CHI11,4,8,12
CHN200604110,2006,60411,CHN,CIN,CHI11,9,2,11
CHN200604120,2006,60412,CHN,CIN,CHI11,1,4,5
CHN200604130,2006,60413,CHN,CIN,CHI11,8,3,11
CHN200604240,2006,60424,CHN,FLO,CHI11,3,6,9
CHN200604250,2006,60425,CHN,FLO,CHI11,1,3,4
CHN200604260,2006,60426,CHN,FLO,CHI11,7,5,12
CHN200604280,2006,60428,CHN,MIL,CHI11,2,6,8
CHN200604290,2006,60429,CHN,MIL,CHI11,16,2,18
CHN200604300,2006,60430,CHN,MIL,CHI11,9,0,9
CHN200605010,2006,60501,CHN,PIT,CHI11,1,2,3
CHN200605020,2006,60502,CHN,PIT,CHI11,8,0,8
CHN200605120,2006,60512,CHN,SDN,CHI11,10,5,15
CHN200605130,2006,60513,CHN,SDN,CHI11,4,3,7
CHN200605140,2006,60514,CHN,SDN,CHI11,9,0,9
CHN200605160,2006,60516,CHN,WAS,CHI11,0,4,4
CHN200605170,2006,60517,CHN,WAS,CHI11,0,5,5
CHN200605180,2006,60518,CHN,WAS,CHI11,5,3,8
CHN200605260,2006,60526,CHN,ATL,CHI11,6,5,11
CHN200605270,2006,60527,CHN,ATL,CHI11,2,1,3
CHN200605280,2006,60528,CHN,ATL,CHI11,13,12,25
CHN200605290,2006,60529,CHN,CIN,CHI11,3,7,10
CHN200605300,2006,60530,CHN,CIN,CHI11,3,8,11
CHN200605310,2006,60531,CHN,CIN,CHI11,3,2,5
CHN200606130,2006,60613,CHN,HOU,CHI11,9,2,11
CHN200606140,2006,60614,CHN,HOU,CHI11,5,4,9
CHN200606150,2006,60615,CHN,HOU,CHI11,3,2,5
CHN200606160,2006,60616,CHN,DET,CHI11,5,3,8
CHN200606170,2006,60617,CHN,DET,CHI11,9,3,12
CHN200606180,2006,60618,CHN,DET,CHI11,12,3,15
CHN200606260,2006,60626,CHN,MIL,CHI11,6,0,6
CHN200606270,2006,60627,CHN,MIL,CHI11,8,5,13
CHN200606280,2006,60628,CHN,MIL,CHI11,3,6,9
CHN200606290,2006,60629,CHN,MIL,CHI11,5,4,9
CHN200606300,2006,60630,CHN,CHA,CHI11,6,2,8
CHN200607010,2006,60701,CHN,CHA,CHI11,8,6,14
CHN200607020,2006,60702,CHN,CHA,CHI11,11,15,26
CHN200607140,2006,60714,CHN,NYN,CHI11,6,3,9
CHN200607150,2006,60715,CHN,NYN,CHI11,2,9,11
CHN200607160,2006,60716,CHN,NYN,CHI11,13,7,20
CHN200607180,2006,60718,CHN,HOU,CHI11,2,4,6
CHN200607190,2006,60719,CHN,HOU,CHI11,4,2,6
CHN200607200,2006,60720,CHN,HOU,CHI11,1,4,5
CHN200607270,2006,60727,CHN,SLN,CHI11,4,5,9
CHN200607280,2006,60728,CHN,SLN,CHI11,5,6,11
CHN200607290,2006,60729,CHN,SLN,CHI11,2,4,6
CHN200607300,2006,60730,CHN,SLN,CHI11,3,6,9
CHN200607310,2006,60731,CHN,ARI,CHI11,15,4,19
CHN200608010,2006,60801,CHN,ARI,CHI11,3,9,12
CHN200608031,2006,60803,CHN,ARI,CHI11,10,2,12
CHN200608032,2006,60803,CHN,ARI,CHI11,3,7,10
CHN200608040,2006,60804,CHN,PIT,CHI11,6,0,6
CHN200608050,2006,60805,CHN,PIT,CHI11,5,7,12
CHN200608060,2006,60806,CHN,PIT,CHI11,1,6,7
CHN200608180,2006,60818,CHN,SLN,CHI11,11,3,14
CHN200608190,2006,60819,CHN,SLN,CHI11,4,5,9
CHN200608200,2006,60820,CHN,SLN,CHI11,5,3,8
CHN200608210,2006,60821,CHN,PHI,CHI11,6,5,11
CHN200608220,2006,60822,CHN,PHI,CHI11,6,3,9
CHN200608230,2006,60823,CHN,PHI,CHI11,2,1,3
CHN200608240,2006,60824,CHN,PHI,CHI11,2,11,13
CHN200609010,2006,60901,CHN,SFN,CHI11,2,6,8
CHN200609020,2006,60902,CHN,SFN,CHI11,4,2,6
CHN200609030,2006,60903,CHN,SFN,CHI11,7,4,11
CHN200609040,2006,60904,CHN,PIT,CHI11,5,4,9
CHN200609050,2006,60905,CHN,PIT,CHI11,6,5,11
CHN200609060,2006,60906,CHN,PIT,CHI11,2,7,9
CHN200609070,2006,60907,CHN,PIT,CHI11,7,5,12
CHN200609120,2006,60912,CHN,LAN,CHI11,8,9,17
CHN200609130,2006,60913,CHN,LAN,CHI11,6,0,6
CHN200609140,2006,60914,CHN,LAN,CHI11,5,6,11
CHN200609150,2006,60915,CHN,CIN,CHI11,4,0,4
CHN200609160,2006,60916,CHN,CIN,CHI11,0,4,4
CHN200609170,2006,60917,CHN,CIN,CHI11,3,11,14
CHN200609260,2006,60926,CHN,MIL,CHI11,6,14,20
CHN200609270,2006,60927,CHN,MIL,CHI11,2,3,5
CHN200609290,2006,60929,CHN,COL,CHI11,5,2,7
CHN200609300,2006,60930,CHN,COL,CHI11,11,9,20
CHN200610010,2006,61001,CHN,COL,CHI11,5,8,13
CHN200704090,2007,70409,CHN,HOU,CHI11,5,3,8
CHN200704100,2007,70410,CHN,HOU,CHI11,4,2,6
CHN200704130,2007,70413,CHN,CIN,CHI11,6,5,11
CHN200704140,2007,70414,CHN,CIN,CHI11,0,7,7
CHN200704150,2007,70415,CHN,CIN,CHI11,1,0,1
CHN200704160,2007,70416,CHN,SDN,CHI11,4,12,16
CHN200704170,2007,70417,CHN,SDN,CHI11,4,3,7
CHN200704200,2007,70420,CHN,SLN,CHI11,2,1,3
CHN200704210,2007,70421,CHN,SLN,CHI11,0,6,6
CHN200704220,2007,70422,CHN,SLN,CHI11,12,9,21
CHN200704230,2007,70423,CHN,MIL,CHI11,5,4,9
CHN200704240,2007,70424,CHN,MIL,CHI11,4,1,5
CHN200704250,2007,70425,CHN,MIL,CHI11,3,9,12
CHN200705040,2007,70504,CHN,WAS,CHI11,4,6,10
CHN200705050,2007,70505,CHN,WAS,CHI11,3,5,8
CHN200705060,2007,70506,CHN,WAS,CHI11,3,4,7
CHN200705080,2007,70508,CHN,PIT,CHI11,4,3,7
CHN200705090,2007,70509,CHN,PIT,CHI11,0,1,1
CHN200705100,2007,70510,CHN,PIT,CHI11,6,4,10
CHN200705180,2007,70518,CHN,CHA,CHI11,3,6,9
CHN200705190,2007,70519,CHN,CHA,CHI11,6,11,17
CHN200705200,2007,70520,CHN,CHA,CHI11,10,6,16
CHN200705280,2007,70528,CHN,FLO,CHI11,5,3,8
CHN200705290,2007,70529,CHN,FLO,CHI11,9,4,13
CHN200705300,2007,70530,CHN,FLO,CHI11,9,0,9
CHN200706010,2007,70601,CHN,ATL,CHI11,8,5,13
CHN200706020,2007,70602,CHN,ATL,CHI11,5,3,8
CHN200706030,2007,70603,CHN,ATL,CHI11,1,10,11
CHN200706110,2007,70611,CHN,HOU,CHI11,1,2,3
CHN200706120,2007,70612,CHN,SEA,CHI11,5,3,8
CHN200706130,2007,70613,CHN,SEA,CHI11,2,3,5
CHN200706140,2007,70614,CHN,SEA,CHI11,4,5,9
CHN200706150,2007,70615,CHN,SDN,CHI11,1,4,5
CHN200706160,2007,70616,CHN,SDN,CHI11,1,0,1
CHN200706170,2007,70617,CHN,SDN,CHI11,11,3,14
CHN200706250,2007,70625,CHN,COL,CHI11,9,10,19
CHN200706260,2007,70626,CHN,COL,CHI11,5,8,13
CHN200706270,2007,70627,CHN,COL,CHI11,4,6,10
CHN200706290,2007,70629,CHN,MIL,CHI11,5,6,11
CHN200706300,2007,70630,CHN,MIL,CHI11,13,4,17
CHN200707010,2007,70701,CHN,MIL,CHI11,1,5,6
CHN200707130,2007,70713,CHN,HOU,CHI11,0,6,6
CHN200707140,2007,70714,CHN,HOU,CHI11,3,9,12
CHN200707150,2007,70715,CHN,HOU,CHI11,6,7,13
CHN200707160,2007,70716,CHN,SFN,CHI11,2,3,5
CHN200707170,2007,70717,CHN,SFN,CHI11,4,2,6
CHN200707180,2007,70718,CHN,SFN,CHI11,1,12,13
CHN200707190,2007,70719,CHN,SFN,CHI11,8,9,17
CHN200707200,2007,70720,CHN,ARI,CHI11,2,6,8
CHN200707210,2007,70721,CHN,ARI,CHI11,3,2,5
CHN200707220,2007,70722,CHN,ARI,CHI11,3,0,3
CHN200707300,2007,70730,CHN,PHI,CHI11,4,1,5
CHN200707310,2007,70731,CHN,PHI,CHI11,3,7,10
CHN200708010,2007,70801,CHN,PHI,CHI11,4,5,9
CHN200708020,2007,70802,CHN,PHI,CHI11,10,6,16
CHN200708030,2007,70803,CHN,NYN,CHI11,6,2,8
CHN200708040,2007,70804,CHN,NYN,CHI11,2,6,8
CHN200708050,2007,70805,CHN,NYN,CHI11,8,3,11
CHN200708140,2007,70814,CHN,CIN,CHI11,6,5,11
CHN200708150,2007,70815,CHN,CIN,CHI11,11,9,20
CHN200708160,2007,70816,CHN,CIN,CHI11,4,12,16
CHN200708170,2007,70817,CHN,SLN,CHI11,1,2,3
CHN200708180,2007,70818,CHN,SLN,CHI11,3,5,8
CHN200708200,2007,70820,CHN,SLN,CHI11,6,4,10
CHN200708280,2007,70828,CHN,MIL,CHI11,3,5,8
CHN200708290,2007,70829,CHN,MIL,CHI11,6,1,7
CHN200708300,2007,70830,CHN,MIL,CHI11,4,5,9
CHN200708310,2007,70831,CHN,HOU,CHI11,6,1,7
CHN200709010,2007,70901,CHN,HOU,CHI11,3,4,7
CHN200709020,2007,70902,CHN,HOU,CHI11,5,6,11
CHN200709030,2007,70903,CHN,LAN,CHI11,11,3,14
CHN200709040,2007,70904,CHN,LAN,CHI11,6,2,8
CHN200709050,2007,70905,CHN,LAN,CHI11,2,8,10
CHN200709060,2007,70906,CHN,LAN,CHI11,7,4,11
CHN200709100,2007,70910,CHN,SLN,CHI11,3,12,15
CHN200709170,2007,70917,CHN,CIN,CHI11,6,7,13
CHN200709180,2007,70918,CHN,CIN,CHI11,5,2,7
CHN200709190,2007,70919,CHN,CIN,CHI11,2,3,5
CHN200709210,2007,70921,CHN,PIT,CHI11,8,13,21
CHN200709220,2007,70922,CHN,PIT,CHI11,5,9,14
CHN200709230,2007,70923,CHN,PIT,CHI11,0,8,8
CHN200710060,2007,71006,CHN,ARI,CHI11,5,1,6
CHN200803310,2008,80331,CHN,MIL,CHI11,4,3,7
CHN200804020,2008,80402,CHN,MIL,CHI11,8,2,10
CHN200804030,2008,80403,CHN,MIL,CHI11,3,6,9
CHN200804040,2008,80404,CHN,HOU,CHI11,4,3,7
CHN200804050,2008,80405,CHN,HOU,CHI11,7,9,16
CHN200804060,2008,80406,CHN,HOU,CHI11,2,3,5
CHN200804150,2008,80415,CHN,CIN,CHI11,5,9,14
CHN200804160,2008,80416,CHN,CIN,CHI11,3,12,15
CHN200804170,2008,80417,CHN,CIN,CHI11,9,2,11
CHN200804180,2008,80418,CHN,PIT,CHI11,2,3,5
CHN200804190,2008,80419,CHN,PIT,CHI11,1,13,14
CHN200804200,2008,80420,CHN,PIT,CHI11,6,13,19
CHN200804210,2008,80421,CHN,NYN,CHI11,1,7,8
CHN200804220,2008,80422,CHN,NYN,CHI11,1,8,9
CHN200804290,2008,80429,CHN,MIL,CHI11,10,7,17
CHN200804300,2008,80430,CHN,MIL,CHI11,5,19,24
CHN200805010,2008,80501,CHN,MIL,CHI11,4,3,7
CHN200805090,2008,80509,CHN,ARI,CHI11,1,3,4
CHN200805100,2008,80510,CHN,ARI,CHI11,2,7,9
CHN200805110,2008,80511,CHN,ARI,CHI11,4,6,10
CHN200805120,2008,80512,CHN,SDN,CHI11,3,12,15
CHN200805130,2008,80513,CHN,SDN,CHI11,4,3,7
CHN200805140,2008,80514,CHN,SDN,CHI11,5,8,13
CHN200805150,2008,80515,CHN,SDN,CHI11,0,4,4
CHN200805160,2008,80516,CHN,PIT,CHI11,4,7,11
CHN200805170,2008,80517,CHN,PIT,CHI11,7,6,13
CHN200805180,2008,80518,CHN,PIT,CHI11,3,4,7
CHN200805260,2008,80526,CHN,LAN,CHI11,1,3,4
CHN200805270,2008,80527,CHN,LAN,CHI11,1,3,4
CHN200805280,2008,80528,CHN,LAN,CHI11,1,2,3
CHN200805290,2008,80529,CHN,COL,CHI11,4,8,12
CHN200805300,2008,80530,CHN,COL,CHI11,9,10,19
CHN200805310,2008,80531,CHN,COL,CHI11,4,5,9
CHN200806010,2008,80601,CHN,COL,CHI11,3,5,8
CHN200806100,2008,80610,CHN,ATL,CHI11,5,10,15
CHN200806110,2008,80611,CHN,ATL,CHI11,2,7,9
CHN200806120,2008,80612,CHN,ATL,CHI11,2,3,5
CHN200806200,2008,80620,CHN,CHA,CHI11,3,4,7
CHN200806210,2008,80621,CHN,CHA,CHI11,7,11,18
CHN200806220,2008,80622,CHN,CHA,CHI11,1,7,8
CHN200806240,2008,80624,CHN,BAL,CHI11,7,5,12
CHN200806250,2008,80625,CHN,BAL,CHI11,4,7,11
CHN200806260,2008,80626,CHN,BAL,CHI11,11,4,15
CHN200807080,2008,80708,CHN,CIN,CHI11,3,7,10
CHN200807090,2008,80709,CHN,CIN,CHI11,1,5,6
CHN200807100,2008,80710,CHN,CIN,CHI11,12,7,19
CHN200807110,2008,80711,CHN,SFN,CHI11,1,3,4
CHN200807120,2008,80712,CHN,SFN,CHI11,7,8,15
CHN200807130,2008,80713,CHN,SFN,CHI11,4,2,6
CHN200807240,2008,80724,CHN,FLO,CHI11,3,6,9
CHN200807250,2008,80725,CHN,FLO,CHI11,3,2,5
CHN200807260,2008,80726,CHN,FLO,CHI11,3,2,5
CHN200807270,2008,80727,CHN,FLO,CHI11,6,9,15
CHN200808010,2008,80801,CHN,PIT,CHI11,3,0,3
CHN200808020,2008,80802,CHN,PIT,CHI11,1,5,6
CHN200808030,2008,80803,CHN,PIT,CHI11,5,8,13
CHN200808040,2008,80804,CHN,HOU,CHI11,2,0,2
CHN200808050,2008,80805,CHN,HOU,CHI11,7,11,18
CHN200808060,2008,80806,CHN,HOU,CHI11,4,11,15
CHN200808080,2008,80808,CHN,SLN,CHI11,2,3,5
CHN200808090,2008,80809,CHN,SLN,CHI11,12,3,15
CHN200808100,2008,80810,CHN,SLN,CHI11,2,6,8
CHN200808190,2008,80819,CHN,CIN,CHI11,0,5,5
CHN200808200,2008,80820,CHN,CIN,CHI11,2,1,3
CHN200808210,2008,80821,CHN,CIN,CHI11,2,3,5
CHN200808220,2008,80822,CHN,WAS,CHI11,13,5,18
CHN200808230,2008,80823,CHN,WAS,CHI11,2,9,11
CHN200808240,2008,80824,CHN,WAS,CHI11,1,6,7
CHN200808280,2008,80828,CHN,PHI,CHI11,4,6,10
CHN200808290,2008,80829,CHN,PHI,CHI11,2,3,5
CHN200808300,2008,80830,CHN,PHI,CHI11,5,2,7
CHN200808310,2008,80831,CHN,PHI,CHI11,5,3,8
CHN200809010,2008,80901,CHN,HOU,CHI11,3,0,3
CHN200809020,2008,80902,CHN,HOU,CHI11,9,7,16
CHN200809030,2008,80903,CHN,HOU,CHI11,4,0,4
CHN200809160,2008,80916,CHN,MIL,CHI11,4,5,9
CHN200809170,2008,80917,CHN,MIL,CHI11,6,2,8
CHN200809180,2008,80918,CHN,MIL,CHI11,6,7,13
CHN200809190,2008,80919,CHN,SLN,CHI11,12,6,18
CHN200809200,2008,80920,CHN,SLN,CHI11,4,5,9
CHN200809210,2008,80921,CHN,SLN,CHI11,1,5,6
CHN200810010,2008,81001,CHN,LAN,CHI11,7,2,9
CHN200810020,2008,81002,CHN,LAN,CHI11,10,3,13
CHN200904130,2009,90413,CHN,COL,CHI11,0,4,4
CHN200904150,2009,90415,CHN,COL,CHI11,5,2,7
CHN200904160,2009,90416,CHN,SLN,CHI11,7,4,11
CHN200904170,2009,90417,CHN,SLN,CHI11,7,8,15
CHN200904180,2009,90418,CHN,SLN,CHI11,5,7,12
CHN200904210,2009,90421,CHN,CIN,CHI11,2,7,9
CHN200904220,2009,90422,CHN,CIN,CHI11,3,0,3
CHN200904230,2009,90423,CHN,CIN,CHI11,7,1,8
CHN200904300,2009,90430,CHN,FLO,CHI11,8,2,10
CHN200905010,2009,90501,CHN,FLO,CHI11,6,8,14
CHN200905020,2009,90502,CHN,FLO,CHI11,1,6,7
CHN200905030,2009,90503,CHN,FLO,CHI11,4,6,10
CHN200905040,2009,90504,CHN,SFN,CHI11,2,4,6
CHN200905050,2009,90505,CHN,SFN,CHI11,6,2,8
CHN200905120,2009,90512,CHN,SDN,CHI11,2,6,8
CHN200905130,2009,90513,CHN,SDN,CHI11,4,6,10
CHN200905140,2009,90514,CHN,SDN,CHI11,3,11,14
CHN200905160,2009,90516,CHN,HOU,CHI11,4,5,9
CHN200905170,2009,90517,CHN,HOU,CHI11,6,5,11
CHN200905250,2009,90525,CHN,PIT,CHI11,10,8,18
CHN200905260,2009,90526,CHN,PIT,CHI11,1,6,7
CHN200905270,2009,90527,CHN,PIT,CHI11,2,5,7
CHN200905280,2009,90528,CHN,LAN,CHI11,2,1,3
CHN200905290,2009,90529,CHN,LAN,CHI11,1,2,3
CHN200905300,2009,90530,CHN,LAN,CHI11,0,7,7
CHN200905310,2009,90531,CHN,LAN,CHI11,8,2,10
CHN200906120,2009,90612,CHN,MIN,CHI11,7,4,11
CHN200906130,2009,90613,CHN,MIN,CHI11,2,0,2
CHN200906140,2009,90614,CHN,MIN,CHI11,2,3,5
CHN200906170,2009,90617,CHN,CHA,CHI11,4,1,5
CHN200906180,2009,90618,CHN,CHA,CHI11,5,6,11
CHN200906190,2009,90619,CHN,CLE,CHI11,7,8,15
CHN200906200,2009,90620,CHN,CLE,CHI11,5,6,11
CHN200906210,2009,90621,CHN,CLE,CHI11,2,6,8
CHN200907020,2009,90702,CHN,MIL,CHI11,5,9,14
CHN200907030,2009,90703,CHN,MIL,CHI11,1,2,3
CHN200907040,2009,90704,CHN,MIL,CHI11,11,2,13
CHN200907050,2009,90705,CHN,MIL,CHI11,2,8,10
CHN200907060,2009,90706,CHN,ATL,CHI11,2,4,6
CHN200907070,2009,90707,CHN,ATL,CHI11,2,1,3
CHN200907080,2009,90708,CHN,ATL,CHI11,4,1,5
CHN200907100,2009,90710,CHN,SLN,CHI11,8,3,11
CHN200907110,2009,90711,CHN,SLN,CHI11,2,5,7
CHN200907121,2009,90712,CHN,SLN,CHI11,3,7,10
CHN200907122,2009,90712,CHN,SLN,CHI11,4,2,6
CHN200907240,2009,90724,CHN,CIN,CHI11,5,8,13
CHN200907250,2009,90725,CHN,CIN,CHI11,3,5,8
CHN200907260,2009,90726,CHN,CIN,CHI11,2,5,7
CHN200907270,2009,90727,CHN,HOU,CHI11,1,5,6
CHN200907280,2009,90728,CHN,HOU,CHI11,11,6,17
CHN200907290,2009,90729,CHN,HOU,CHI11,0,12,12
CHN200907300,2009,90730,CHN,HOU,CHI11,3,12,15
CHN200908110,2009,90811,CHN,PHI,CHI11,4,3,7
CHN200908120,2009,90812,CHN,PHI,CHI11,12,5,17
CHN200908130,2009,90813,CHN,PHI,CHI11,6,1,7
CHN200908140,2009,90814,CHN,PIT,CHI11,2,17,19
CHN200908150,2009,90815,CHN,PIT,CHI11,1,3,4
CHN200908250,2009,90825,CHN,WAS,CHI11,15,6,21
CHN200908260,2009,90826,CHN,WAS,CHI11,4,9,13
CHN200908270,2009,90827,CHN,WAS,CHI11,5,4,9
CHN200908280,2009,90828,CHN,NYN,CHI11,2,5,7
CHN200908290,2009,90829,CHN,NYN,CHI11,4,11,15
CHN200908300,2009,90830,CHN,NYN,CHI11,4,1,5
CHN200908310,2009,90831,CHN,HOU,CHI11,5,3,8
CHN200909010,2009,90901,CHN,HOU,CHI11,1,4,5
CHN200909020,2009,90902,CHN,HOU,CHI11,0,2,2
CHN200909030,2009,90903,CHN,CHA,CHI11,5,0,5
CHN200909110,2009,90911,CHN,CIN,CHI11,4,6,10
CHN200909120,2009,90912,CHN,CIN,CHI11,7,5,12
CHN200909130,2009,90913,CHN,CIN,CHI11,2,5,7
CHN200909140,2009,90914,CHN,MIL,CHI11,0,2,2
CHN200909150,2009,90915,CHN,MIL,CHI11,7,13,20
CHN200909160,2009,90916,CHN,MIL,CHI11,9,5,14
CHN200909170,2009,90917,CHN,MIL,CHI11,7,4,11
CHN200909290,2009,90929,CHN,PIT,CHI11,0,6,6
CHN200909301,2009,90930,CHN,PIT,CHI11,4,0,4
CHN200909302,2009,90930,CHN,PIT,CHI11,8,2,10
CHN200910020,2009,91002,CHN,ARI,CHI11,12,3,15
CHN200910030,2009,91003,CHN,ARI,CHI11,0,5,5
CHN200910040,2009,91004,CHN,ARI,CHI11,5,2,7
CIN200004030,2000,403,CIN,MIL,CIN08,3,3,6
CIN200004040,2000,404,CIN,MIL,CIN08,5,1,6
CIN200004050,2000,405,CIN,MIL,CIN08,8,5,13
CIN200004060,2000,406,CIN,MIL,CIN08,1,5,6
CIN200004070,2000,407,CIN,CHN,CIN08,10,6,16
CIN200004080,2000,408,CIN,CHN,CIN08,3,4,7
CIN200004090,2000,409,CIN,CHN,CIN08,7,8,15
CIN200004180,2000,418,CIN,SFN,CIN08,13,9,22
CIN200004190,2000,419,CIN,SFN,CIN08,4,5,9
CIN200004200,2000,420,CIN,SFN,CIN08,1,11,12
CIN200004210,2000,421,CIN,LAN,CIN08,9,2,11
CIN200004220,2000,422,CIN,LAN,CIN08,16,2,18
CIN200004230,2000,423,CIN,LAN,CIN08,11,3,14
CIN200005050,2000,505,CIN,SLN,CIN08,2,3,5
CIN200005060,2000,506,CIN,SLN,CIN08,3,1,4
CIN200005070,2000,507,CIN,SLN,CIN08,7,9,16
CIN200005090,2000,509,CIN,SDN,CIN08,0,2,2
CIN200005100,2000,510,CIN,SDN,CIN08,1,5,6
CIN200005110,2000,511,CIN,SDN,CIN08,9,11,20
CIN200005160,2000,516,CIN,PIT,CIN08,2,6,8
CIN200005170,2000,517,CIN,PIT,CIN08,9,6,15
CIN200005180,2000,518,CIN,PIT,CIN08,3,4,7
CIN200005260,2000,526,CIN,FLO,CIN08,2,3,5
CIN200005270,2000,527,CIN,FLO,CIN08,8,6,14
CIN200005280,2000,528,CIN,FLO,CIN08,3,1,4
CIN200005300,2000,530,CIN,MON,CIN08,2,4,6
CIN200005310,2000,531,CIN,MON,CIN08,10,4,14
CIN200006010,2000,601,CIN,MON,CIN08,9,7,16
CIN200006020,2000,602,CIN,MIN,CIN08,3,4,7
CIN200006030,2000,603,CIN,MIN,CIN08,3,9,12
CIN200006040,2000,604,CIN,MIN,CIN08,2,3,5
CIN200006050,2000,605,CIN,CHA,CIN08,4,3,7
CIN200006060,2000,606,CIN,CHA,CIN08,17,12,29
CIN200006070,2000,607,CIN,CHA,CIN08,6,4,10
CIN200006200,2000,620,CIN,COL,CIN08,2,3,5
CIN200006210,2000,621,CIN,COL,CIN08,6,4,10
CIN200006220,2000,622,CIN,COL,CIN08,3,5,8
CIN200006230,2000,623,CIN,SDN,CIN08,10,7,17
CIN200006240,2000,624,CIN,SDN,CIN08,5,11,16
CIN200006250,2000,625,CIN,SDN,CIN08,5,4,9
CIN200006260,2000,626,CIN,SLN,CIN08,2,3,5
CIN200006270,2000,627,CIN,SLN,CIN08,4,3,7
CIN200006280,2000,628,CIN,SLN,CIN08,3,7,10
CIN200006290,2000,629,CIN,SLN,CIN08,12,3,15
CIN200007070,2000,707,CIN,CLE,CIN08,1,2,3
CIN200007080,2000,708,CIN,CLE,CIN08,5,14,19
CIN200007090,2000,709,CIN,CLE,CIN08,5,3,8
CIN200007210,2000,721,CIN,ARI,CIN08,5,4,9
CIN200007220,2000,722,CIN,ARI,CIN08,3,7,10
CIN200007230,2000,723,CIN,ARI,CIN08,3,5,8
CIN200007240,2000,724,CIN,HOU,CIN08,7,5,12
CIN200007250,2000,725,CIN,HOU,CIN08,7,4,11
CIN200007260,2000,726,CIN,HOU,CIN08,3,2,5
CIN200008040,2000,804,CIN,FLO,CIN08,2,1,3
CIN200008050,2000,805,CIN,FLO,CIN08,10,5,15
CIN200008060,2000,806,CIN,FLO,CIN08,9,6,15
CIN200008070,2000,807,CIN,ATL,CIN08,2,3,5
CIN200008080,2000,808,CIN,ATL,CIN08,5,4,9
CIN200008090,2000,809,CIN,ATL,CIN08,6,10,16
CIN200008180,2000,818,CIN,PIT,CIN08,6,3,9
CIN200008190,2000,819,CIN,PIT,CIN08,1,7,8
CIN200008200,2000,820,CIN,PIT,CIN08,7,3,10
CIN200008210,2000,821,CIN,PHI,CIN08,4,7,11
CIN200008220,2000,822,CIN,PHI,CIN08,5,4,9
CIN200008230,2000,823,CIN,PHI,CIN08,4,3,7
CIN200008240,2000,824,CIN,PHI,CIN08,3,8,11
CIN200009010,2000,901,CIN,MON,CIN08,2,8,10
CIN200009020,2000,902,CIN,MON,CIN08,9,5,14
CIN200009030,2000,903,CIN,MON,CIN08,1,8,9
CIN200009040,2000,904,CIN,NYN,CIN08,2,6,8
CIN200009050,2000,905,CIN,NYN,CIN08,3,2,5
CIN200009060,2000,906,CIN,NYN,CIN08,8,11,19
CIN200009110,2000,911,CIN,CHN,CIN08,6,7,13
CIN200009120,2000,912,CIN,CHN,CIN08,2,1,3
CIN200009130,2000,913,CIN,CHN,CIN08,3,13,16
CIN200009140,2000,914,CIN,MIL,CIN08,6,4,10
CIN200009150,2000,915,CIN,MIL,CIN08,4,6,10
CIN200009160,2000,916,CIN,MIL,CIN08,3,7,10
CIN200009170,2000,917,CIN,MIL,CIN08,4,8,12
CIN200009220,2000,922,CIN,HOU,CIN08,5,12,17
CIN200009230,2000,923,CIN,HOU,CIN08,4,6,10
CIN200009240,2000,924,CIN,HOU,CIN08,3,4,7
CIN200104020,2001,10402,CIN,ATL,CIN08,10,4,14
CIN200104030,2001,10403,CIN,PIT,CIN08,2,3,5
CIN200104040,2001,10404,CIN,PIT,CIN08,6,5,11
CIN200104050,2001,10405,CIN,PIT,CIN08,1,4,5
CIN200104170,2001,10417,CIN,MIL,CIN08,2,3,5
CIN200104180,2001,10418,CIN,MIL,CIN08,7,4,11
CIN200104200,2001,10420,CIN,NYN,CIN08,5,9,14
CIN200104210,2001,10421,CIN,NYN,CIN08,5,2,7
CIN200104220,2001,10422,CIN,NYN,CIN08,5,1,6
CIN200105010,2001,10501,CIN,LAN,CIN08,6,7,13
CIN200105020,2001,10502,CIN,LAN,CIN08,7,3,10
CIN200105030,2001,10503,CIN,LAN,CIN08,8,6,14
CIN200105040,2001,10504,CIN,SDN,CIN08,11,5,16
CIN200105050,2001,10505,CIN,SDN,CIN08,5,2,7
CIN200105060,2001,10506,CIN,SDN,CIN08,8,2,10
CIN200105121,2001,10512,CIN,HOU,CIN08,2,1,3
CIN200105122,2001,10512,CIN,HOU,CIN08,4,5,9
CIN200105130,2001,10513,CIN,HOU,CIN08,4,3,7
CIN200105140,2001,10514,CIN,HOU,CIN08,6,4,10
CIN200105150,2001,10515,CIN,ARI,CIN08,5,1,6
CIN200105160,2001,10516,CIN,ARI,CIN08,2,1,3
CIN200105170,2001,10517,CIN,ARI,CIN08,7,2,9
CIN200105250,2001,10525,CIN,SLN,CIN08,5,4,9
CIN200105260,2001,10526,CIN,SLN,CIN08,2,7,9
CIN200105270,2001,10527,CIN,SLN,CIN08,2,0,2
CIN200105280,2001,10528,CIN,CHN,CIN08,9,6,15
CIN200105290,2001,10529,CIN,CHN,CIN08,10,5,15
CIN200105300,2001,10530,CIN,CHN,CIN08,3,1,4
CIN200106150,2001,10615,CIN,COL,CIN08,8,4,12
CIN200106160,2001,10616,CIN,COL,CIN08,8,7,15
CIN200106170,2001,10617,CIN,COL,CIN08,4,3,7
CIN200106180,2001,10618,CIN,MIL,CIN08,6,4,10
CIN200106190,2001,10619,CIN,MIL,CIN08,10,8,18
CIN200106200,2001,10620,CIN,MIL,CIN08,3,11,14
CIN200106280,2001,10628,CIN,CHN,CIN08,2,5,7
CIN200106290,2001,10629,CIN,CHN,CIN08,7,1,8
CIN200106300,2001,10630,CIN,CHN,CIN08,1,7,8
CIN200107010,2001,10701,CIN,CHN,CIN08,2,1,3
CIN200107020,2001,10702,CIN,PIT,CIN08,10,5,15
CIN200107030,2001,10703,CIN,PIT,CIN08,3,2,5
CIN200107040,2001,10704,CIN,PIT,CIN08,14,3,17
CIN200107050,2001,10705,CIN,PIT,CIN08,1,7,8
CIN200107120,2001,10712,CIN,CLE,CIN08,7,0,7
CIN200107130,2001,10713,CIN,CLE,CIN08,5,1,6
CIN200107140,2001,10714,CIN,CLE,CIN08,5,6,11
CIN200107150,2001,10715,CIN,DET,CIN08,8,5,13
CIN200107160,2001,10716,CIN,DET,CIN08,1,9,10
CIN200107170,2001,10717,CIN,DET,CIN08,3,1,4
CIN200107180,2001,10718,CIN,ATL,CIN08,3,1,4
CIN200107190,2001,10719,CIN,ATL,CIN08,2,1,3
CIN200107270,2001,10727,CIN,FLO,CIN08,5,10,15
CIN200107280,2001,10728,CIN,FLO,CIN08,0,5,5
CIN200107290,2001,10729,CIN,FLO,CIN08,4,8,12
CIN200108070,2001,10807,CIN,SFN,CIN08,9,3,12
CIN200108080,2001,10808,CIN,SFN,CIN08,9,11,20
CIN200108090,2001,10809,CIN,SFN,CIN08,6,4,10
CIN200108100,2001,10810,CIN,COL,CIN08,16,7,23
CIN200108110,2001,10811,CIN,COL,CIN08,3,7,10
CIN200108120,2001,10812,CIN,COL,CIN08,7,6,13
CIN200108170,2001,10817,CIN,MIL,CIN08,5,1,6
CIN200108180,2001,10818,CIN,MIL,CIN08,6,5,11
CIN200108190,2001,10819,CIN,MIL,CIN08,6,4,10
CIN200108200,2001,10820,CIN,SLN,CIN08,4,5,9
CIN200108210,2001,10821,CIN,SLN,CIN08,11,6,17
CIN200108220,2001,10822,CIN,SLN,CIN08,1,3,4
CIN200108230,2001,10823,CIN,SLN,CIN08,2,12,14
CIN200108310,2001,10831,CIN,PIT,CIN08,3,11,14
CIN200109010,2001,10901,CIN,PIT,CIN08,7,0,7
CIN200109020,2001,10902,CIN,PIT,CIN08,6,8,14
CIN200109030,2001,10903,CIN,HOU,CIN08,2,3,5
CIN200109040,2001,10904,CIN,HOU,CIN08,7,1,8
CIN200109050,2001,10905,CIN,HOU,CIN08,10,3,13
CIN200109180,2001,10918,CIN,CHN,CIN08,5,6,11
CIN200109190,2001,10919,CIN,CHN,CIN08,10,0,10
CIN200109200,2001,10920,CIN,CHN,CIN08,6,5,11
CIN200109280,2001,10928,CIN,MON,CIN08,7,6,13
CIN200109290,2001,10929,CIN,MON,CIN08,4,7,11
CIN200109300,2001,10930,CIN,MON,CIN08,4,5,9
CIN200110061,2001,11006,CIN,PHI,CIN08,2,1,3
CIN200110062,2001,11006,CIN,PHI,CIN08,5,1,6
CIN200110070,2001,11007,CIN,PHI,CIN08,4,1,5
CIN200204010,2002,20401,CIN,CHN,CIN08,4,5,9
CIN200204030,2002,20403,CIN,CHN,CIN08,10,3,13
CIN200204040,2002,20404,CIN,CHN,CIN08,1,3,4
CIN200204050,2002,20405,CIN,MON,CIN08,8,7,15
CIN200204060,2002,20406,CIN,MON,CIN08,5,2,7
CIN200204070,2002,20407,CIN,MON,CIN08,5,6,11
CIN200204160,2002,20416,CIN,HOU,CIN08,8,3,11
CIN200204170,2002,20417,CIN,HOU,CIN08,7,2,9
CIN200204180,2002,20418,CIN,HOU,CIN08,4,5,9
CIN200204230,2002,20423,CIN,COL,CIN08,2,3,5
CIN200204240,2002,20424,CIN,COL,CIN08,3,4,7
CIN200204250,2002,20425,CIN,COL,CIN08,3,4,7
CIN200204260,2002,20426,CIN,SFN,CIN08,3,4,7
CIN200204270,2002,20427,CIN,SFN,CIN08,4,8,12
CIN200204280,2002,20428,CIN,SFN,CIN08,5,4,9
CIN200205060,2002,20506,CIN,MIL,CIN08,5,8,13
CIN200205070,2002,20507,CIN,MIL,CIN08,2,8,10
CIN200205080,2002,20508,CIN,MIL,CIN08,5,14,19
CIN200205100,2002,20510,CIN,SLN,CIN08,4,2,6
CIN200205110,2002,20511,CIN,SLN,CIN08,1,8,9
CIN200205120,2002,20512,CIN,SLN,CIN08,10,8,18
CIN200205210,2002,20521,CIN,FLO,CIN08,1,6,7
CIN200205220,2002,20522,CIN,FLO,CIN08,2,6,8
CIN200205230,2002,20523,CIN,FLO,CIN08,8,4,12
CIN200205310,2002,20531,CIN,ATL,CIN08,7,0,7
CIN200206010,2002,20601,CIN,ATL,CIN08,7,1,8
CIN200206020,2002,20602,CIN,ATL,CIN08,1,5,6
CIN200206040,2002,20604,CIN,SLN,CIN08,8,5,13
CIN200206060,2002,20606,CIN,SLN,CIN08,2,3,5
CIN200206140,2002,20614,CIN,PIT,CIN08,3,4,7
CIN200206150,2002,20615,CIN,PIT,CIN08,3,4,7
CIN200206160,2002,20616,CIN,PIT,CIN08,5,1,6
CIN200206180,2002,20618,CIN,SEA,CIN08,8,1,9
CIN200206190,2002,20619,CIN,SEA,CIN08,2,0,2
CIN200206200,2002,20620,CIN,SEA,CIN08,3,2,5
CIN200206210,2002,20621,CIN,OAK,CIN08,5,3,8
CIN200206220,2002,20622,CIN,OAK,CIN08,10,3,13
CIN200206230,2002,20623,CIN,OAK,CIN08,5,1,6
CIN200207010,2002,20701,CIN,HOU,CIN08,5,7,12
CIN200207020,2002,20702,CIN,HOU,CIN08,6,5,11
CIN200207030,2002,20703,CIN,HOU,CIN08,11,4,15
CIN200207040,2002,20704,CIN,MIL,CIN08,5,4,9
CIN200207050,2002,20705,CIN,MIL,CIN08,6,8,14
CIN200207060,2002,20706,CIN,MIL,CIN08,4,6,10
CIN200207070,2002,20707,CIN,MIL,CIN08,7,4,11
CIN200207190,2002,20719,CIN,NYN,CIN08,4,2,6
CIN200207200,2002,20720,CIN,NYN,CIN08,8,7,15
CIN200207210,2002,20721,CIN,NYN,CIN08,1,9,10
CIN200207220,2002,20722,CIN,PIT,CIN08,6,5,11
CIN200207230,2002,20723,CIN,PIT,CIN08,2,7,9
CIN200207240,2002,20724,CIN,PIT,CIN08,5,10,15
CIN200207300,2002,20730,CIN,LAN,CIN08,4,12,16
CIN200207310,2002,20731,CIN,LAN,CIN08,11,5,16
CIN200208010,2002,20801,CIN,LAN,CIN08,4,6,10
CIN200208090,2002,20809,CIN,SDN,CIN08,10,12,22
CIN200208100,2002,20810,CIN,SDN,CIN08,0,9,9
CIN200208110,2002,20811,CIN,SDN,CIN08,7,9,16
CIN200208130,2002,20813,CIN,ARI,CIN08,6,1,7
CIN200208140,2002,20814,CIN,ARI,CIN08,7,2,9
CIN200208150,2002,20815,CIN,ARI,CIN08,7,2,9
CIN200208160,2002,20816,CIN,HOU,CIN08,3,9,12
CIN200208170,2002,20817,CIN,HOU,CIN08,6,1,7
CIN200208180,2002,20818,CIN,HOU,CIN08,1,2,3
CIN200208190,2002,20819,CIN,HOU,CIN08,7,5,12
CIN200208271,2002,20827,CIN,SLN,CIN08,4,5,9
CIN200208272,2002,20827,CIN,SLN,CIN08,5,0,5
CIN200208280,2002,20828,CIN,SLN,CIN08,9,2,11
CIN200208290,2002,20829,CIN,SLN,CIN08,0,7,7
CIN200208300,2002,20830,CIN,MIL,CIN08,9,4,13
CIN200208310,2002,20831,CIN,MIL,CIN08,11,2,13
CIN200209010,2002,20901,CIN,MIL,CIN08,4,2,6
CIN200209090,2002,20909,CIN,PIT,CIN08,8,9,17
CIN200209100,2002,20910,CIN,PIT,CIN08,0,3,3
CIN200209110,2002,20911,CIN,PIT,CIN08,4,1,5
CIN200209120,2002,20912,CIN,CHN,CIN08,12,15,27
CIN200209130,2002,20913,CIN,CHN,CIN08,7,6,13
CIN200209140,2002,20914,CIN,CHN,CIN08,1,3,4
CIN200209150,2002,20915,CIN,CHN,CIN08,6,0,6
CIN200209211,2002,20921,CIN,PHI,CIN08,5,3,8
CIN200209212,2002,20921,CIN,PHI,CIN08,5,4,9
CIN200209220,2002,20922,CIN,PHI,CIN08,4,3,7
CIN200303310,2003,30331,CIN,PIT,CIN09,10,1,11
CIN200304020,2003,30402,CIN,PIT,CIN09,7,4,11
CIN200304030,2003,30403,CIN,PIT,CIN09,7,5,12
CIN200304040,2003,30404,CIN,CHN,CIN09,9,10,19
CIN200304050,2003,30405,CIN,CHN,CIN09,9,7,16
CIN200304060,2003,30406,CIN,CHN,CIN09,4,5,9
CIN200304110,2003,30411,CIN,PHI,CIN09,6,7,13
CIN200304120,2003,30412,CIN,PHI,CIN09,8,5,13
CIN200304130,2003,30413,CIN,PHI,CIN09,13,1,14
CIN200304220,2003,30422,CIN,LAN,CIN09,2,1,3
CIN200304230,2003,30423,CIN,LAN,CIN09,0,3,3
CIN200304240,2003,30424,CIN,LAN,CIN09,2,3,5
CIN200304250,2003,30425,CIN,SDN,CIN09,7,3,10
CIN200304260,2003,30426,CIN,SDN,CIN09,6,7,13
CIN200304270,2003,30427,CIN,SDN,CIN09,5,7,12
CIN200305050,2003,30505,CIN,SLN,CIN09,4,5,9
CIN200305060,2003,30506,CIN,SLN,CIN09,5,6,11
CIN200305070,2003,30507,CIN,SLN,CIN09,2,4,6
CIN200305080,2003,30508,CIN,SLN,CIN09,6,8,14
CIN200305090,2003,30509,CIN,MIL,CIN09,6,7,13
CIN200305100,2003,30510,CIN,MIL,CIN09,9,3,12
CIN200305110,2003,30511,CIN,MIL,CIN09,5,7,12
CIN200305200,2003,30520,CIN,ATL,CIN09,8,9,17
CIN200305210,2003,30521,CIN,ATL,CIN09,3,9,12
CIN200305220,2003,30522,CIN,ATL,CIN09,9,4,13
CIN200305230,2003,30523,CIN,FLO,CIN09,8,4,12
CIN200305240,2003,30524,CIN,FLO,CIN09,5,4,9
CIN200305250,2003,30525,CIN,FLO,CIN09,6,2,8
CIN200306030,2003,30603,CIN,NYA,CIN09,3,4,7
CIN200306040,2003,30604,CIN,NYA,CIN09,2,6,8
CIN200306050,2003,30605,CIN,NYA,CIN09,10,2,12
CIN200306060,2003,30606,CIN,TOR,CIN09,9,2,11
CIN200306070,2003,30607,CIN,TOR,CIN09,8,9,17
CIN200306080,2003,30608,CIN,TOR,CIN09,5,0,5
CIN200306130,2003,30613,CIN,PHI,CIN09,1,15,16
CIN200306140,2003,30614,CIN,PHI,CIN09,12,2,14
CIN200306160,2003,30616,CIN,CHN,CIN09,4,3,7
CIN200306170,2003,30617,CIN,CHN,CIN09,1,2,3
CIN200306180,2003,30618,CIN,CHN,CIN09,4,1,5
CIN200306190,2003,30619,CIN,CHN,CIN09,1,3,4
CIN200307040,2003,30704,CIN,NYN,CIN09,7,2,9
CIN200307050,2003,30705,CIN,NYN,CIN09,6,2,8
CIN200307060,2003,30706,CIN,NYN,CIN09,7,5,12
CIN200307170,2003,30717,CIN,HOU,CIN09,5,4,9
CIN200307180,2003,30718,CIN,HOU,CIN09,5,3,8
CIN200307190,2003,30719,CIN,HOU,CIN09,9,8,17
CIN200307200,2003,30720,CIN,HOU,CIN09,6,3,9
CIN200307210,2003,30721,CIN,MIL,CIN09,2,11,13
CIN200307220,2003,30722,CIN,MIL,CIN09,6,4,10
CIN200307230,2003,30723,CIN,PIT,CIN09,6,5,11
CIN200307240,2003,30724,CIN,PIT,CIN09,7,5,12
CIN200307280,2003,30728,CIN,PHI,CIN09,5,6,11
CIN200307290,2003,30729,CIN,COL,CIN09,5,3,8
CIN200307300,2003,30730,CIN,COL,CIN09,2,3,5
CIN200307310,2003,30731,CIN,COL,CIN09,4,5,9
CIN200308010,2003,30801,CIN,SFN,CIN09,3,5,8
CIN200308020,2003,30802,CIN,SFN,CIN09,4,5,9
CIN200308030,2003,30803,CIN,SFN,CIN09,7,3,10
CIN200308120,2003,30812,CIN,ARI,CIN09,2,0,2
CIN200308130,2003,30813,CIN,ARI,CIN09,3,1,4
CIN200308140,2003,30814,CIN,ARI,CIN09,2,3,5
CIN200308150,2003,30815,CIN,HOU,CIN09,7,9,16
CIN200308160,2003,30816,CIN,HOU,CIN09,5,2,7
CIN200308170,2003,30817,CIN,HOU,CIN09,3,4,7
CIN200308250,2003,30825,CIN,MIL,CIN09,10,6,16
CIN200308260,2003,30826,CIN,MIL,CIN09,7,1,8
CIN200308270,2003,30827,CIN,MIL,CIN09,6,2,8
CIN200308280,2003,30828,CIN,MIL,CIN09,4,3,7
CIN200308290,2003,30829,CIN,SLN,CIN09,5,8,13
CIN200308300,2003,30830,CIN,SLN,CIN09,6,3,9
CIN200308310,2003,30831,CIN,SLN,CIN09,5,0,5
CIN200309080,2003,30908,CIN,PIT,CIN09,9,1,10
CIN200309090,2003,30909,CIN,PIT,CIN09,6,10,16
CIN200309100,2003,30910,CIN,PIT,CIN09,3,2,5
CIN200309110,2003,30911,CIN,PIT,CIN09,2,3,5
CIN200309230,2003,30923,CIN,CHN,CIN09,6,0,6
CIN200309240,2003,30924,CIN,CHN,CIN09,8,0,8
CIN200309250,2003,30925,CIN,CHN,CIN09,7,9,16
CIN200309260,2003,30926,CIN,MON,CIN09,5,1,6
CIN200309270,2003,30927,CIN,MON,CIN09,2,4,6
CIN200309280,2003,30928,CIN,MON,CIN09,2,1,3
CIN200404050,2004,40405,CIN,CHN,CIN09,7,4,11
CIN200404070,2004,40407,CIN,CHN,CIN09,1,3,4
CIN200404080,2004,40408,CIN,CHN,CIN09,3,5,8
CIN200404090,2004,40409,CIN,PIT,CIN09,1,5,6
CIN200404100,2004,40410,CIN,PIT,CIN09,1,3,4
CIN200404110,2004,40411,CIN,PIT,CIN09,4,3,7
CIN200404200,2004,40420,CIN,ATL,CIN09,2,3,5
CIN200404210,2004,40421,CIN,ATL,CIN09,9,5,14
CIN200404220,2004,40422,CIN,ATL,CIN09,3,5,8
CIN200405040,2004,40504,CIN,MIL,CIN09,6,2,8
CIN200405050,2004,40505,CIN,MIL,CIN09,4,5,9
CIN200405060,2004,40506,CIN,MIL,CIN09,6,9,15
CIN200405070,2004,40507,CIN,SFN,CIN09,6,1,7
CIN200405080,2004,40508,CIN,SFN,CIN09,3,5,8
CIN200405090,2004,40509,CIN,SFN,CIN09,7,6,13
CIN200405180,2004,40518,CIN,COL,CIN09,8,3,11
CIN200405190,2004,40519,CIN,COL,CIN09,3,4,7
CIN200405200,2004,40520,CIN,COL,CIN09,1,3,4
CIN200405210,2004,40521,CIN,HOU,CIN09,4,7,11
CIN200405220,2004,40522,CIN,HOU,CIN09,7,8,15
CIN200405230,2004,40523,CIN,HOU,CIN09,0,7,7
CIN200405240,2004,40524,CIN,HOU,CIN09,5,7,12
CIN200405250,2004,40525,CIN,FLO,CIN09,2,5,7
CIN200405260,2004,40526,CIN,FLO,CIN09,3,0,3
CIN200405270,2004,40527,CIN,FLO,CIN09,5,2,7
CIN200406040,2004,40604,CIN,MON,CIN09,4,2,6
CIN200406050,2004,40605,CIN,MON,CIN09,3,6,9
CIN200406060,2004,40606,CIN,MON,CIN09,5,6,11
CIN200406150,2004,40615,CIN,TEX,CIN09,4,5,9
CIN200406160,2004,40616,CIN,TEX,CIN09,4,7,11
CIN200406170,2004,40617,CIN,TEX,CIN09,3,4,7
CIN200406250,2004,40625,CIN,PIT,CIN09,4,6,10
CIN200406260,2004,40626,CIN,PIT,CIN09,1,0,1
CIN200406270,2004,40627,CIN,PIT,CIN09,14,4,18
CIN200406290,2004,40629,CIN,NYN,CIN09,7,5,12
CIN200406300,2004,40630,CIN,NYN,CIN09,0,2,2
CIN200407010,2004,40701,CIN,NYN,CIN09,7,6,13
CIN200407020,2004,40702,CIN,CLE,CIN09,15,2,17
CIN200407030,2004,40703,CIN,CLE,CIN09,2,4,6
CIN200407040,2004,40704,CIN,CLE,CIN09,4,5,9
CIN200407150,2004,40715,CIN,SLN,CIN09,7,2,9
CIN200407160,2004,40716,CIN,SLN,CIN09,7,5,12
CIN200407170,2004,40717,CIN,SLN,CIN09,5,7,12
CIN200407180,2004,40718,CIN,SLN,CIN09,10,4,14
CIN200407190,2004,40719,CIN,MIL,CIN09,4,8,12
CIN200407200,2004,40720,CIN,MIL,CIN09,2,6,8
CIN200407260,2004,40726,CIN,SLN,CIN09,9,6,15
CIN200407270,2004,40727,CIN,SLN,CIN09,6,0,6
CIN200407280,2004,40728,CIN,SLN,CIN09,11,10,21
CIN200407300,2004,40730,CIN,HOU,CIN09,2,3,5
CIN200407310,2004,40731,CIN,HOU,CIN09,8,0,8
CIN200408010,2004,40801,CIN,HOU,CIN09,7,5,12
CIN200408100,2004,40810,CIN,LAN,CIN09,5,2,7
CIN200408110,2004,40811,CIN,LAN,CIN09,11,1,12
CIN200408120,2004,40812,CIN,LAN,CIN09,5,6,11
CIN200408130,2004,40813,CIN,SDN,CIN09,14,5,19
CIN200408140,2004,40814,CIN,SDN,CIN09,5,11,16
CIN200408150,2004,40815,CIN,SDN,CIN09,7,2,9
CIN200408240,2004,40824,CIN,SLN,CIN09,3,4,7
CIN200408250,2004,40825,CIN,SLN,CIN09,6,5,11
CIN200408260,2004,40826,CIN,SLN,CIN09,0,1,1
CIN200408270,2004,40827,CIN,ARI,CIN09,4,3,7
CIN200408280,2004,40828,CIN,ARI,CIN09,6,3,9
CIN200408290,2004,40829,CIN,ARI,CIN09,2,6,8
CIN200408300,2004,40830,CIN,HOU,CIN09,11,3,14
CIN200408310,2004,40831,CIN,HOU,CIN09,8,0,8
CIN200409010,2004,40901,CIN,HOU,CIN09,9,3,12
CIN200409090,2004,40909,CIN,MIL,CIN09,7,2,9
CIN200409100,2004,40910,CIN,MIL,CIN09,4,6,10
CIN200409110,2004,40911,CIN,MIL,CIN09,0,9,9
CIN200409120,2004,40912,CIN,MIL,CIN09,11,0,11
CIN200409130,2004,40913,CIN,PHI,CIN09,3,4,7
CIN200409140,2004,40914,CIN,PHI,CIN09,6,7,13
CIN200409150,2004,40915,CIN,PHI,CIN09,9,1,10
CIN200409160,2004,40916,CIN,CHN,CIN09,5,4,9
CIN200409170,2004,40917,CIN,CHN,CIN09,12,4,16
CIN200409180,2004,40918,CIN,CHN,CIN09,5,6,11
CIN200409190,2004,40919,CIN,CHN,CIN09,5,1,6
CIN200410010,2004,41001,CIN,PIT,CIN09,1,5,6
CIN200410020,2004,41002,CIN,PIT,CIN09,3,1,4
CIN200410030,2004,41003,CIN,PIT,CIN09,2,0,2
CIN200504040,2005,50404,CIN,NYN,CIN09,6,7,13
CIN200504060,2005,50406,CIN,NYN,CIN09,5,9,14
CIN200504070,2005,50407,CIN,NYN,CIN09,1,6,7
CIN200504150,2005,50415,CIN,HOU,CIN09,11,2,13
CIN200504160,2005,50416,CIN,HOU,CIN09,2,3,5
CIN200504170,2005,50417,CIN,HOU,CIN09,5,6,11
CIN200504180,2005,50418,CIN,CHN,CIN09,6,7,13
CIN200504190,2005,50419,CIN,CHN,CIN09,7,1,8
CIN200504200,2005,50420,CIN,PIT,CIN09,4,6,10
CIN200504210,2005,50421,CIN,PIT,CIN09,4,2,6
CIN200505020,2005,50502,CIN,SLN,CIN09,10,9,19
CIN200505030,2005,50503,CIN,SLN,CIN09,4,2,6
CIN200505040,2005,50504,CIN,SLN,CIN09,7,3,10
CIN200505060,2005,50506,CIN,LAN,CIN09,13,6,19
CIN200505070,2005,50507,CIN,LAN,CIN09,3,11,14
CIN200505080,2005,50508,CIN,LAN,CIN09,9,3,12
CIN200505090,2005,50509,CIN,SDN,CIN09,6,5,11
CIN200505100,2005,50510,CIN,SDN,CIN09,1,5,6
CIN200505110,2005,50511,CIN,SDN,CIN09,7,2,9
CIN200505200,2005,50520,CIN,CLE,CIN09,1,2,3
CIN200505210,2005,50521,CIN,CLE,CIN09,5,3,8
CIN200505220,2005,50522,CIN,CLE,CIN09,9,2,11
CIN200505230,2005,50523,CIN,WAS,CIN09,3,5,8
CIN200505240,2005,50524,CIN,WAS,CIN09,3,4,7
CIN200505250,2005,50525,CIN,WAS,CIN09,3,12,15
CIN200505260,2005,50526,CIN,PIT,CIN09,8,4,12
CIN200505270,2005,50527,CIN,PIT,CIN09,5,6,11
CIN200505280,2005,50528,CIN,PIT,CIN09,9,2,11
CIN200505290,2005,50529,CIN,PIT,CIN09,2,11,13
CIN200506070,2005,50607,CIN,TBA,CIN09,7,9,16
CIN200506080,2005,50608,CIN,TBA,CIN09,9,11,20
CIN200506090,2005,50609,CIN,TBA,CIN09,5,14,19
CIN200506100,2005,50610,CIN,BAL,CIN09,4,3,7
CIN200506110,2005,50611,CIN,BAL,CIN09,1,10,11
CIN200506120,2005,50612,CIN,BAL,CIN09,6,10,16
CIN200506160,2005,50616,CIN,ATL,CIN09,5,2,7
CIN200506170,2005,50617,CIN,ATL,CIN09,10,5,15
CIN200506180,2005,50618,CIN,ATL,CIN09,6,1,7
CIN200506190,2005,50619,CIN,ATL,CIN09,8,11,19
CIN200506200,2005,50620,CIN,SLN,CIN09,6,1,7
CIN200506210,2005,50621,CIN,SLN,CIN09,4,11,15
CIN200506220,2005,50622,CIN,SLN,CIN09,6,7,13
CIN200506300,2005,50630,CIN,HOU,CIN09,2,2,4
CIN200507010,2005,50701,CIN,HOU,CIN09,10,7,17
CIN200507021,2005,50702,CIN,HOU,CIN09,4,3,7
CIN200507022,2005,50702,CIN,HOU,CIN09,6,11,17
CIN200507030,2005,50703,CIN,HOU,CIN09,9,0,9
CIN200507150,2005,50715,CIN,COL,CIN09,3,4,7
CIN200507160,2005,50716,CIN,COL,CIN09,6,7,13
CIN200507170,2005,50717,CIN,COL,CIN09,4,9,13
CIN200507180,2005,50718,CIN,CHN,CIN09,9,4,13
CIN200507190,2005,50719,CIN,CHN,CIN09,7,3,10
CIN200507200,2005,50720,CIN,CHN,CIN09,3,9,12
CIN200507210,2005,50721,CIN,CHN,CIN09,6,9,15
CIN200507220,2005,50722,CIN,MIL,CIN09,6,11,17
CIN200507230,2005,50723,CIN,MIL,CIN09,11,7,18
CIN200507240,2005,50724,CIN,MIL,CIN09,2,3,5
CIN200508020,2005,50802,CIN,ATL,CIN09,12,2,14
CIN200508030,2005,50803,CIN,ATL,CIN09,5,8,13
CIN200508040,2005,50804,CIN,ATL,CIN09,7,4,11
CIN200508050,2005,50805,CIN,FLO,CIN09,5,1,6
CIN200508060,2005,50806,CIN,FLO,CIN09,3,4,7
CIN200508070,2005,50807,CIN,FLO,CIN09,2,0,2
CIN200508150,2005,50815,CIN,SFN,CIN09,7,3,10
CIN200508160,2005,50816,CIN,SFN,CIN09,10,8,18
CIN200508170,2005,50817,CIN,SFN,CIN09,3,2,5
CIN200508180,2005,50818,CIN,SFN,CIN09,2,4,6
CIN200508190,2005,50819,CIN,ARI,CIN09,3,17,20
CIN200508200,2005,50820,CIN,ARI,CIN09,6,2,8
CIN200508210,2005,50821,CIN,ARI,CIN09,6,13,19
CIN200509050,2005,50905,CIN,MIL,CIN09,6,1,7
CIN200509060,2005,50906,CIN,MIL,CIN09,1,2,3
CIN200509070,2005,50907,CIN,MIL,CIN09,14,5,19
CIN200509090,2005,50909,CIN,PIT,CIN09,8,4,12
CIN200509100,2005,50910,CIN,PIT,CIN09,2,6,8
CIN200509110,2005,50911,CIN,PIT,CIN09,3,5,8
CIN200509200,2005,50920,CIN,SLN,CIN09,5,6,11
CIN200509210,2005,50921,CIN,SLN,CIN09,5,1,6
CIN200509220,2005,50922,CIN,SLN,CIN09,2,6,8
CIN200509230,2005,50923,CIN,PHI,CIN09,11,10,21
CIN200509240,2005,50924,CIN,PHI,CIN09,2,3,5
CIN200509250,2005,50925,CIN,PHI,CIN09,6,3,9
CIN200604030,2006,60403,CIN,CHN,CIN09,16,7,23
CIN200604050,2006,60405,CIN,CHN,CIN09,6,8,14
CIN200604060,2006,60406,CIN,PIT,CIN09,5,6,11
CIN200604070,2006,60407,CIN,PIT,CIN09,6,7,13
CIN200604080,2006,60408,CIN,PIT,CIN09,9,11,20
CIN200604090,2006,60409,CIN,PIT,CIN09,5,3,8
CIN200604170,2006,60417,CIN,FLO,CIN09,1,9,10
CIN200604180,2006,60418,CIN,FLO,CIN09,12,6,18
CIN200604190,2006,60419,CIN,FLO,CIN09,8,9,17
CIN200604280,2006,60428,CIN,HOU,CIN09,4,5,9
CIN200604290,2006,60429,CIN,HOU,CIN09,3,6,9
CIN200604300,2006,60430,CIN,HOU,CIN09,3,2,5
CIN200605010,2006,60501,CIN,SLN,CIN09,1,6,7
CIN200605020,2006,60502,CIN,SLN,CIN09,2,3,5
CIN200605090,2006,60509,CIN,WAS,CIN09,7,1,8
CIN200605100,2006,60510,CIN,WAS,CIN09,6,9,15
CIN200605110,2006,60511,CIN,WAS,CIN09,4,5,9
CIN200605120,2006,60512,CIN,PHI,CIN09,8,4,12
CIN200605130,2006,60513,CIN,PHI,CIN09,2,0,2
CIN200605140,2006,60514,CIN,PHI,CIN09,2,1,3
CIN200605220,2006,60522,CIN,MIL,CIN09,5,15,20
CIN200605230,2006,60523,CIN,MIL,CIN09,3,7,10
CIN200605240,2006,60524,CIN,MIL,CIN09,6,2,8
CIN200605260,2006,60526,CIN,ARI,CIN09,3,0,3
CIN200605270,2006,60527,CIN,ARI,CIN09,7,0,7
CIN200605280,2006,60528,CIN,ARI,CIN09,4,5,9
CIN200606080,2006,60608,CIN,CHN,CIN09,1,7,8
CIN200606090,2006,60609,CIN,CHN,CIN09,6,5,11
CIN200606100,2006,60610,CIN,CHN,CIN09,4,2,6
CIN200606110,2006,60611,CIN,CHN,CIN09,9,3,12
CIN200606120,2006,60612,CIN,MIL,CIN09,6,5,11
CIN200606130,2006,60613,CIN,MIL,CIN09,6,4,10
CIN200606140,2006,60614,CIN,MIL,CIN09,0,3,3
CIN200606160,2006,60616,CIN,CHA,CIN09,12,4,16
CIN200606170,2006,60617,CIN,CHA,CIN09,8,6,14
CIN200606180,2006,60618,CIN,CHA,CIN09,8,1,9
CIN200606270,2006,60627,CIN,KCA,CIN09,9,8,17
CIN200606280,2006,60628,CIN,KCA,CIN09,2,7,9
CIN200606290,2006,60629,CIN,KCA,CIN09,5,6,11
CIN200606300,2006,60630,CIN,CLE,CIN09,8,9,17
CIN200607010,2006,60701,CIN,CLE,CIN09,12,7,19
CIN200607020,2006,60702,CIN,CLE,CIN09,6,3,9
CIN200607130,2006,60713,CIN,COL,CIN09,7,9,16
CIN200607140,2006,60714,CIN,COL,CIN09,1,3,4
CIN200607150,2006,60715,CIN,COL,CIN09,2,3,5
CIN200607160,2006,60716,CIN,COL,CIN09,4,6,10
CIN200607180,2006,60718,CIN,NYN,CIN09,8,3,11
CIN200607190,2006,60719,CIN,NYN,CIN09,4,7,11
CIN200607200,2006,60720,CIN,NYN,CIN09,4,2,6
CIN200607210,2006,60721,CIN,MIL,CIN09,5,6,11
CIN200607220,2006,60722,CIN,MIL,CIN09,7,8,15
CIN200607230,2006,60723,CIN,MIL,CIN09,4,1,5
CIN200608010,2006,60801,CIN,LAN,CIN09,10,4,14
CIN200608020,2006,60802,CIN,LAN,CIN09,5,3,8
CIN200608030,2006,60803,CIN,LAN,CIN09,3,0,3
CIN200608040,2006,60804,CIN,ATL,CIN09,4,5,9
CIN200608050,2006,60805,CIN,ATL,CIN09,6,8,14
CIN200608060,2006,60806,CIN,ATL,CIN09,6,4,10
CIN200608070,2006,60807,CIN,SLN,CIN09,13,1,14
CIN200608080,2006,60808,CIN,SLN,CIN09,3,10,13
CIN200608090,2006,60809,CIN,SLN,CIN09,7,8,15
CIN200608100,2006,60810,CIN,SLN,CIN09,6,1,7
CIN200608180,2006,60818,CIN,PIT,CIN09,7,3,10
CIN200608190,2006,60819,CIN,PIT,CIN09,7,14,21
CIN200608200,2006,60820,CIN,PIT,CIN09,1,5,6
CIN200608210,2006,60821,CIN,HOU,CIN09,3,4,7
CIN200608220,2006,60822,CIN,HOU,CIN09,0,14,14
CIN200608230,2006,60823,CIN,HOU,CIN09,7,3,10
CIN200609040,2006,60904,CIN,SFN,CIN09,5,4,9
CIN200609050,2006,60905,CIN,SFN,CIN09,0,3,3
CIN200609060,2006,60906,CIN,SFN,CIN09,3,2,5
CIN200609080,2006,60908,CIN,PIT,CIN09,1,9,10
CIN200609090,2006,60909,CIN,PIT,CIN09,7,4,11
CIN200609100,2006,60910,CIN,PIT,CIN09,2,4,6
CIN200609120,2006,60912,CIN,SDN,CIN09,4,5,9
CIN200609130,2006,60913,CIN,SDN,CIN09,10,0,10
CIN200609140,2006,60914,CIN,SDN,CIN09,4,2,6
CIN200609220,2006,60922,CIN,CHN,CIN09,2,4,6
CIN200609230,2006,60923,CIN,CHN,CIN09,11,4,15
CIN200609240,2006,60924,CIN,CHN,CIN09,2,3,5
CIN200609250,2006,60925,CIN,CHN,CIN09,4,5,9
CIN200704020,2007,70402,CIN,CHN,CIN09,1,5,6
CIN200704040,2007,70404,CIN,CHN,CIN09,4,1,5
CIN200704050,2007,70405,CIN,CHN,CIN09,2,5,7
CIN200704060,2007,70406,CIN,PIT,CIN09,1,6,7
CIN200704070,2007,70407,CIN,PIT,CIN09,5,7,12
CIN200704080,2007,70408,CIN,PIT,CIN09,6,3,9
CIN200704160,2007,70416,CIN,MIL,CIN09,10,6,16
CIN200704170,2007,70417,CIN,MIL,CIN09,5,11,16
CIN200704180,2007,70418,CIN,HOU,CIN09,7,2,9
CIN200704190,2007,70419,CIN,HOU,CIN09,8,6,14
CIN200704200,2007,70420,CIN,PHI,CIN09,1,2,3
CIN200704210,2007,70421,CIN,PHI,CIN09,4,1,5
CIN200704220,2007,70422,CIN,PHI,CIN09,9,3,12
CIN200705040,2007,70504,CIN,COL,CIN09,6,5,11
CIN200705050,2007,70505,CIN,COL,CIN09,9,7,16
CIN200705060,2007,70506,CIN,COL,CIN09,3,9,12
CIN200705070,2007,70507,CIN,HOU,CIN09,5,4,9
CIN200705080,2007,70508,CIN,HOU,CIN09,7,6,13
CIN200705090,2007,70509,CIN,HOU,CIN09,3,2,5
CIN200705100,2007,70510,CIN,HOU,CIN09,5,9,14
CIN200705210,2007,70521,CIN,WAS,CIN09,7,8,15
CIN200705220,2007,70522,CIN,WAS,CIN09,8,4,12
CIN200705230,2007,70523,CIN,WAS,CIN09,12,7,19
CIN200705240,2007,70524,CIN,WAS,CIN09,4,3,7
CIN200705250,2007,70525,CIN,PIT,CIN09,10,4,14
CIN200705260,2007,70526,CIN,PIT,CIN09,9,5,14
CIN200705270,2007,70527,CIN,PIT,CIN09,14,10,24
CIN200705280,2007,70528,CIN,PIT,CIN09,0,4,4
CIN200706080,2007,70608,CIN,CLE,CIN09,3,4,7
CIN200706090,2007,70609,CIN,CLE,CIN09,8,6,14
CIN200706100,2007,70610,CIN,CLE,CIN09,0,1,1
CIN200706120,2007,70612,CIN,ANA,CIN09,3,5,8
CIN200706130,2007,70613,CIN,ANA,CIN09,6,3,9
CIN200706140,2007,70614,CIN,ANA,CIN09,9,7,16
CIN200706150,2007,70615,CIN,TEX,CIN09,7,6,13
CIN200706160,2007,70616,CIN,TEX,CIN09,4,8,12
CIN200706170,2007,70617,CIN,TEX,CIN09,11,4,15
CIN200706290,2007,70629,CIN,SLN,CIN09,4,2,6
CIN200706300,2007,70630,CIN,SLN,CIN09,1,5,6
CIN200707010,2007,70701,CIN,SLN,CIN09,11,7,18
CIN200707030,2007,70703,CIN,SFN,CIN09,3,7,10
CIN200707040,2007,70704,CIN,SFN,CIN09,9,5,14
CIN200707050,2007,70705,CIN,SFN,CIN09,3,6,9
CIN200707060,2007,70706,CIN,ARI,CIN09,1,8,9
CIN200707070,2007,70707,CIN,ARI,CIN09,4,5,9
CIN200707080,2007,70708,CIN,ARI,CIN09,3,4,7
CIN200707230,2007,70723,CIN,MIL,CIN09,1,2,3
CIN200707240,2007,70724,CIN,MIL,CIN09,5,3,8
CIN200707250,2007,70725,CIN,MIL,CIN09,3,7,10
CIN200707260,2007,70726,CIN,MIL,CIN09,5,6,11
CIN200707270,2007,70727,CIN,CHN,CIN09,4,5,9
CIN200707280,2007,70728,CIN,CHN,CIN09,8,1,9
CIN200707290,2007,70729,CIN,CHN,CIN09,6,0,6
CIN200708070,2007,70807,CIN,LAN,CIN09,0,4,4
CIN200708080,2007,70808,CIN,LAN,CIN09,0,1,1
CIN200708090,2007,70809,CIN,LAN,CIN09,5,4,9
CIN200708100,2007,70810,CIN,SDN,CIN09,12,7,19
CIN200708110,2007,70811,CIN,SDN,CIN09,3,8,11
CIN200708120,2007,70812,CIN,SDN,CIN09,10,4,14
CIN200708200,2007,70820,CIN,ATL,CIN09,14,4,18
CIN200708210,2007,70821,CIN,ATL,CIN09,7,8,15
CIN200708220,2007,70822,CIN,ATL,CIN09,2,4,6
CIN200708230,2007,70823,CIN,ATL,CIN09,7,9,16
CIN200708240,2007,70824,CIN,FLO,CIN09,3,5,8
CIN200708250,2007,70825,CIN,FLO,CIN09,7,11,18
CIN200708260,2007,70826,CIN,FLO,CIN09,3,9,12
CIN200709030,2007,70903,CIN,NYN,CIN09,10,4,14
CIN200709040,2007,70904,CIN,NYN,CIN09,11,7,18
CIN200709050,2007,70905,CIN,NYN,CIN09,0,7,7
CIN200709070,2007,70907,CIN,MIL,CIN09,4,11,15
CIN200709080,2007,70908,CIN,MIL,CIN09,4,3,7
CIN200709090,2007,70909,CIN,MIL,CIN09,10,5,15
CIN200709110,2007,70911,CIN,SLN,CIN09,2,7,9
CIN200709120,2007,70912,CIN,SLN,CIN09,1,5,6
CIN200709130,2007,70913,CIN,SLN,CIN09,4,5,9
CIN200709250,2007,70925,CIN,HOU,CIN09,8,5,13
CIN200709260,2007,70926,CIN,HOU,CIN09,7,6,13
CIN200709270,2007,70927,CIN,HOU,CIN09,4,3,7
CIN200709280,2007,70928,CIN,CHN,CIN09,6,0,6
CIN200709290,2007,70929,CIN,CHN,CIN09,4,0,4
CIN200709300,2007,70930,CIN,CHN,CIN09,4,8,12
CIN200803310,2008,80331,CIN,ARI,CIN09,4,2,6
CIN200804020,2008,80402,CIN,ARI,CIN09,5,6,11
CIN200804030,2008,80403,CIN,ARI,CIN09,2,3,5
CIN200804040,2008,80404,CIN,PHI,CIN09,8,4,12
CIN200804050,2008,80405,CIN,PHI,CIN09,3,4,7
CIN200804060,2008,80406,CIN,PHI,CIN09,2,8,10
CIN200804070,2008,80407,CIN,PHI,CIN09,5,3,8
CIN200804180,2008,80418,CIN,MIL,CIN09,5,2,7
CIN200804190,2008,80419,CIN,MIL,CIN09,5,3,8
CIN200804200,2008,80420,CIN,MIL,CIN09,3,4,7
CIN200804210,2008,80421,CIN,LAN,CIN09,9,3,12
CIN200804220,2008,80422,CIN,LAN,CIN09,1,8,9
CIN200804230,2008,80423,CIN,HOU,CIN09,9,3,12
CIN200804240,2008,80424,CIN,HOU,CIN09,5,3,8
CIN200805050,2008,80505,CIN,CHN,CIN09,3,5,8
CIN200805060,2008,80506,CIN,CHN,CIN09,3,0,3
CIN200805070,2008,80507,CIN,CHN,CIN09,0,9,9
CIN200805120,2008,80512,CIN,FLO,CIN09,7,8,15
CIN200805130,2008,80513,CIN,FLO,CIN09,3,5,8
CIN200805140,2008,80514,CIN,FLO,CIN09,6,7,13
CIN200805160,2008,80516,CIN,CLE,CIN09,3,4,7
CIN200805170,2008,80517,CIN,CLE,CIN09,2,4,6
CIN200805180,2008,80518,CIN,CLE,CIN09,4,6,10
CIN200805270,2008,80527,CIN,PIT,CIN09,6,9,15
CIN200805280,2008,80528,CIN,PIT,CIN09,1,9,10
CIN200805290,2008,80529,CIN,PIT,CIN09,7,2,9
CIN200805300,2008,80530,CIN,ATL,CIN09,2,3,5
CIN200805310,2008,80531,CIN,ATL,CIN09,7,8,15
CIN200806010,2008,80601,CIN,ATL,CIN09,2,6,8
CIN200806100,2008,80610,CIN,SLN,CIN09,7,2,9
CIN200806110,2008,80611,CIN,SLN,CIN09,10,0,10
CIN200806120,2008,80612,CIN,SLN,CIN09,2,6,8
CIN200806130,2008,80613,CIN,BOS,CIN09,1,3,4
CIN200806140,2008,80614,CIN,BOS,CIN09,6,4,10
CIN200806150,2008,80615,CIN,BOS,CIN09,9,0,9
CIN200806170,2008,80617,CIN,LAN,CIN09,3,1,4
CIN200806180,2008,80618,CIN,LAN,CIN09,6,1,7
CIN200806190,2008,80619,CIN,LAN,CIN09,7,4,11
CIN200806300,2008,80630,CIN,PIT,CIN09,3,4,7
CIN200807010,2008,80701,CIN,PIT,CIN09,6,5,11
CIN200807020,2008,80702,CIN,PIT,CIN09,9,5,14
CIN200807030,2008,80703,CIN,WAS,CIN09,3,5,8
CIN200807040,2008,80704,CIN,WAS,CIN09,0,3,3
CIN200807050,2008,80705,CIN,WAS,CIN09,2,3,5
CIN200807060,2008,80706,CIN,WAS,CIN09,5,6,11
CIN200807170,2008,80717,CIN,NYN,CIN09,10,8,18
CIN200807180,2008,80718,CIN,NYN,CIN09,2,5,7
CIN200807190,2008,80719,CIN,NYN,CIN09,2,7,9
CIN200807200,2008,80720,CIN,NYN,CIN09,7,5,12
CIN200807210,2008,80721,CIN,SDN,CIN09,6,4,10
CIN200807220,2008,80722,CIN,SDN,CIN09,3,4,7
CIN200807230,2008,80723,CIN,SDN,CIN09,5,9,14
CIN200807250,2008,80725,CIN,COL,CIN09,7,2,9
CIN200807260,2008,80726,CIN,COL,CIN09,5,1,6
CIN200807270,2008,80727,CIN,COL,CIN09,11,0,11
CIN200808040,2008,80804,CIN,MIL,CIN09,3,6,9
CIN200808050,2008,80805,CIN,MIL,CIN09,8,1,9
CIN200808060,2008,80806,CIN,MIL,CIN09,6,3,9
CIN200808070,2008,80807,CIN,HOU,CIN09,7,4,11
CIN200808080,2008,80808,CIN,HOU,CIN09,9,5,14
CIN200808090,2008,80809,CIN,HOU,CIN09,3,1,4
CIN200808100,2008,80810,CIN,HOU,CIN09,13,4,17
CIN200808150,2008,80815,CIN,SLN,CIN09,5,3,8
CIN200808160,2008,80816,CIN,SLN,CIN09,9,3,12
CIN200808170,2008,80817,CIN,SLN,CIN09,3,7,10
CIN200808290,2008,80829,CIN,SFN,CIN09,7,11,18
CIN200808300,2008,80830,CIN,SFN,CIN09,6,7,13
CIN200808310,2008,80831,CIN,SFN,CIN09,3,9,12
CIN200809020,2008,80902,CIN,PIT,CIN09,3,2,5
CIN200809030,2008,80903,CIN,PIT,CIN09,6,5,11
CIN200809040,2008,80904,CIN,PIT,CIN09,6,8,14
CIN200809050,2008,80905,CIN,CHN,CIN09,2,10,12
CIN200809060,2008,80906,CIN,CHN,CIN09,14,9,23
CIN200809070,2008,80907,CIN,CHN,CIN09,3,4,7
CIN200809160,2008,80916,CIN,SLN,CIN09,2,7,9
CIN200809170,2008,80917,CIN,SLN,CIN09,0,3,3
CIN200809180,2008,80918,CIN,SLN,CIN09,5,4,9
CIN200809190,2008,80919,CIN,MIL,CIN09,2,11,13
CIN200809200,2008,80920,CIN,MIL,CIN09,3,4,7
CIN200809210,2008,80921,CIN,MIL,CIN09,8,1,9
CIN200809220,2008,80922,CIN,FLO,CIN09,5,7,12
CIN200904060,2009,90406,CIN,NYN,CIN09,2,1,3
CIN200904080,2009,90408,CIN,NYN,CIN09,9,7,16
CIN200904090,2009,90409,CIN,NYN,CIN09,6,8,14
CIN200904110,2009,90411,CIN,PIT,CIN09,10,2,12
CIN200904120,2009,90412,CIN,PIT,CIN09,0,2,2
CIN200904240,2009,90424,CIN,ATL,CIN09,4,3,7
CIN200904250,2009,90425,CIN,ATL,CIN09,10,2,12
CIN200904260,2009,90426,CIN,ATL,CIN09,2,8,10
CIN200904270,2009,90427,CIN,HOU,CIN09,4,1,5
CIN200904280,2009,90428,CIN,HOU,CIN09,8,3,11
CIN200904290,2009,90429,CIN,HOU,CIN09,0,3,3
CIN200905060,2009,90506,CIN,MIL,CIN09,15,3,18
CIN200905070,2009,90507,CIN,MIL,CIN09,5,6,11
CIN200905080,2009,90508,CIN,SLN,CIN09,4,6,10
CIN200905090,2009,90509,CIN,SLN,CIN09,3,8,11
CIN200905100,2009,90510,CIN,SLN,CIN09,8,7,15
CIN200905190,2009,90519,CIN,PHI,CIN09,4,3,7
CIN200905200,2009,90520,CIN,PHI,CIN09,1,5,6
CIN200905210,2009,90521,CIN,PHI,CIN09,12,5,17
CIN200905220,2009,90522,CIN,CLE,CIN09,1,3,4
CIN200905230,2009,90523,CIN,CLE,CIN09,7,6,13
CIN200905240,2009,90524,CIN,CLE,CIN09,3,4,7
CIN200905250,2009,90525,CIN,HOU,CIN09,5,8,13
CIN200905260,2009,90526,CIN,HOU,CIN09,4,6,10
CIN200905270,2009,90527,CIN,HOU,CIN09,1,6,7
CIN200906050,2009,90605,CIN,CHN,CIN09,2,1,3
CIN200906060,2009,90606,CIN,CHN,CIN09,3,4,7
CIN200906070,2009,90607,CIN,CHN,CIN09,6,3,9
CIN200906160,2009,90616,CIN,ATL,CIN09,2,7,9
CIN200906170,2009,90617,CIN,ATL,CIN09,3,4,7
CIN200906180,2009,90618,CIN,ATL,CIN09,7,0,7
CIN200906190,2009,90619,CIN,CHA,CIN09,3,4,7
CIN200906200,2009,90620,CIN,CHA,CIN09,10,8,18
CIN200906210,2009,90621,CIN,CHA,CIN09,4,1,5
CIN200906300,2009,90630,CIN,ARI,CIN09,6,2,8
CIN200907010,2009,90701,CIN,ARI,CIN09,0,1,1
CIN200907020,2009,90702,CIN,ARI,CIN09,2,3,5
CIN200907030,2009,90703,CIN,SLN,CIN09,7,4,11
CIN200907040,2009,90704,CIN,SLN,CIN09,2,5,7
CIN200907050,2009,90705,CIN,SLN,CIN09,10,1,11
CIN200907160,2009,90716,CIN,MIL,CIN09,9,6,15
CIN200907170,2009,90717,CIN,MIL,CIN09,0,4,4
CIN200907180,2009,90718,CIN,MIL,CIN09,5,1,6
CIN200907190,2009,90719,CIN,MIL,CIN09,3,5,8
CIN200907270,2009,90727,CIN,SDN,CIN09,4,6,10
CIN200907280,2009,90728,CIN,SDN,CIN09,3,2,5
CIN200907290,2009,90729,CIN,SDN,CIN09,7,1,8
CIN200907300,2009,90730,CIN,SDN,CIN09,7,4,11
CIN200907310,2009,90731,CIN,COL,CIN09,5,3,8
CIN200908010,2009,90801,CIN,COL,CIN09,6,2,8
CIN200908020,2009,90802,CIN,COL,CIN09,6,4,10
CIN200908030,2009,90803,CIN,CHN,CIN09,4,2,6
CIN200908040,2009,90804,CIN,CHN,CIN09,6,3,9
CIN200908050,2009,90805,CIN,CHN,CIN09,0,4,4
CIN200908130,2009,90813,CIN,WAS,CIN09,0,7,7
CIN200908140,2009,90814,CIN,WAS,CIN09,2,0,2
CIN200908150,2009,90815,CIN,WAS,CIN09,10,6,16
CIN200908160,2009,90816,CIN,WAS,CIN09,5,4,9
CIN200908180,2009,90818,CIN,SFN,CIN09,8,5,13
CIN200908190,2009,90819,CIN,SFN,CIN09,1,0,1
CIN200908200,2009,90820,CIN,SFN,CIN09,1,2,3
CIN200908280,2009,90828,CIN,LAN,CIN09,2,4,6
CIN200908290,2009,90829,CIN,LAN,CIN09,11,4,15
CIN200908300,2009,90830,CIN,LAN,CIN09,3,2,5
CIN200908311,2009,90831,CIN,PIT,CIN09,3,4,7
CIN200908312,2009,90831,CIN,PIT,CIN09,3,6,9
CIN200909010,2009,90901,CIN,PIT,CIN09,5,11,16
CIN200909020,2009,90902,CIN,PIT,CIN09,3,5,8
CIN200909140,2009,90914,CIN,HOU,CIN09,1,3,4
CIN200909150,2009,90915,CIN,HOU,CIN09,4,5,9
CIN200909160,2009,90916,CIN,HOU,CIN09,5,6,11
CIN200909170,2009,90917,CIN,FLO,CIN09,2,3,5
CIN200909180,2009,90918,CIN,FLO,CIN09,4,3,7
CIN200909190,2009,90919,CIN,FLO,CIN09,3,2,5
CIN200909200,2009,90920,CIN,FLO,CIN09,1,8,9
CIN200909290,2009,90929,CIN,SLN,CIN09,2,7,9
CIN200909300,2009,90930,CIN,SLN,CIN09,1,6,7
CIN200910010,2009,91001,CIN,SLN,CIN09,13,0,13
CIN200910020,2009,91002,CIN,PIT,CIN09,3,1,4
CIN200910030,2009,91003,CIN,PIT,CIN09,4,8,12
CIN200910040,2009,91004,CIN,PIT,CIN09,0,6,6
CLE200004140,2000,414,CLE,TEX,CLE08,7,2,9
CLE200004150,2000,415,CLE,TEX,CLE08,6,4,10
CLE200004160,2000,416,CLE,TEX,CLE08,1,2,3
CLE200004180,2000,418,CLE,OAK,CLE08,8,5,13
CLE200004190,2000,419,CLE,OAK,CLE08,10,5,15
CLE200004200,2000,420,CLE,OAK,CLE08,5,9,14
CLE200004280,2000,428,CLE,BOS,CLE08,3,4,7
CLE200004290,2000,429,CLE,BOS,CLE08,2,3,5
CLE200004300,2000,430,CLE,BOS,CLE08,2,1,3
CLE200005010,2000,501,CLE,NYA,CLE08,2,1,3
CLE200005020,2000,502,CLE,NYA,CLE08,4,2,6
CLE200005030,2000,503,CLE,NYA,CLE08,6,5,11
CLE200005110,2000,511,CLE,KCA,CLE08,0,16,16
CLE200005120,2000,512,CLE,KCA,CLE08,3,7,10
CLE200005130,2000,513,CLE,KCA,CLE08,6,7,13
CLE200005140,2000,514,CLE,KCA,CLE08,5,4,9
CLE200005160,2000,516,CLE,DET,CLE08,9,11,20
CLE200005170,2000,517,CLE,DET,CLE08,2,7,9
CLE200005190,2000,519,CLE,NYA,CLE08,11,7,18
CLE200005200,2000,520,CLE,NYA,CLE08,2,3,5
CLE200005210,2000,521,CLE,NYA,CLE08,1,6,7
CLE200005290,2000,529,CLE,ANA,CLE08,3,2,5
CLE200005300,2000,530,CLE,ANA,CLE08,1,6,7
CLE200005310,2000,531,CLE,ANA,CLE08,3,7,10
CLE200006090,2000,609,CLE,CIN,CLE08,4,7,11
CLE200006100,2000,610,CLE,CIN,CLE08,5,6,11
CLE200006110,2000,611,CLE,CIN,CLE08,7,5,12
CLE200006120,2000,612,CLE,CHA,CLE08,8,7,15
CLE200006130,2000,613,CLE,CHA,CLE08,4,3,7
CLE200006140,2000,614,CLE,CHA,CLE08,11,4,15
CLE200006230,2000,623,CLE,DET,CLE08,7,6,13
CLE200006241,2000,624,CLE,DET,CLE08,1,8,9
CLE200006242,2000,624,CLE,DET,CLE08,14,8,22
CLE200006250,2000,625,CLE,DET,CLE08,1,2,3
CLE200006260,2000,626,CLE,DET,CLE08,13,2,15
CLE200006300,2000,630,CLE,MIN,CLE08,7,2,9
CLE200007010,2000,701,CLE,MIN,CLE08,4,3,7
CLE200007020,2000,702,CLE,MIN,CLE08,1,7,8
CLE200007040,2000,704,CLE,TOR,CLE08,4,9,13
CLE200007050,2000,705,CLE,TOR,CLE08,7,15,22
CLE200007060,2000,706,CLE,TOR,CLE08,9,6,15
CLE200007130,2000,713,CLE,PIT,CLE08,3,4,7
CLE200007140,2000,714,CLE,PIT,CLE08,3,9,12
CLE200007150,2000,715,CLE,PIT,CLE08,4,6,10
CLE200007160,2000,716,CLE,HOU,CLE08,5,1,6
CLE200007170,2000,717,CLE,HOU,CLE08,6,8,14
CLE200007180,2000,718,CLE,HOU,CLE08,2,8,10
CLE200007190,2000,719,CLE,KCA,CLE08,10,5,15
CLE200007200,2000,720,CLE,KCA,CLE08,10,6,16
CLE200008040,2000,804,CLE,ANA,CLE08,10,11,21
CLE200008050,2000,805,CLE,ANA,CLE08,3,6,9
CLE200008060,2000,806,CLE,ANA,CLE08,2,5,7
CLE200008070,2000,807,CLE,TEX,CLE08,0,2,2
CLE200008080,2000,808,CLE,TEX,CLE08,11,2,13
CLE200008090,2000,809,CLE,TEX,CLE08,4,6,10
CLE200008180,2000,818,CLE,SEA,CLE08,8,9,17
CLE200008190,2000,819,CLE,SEA,CLE08,4,10,14
CLE200008200,2000,820,CLE,SEA,CLE08,4,12,16
CLE200008220,2000,822,CLE,OAK,CLE08,6,14,20
CLE200008230,2000,823,CLE,OAK,CLE08,5,7,12
CLE200008240,2000,824,CLE,OAK,CLE08,11,7,18
CLE200009010,2000,901,CLE,BAL,CLE08,2,5,7
CLE200009020,2000,902,CLE,BAL,CLE08,8,6,14
CLE200009030,2000,903,CLE,BAL,CLE08,11,12,23
CLE200009040,2000,904,CLE,TBA,CLE08,1,5,6
CLE200009050,2000,905,CLE,TBA,CLE08,4,7,11
CLE200009060,2000,906,CLE,TBA,CLE08,2,6,8
CLE200009070,2000,907,CLE,TBA,CLE08,4,3,7
CLE200009080,2000,908,CLE,CHA,CLE08,5,4,9
CLE200009090,2000,909,CLE,CHA,CLE08,3,9,12
CLE200009120,2000,912,CLE,BOS,CLE08,8,6,14
CLE200009130,2000,913,CLE,BOS,CLE08,3,10,13
CLE200009140,2000,914,CLE,BOS,CLE08,7,4,11
CLE200009251,2000,925,CLE,CHA,CLE08,2,9,11
CLE200009252,2000,925,CLE,MIN,CLE08,4,3,7
CLE200009260,2000,926,CLE,MIN,CLE08,2,4,6
CLE200009270,2000,927,CLE,MIN,CLE08,2,8,10
CLE200009280,2000,928,CLE,MIN,CLE08,4,3,7
CLE200009290,2000,929,CLE,TOR,CLE08,4,8,12
CLE200009300,2000,930,CLE,TOR,CLE08,5,6,11
CLE200010010,2000,1001,CLE,TOR,CLE08,4,11,15
CLE200104020,2001,10402,CLE,CHA,CLE08,7,4,11
CLE200104040,2001,10404,CLE,CHA,CLE08,4,8,12
CLE200104060,2001,10406,CLE,BAL,CLE08,3,4,7
CLE200104070,2001,10407,CLE,BAL,CLE08,4,2,6
CLE200104080,2001,10408,CLE,BAL,CLE08,3,4,7
CLE200104200,2001,10420,CLE,DET,CLE08,4,5,9
CLE200104210,2001,10421,CLE,DET,CLE08,4,5,9
CLE200104220,2001,10422,CLE,DET,CLE08,3,11,14
CLE200104240,2001,10424,CLE,ANA,CLE08,7,2,9
CLE200104250,2001,10425,CLE,ANA,CLE08,3,1,4
CLE200104260,2001,10426,CLE,ANA,CLE08,5,6,11
CLE200104270,2001,10427,CLE,TEX,CLE08,11,9,20
CLE200104280,2001,10428,CLE,TEX,CLE08,3,7,10
CLE200104290,2001,10429,CLE,TEX,CLE08,2,9,11
CLE200105080,2001,10508,CLE,KCA,CLE08,4,8,12
CLE200105090,2001,10509,CLE,KCA,CLE08,1,5,6
CLE200105100,2001,10510,CLE,KCA,CLE08,8,3,11
CLE200105110,2001,10511,CLE,TBA,CLE08,6,10,16
CLE200105120,2001,10512,CLE,TBA,CLE08,0,8,8
CLE200105130,2001,10513,CLE,TBA,CLE08,7,0,7
CLE200105220,2001,10522,CLE,DET,CLE08,3,0,3
CLE200105230,2001,10523,CLE,DET,CLE08,3,4,7
CLE200105240,2001,10524,CLE,DET,CLE08,5,8,13
CLE200105250,2001,10525,CLE,NYA,CLE08,4,6,10
CLE200105260,2001,10526,CLE,NYA,CLE08,12,5,17
CLE200105270,2001,10527,CLE,NYA,CLE08,6,2,8
CLE200106080,2001,10608,CLE,CIN,CLE08,7,4,11
CLE200106090,2001,10609,CLE,CIN,CLE08,2,10,12
CLE200106100,2001,10610,CLE,CIN,CLE08,9,3,12
CLE200106120,2001,10612,CLE,MIL,CLE08,4,2,6
CLE200106130,2001,10613,CLE,MIL,CLE08,2,5,7
CLE200106140,2001,10614,CLE,MIL,CLE08,9,4,13
CLE200106190,2001,10619,CLE,MIN,CLE08,10,9,19
CLE200106200,2001,10620,CLE,MIN,CLE08,2,4,6
CLE200106210,2001,10621,CLE,MIN,CLE08,6,9,15
CLE200106290,2001,10629,CLE,KCA,CLE08,5,3,8
CLE200106300,2001,10630,CLE,KCA,CLE08,11,7,18
CLE200107010,2001,10701,CLE,KCA,CLE08,13,11,24
CLE200107020,2001,10702,CLE,KCA,CLE08,1,2,3
CLE200107030,2001,10703,CLE,BOS,CLE08,1,9,10
CLE200107040,2001,10704,CLE,BOS,CLE08,13,4,17
CLE200107050,2001,10705,CLE,BOS,CLE08,5,4,9
CLE200107060,2001,10706,CLE,SLN,CLE08,2,14,16
CLE200107070,2001,10707,CLE,SLN,CLE08,6,7,13
CLE200107080,2001,10708,CLE,SLN,CLE08,4,3,7
CLE200107200,2001,10720,CLE,DET,CLE08,7,3,10
CLE200107210,2001,10721,CLE,DET,CLE08,4,8,12
CLE200107220,2001,10722,CLE,DET,CLE08,3,6,9
CLE200107230,2001,10723,CLE,CHA,CLE08,0,2,2
CLE200107240,2001,10724,CLE,CHA,CLE08,4,1,5
CLE200107250,2001,10725,CLE,CHA,CLE08,5,7,12
CLE200107260,2001,10726,CLE,CHA,CLE08,5,4,9
CLE200107310,2001,10731,CLE,OAK,CLE08,11,2,13
CLE200108010,2001,10801,CLE,OAK,CLE08,5,6,11
CLE200108020,2001,10802,CLE,OAK,CLE08,17,4,21
CLE200108030,2001,10803,CLE,SEA,CLE08,2,1,3
CLE200108040,2001,10804,CLE,SEA,CLE08,8,5,13
CLE200108050,2001,10805,CLE,SEA,CLE08,14,15,29
CLE200108060,2001,10806,CLE,SEA,CLE08,8,6,14
CLE200108140,2001,10814,CLE,MIN,CLE08,7,8,15
CLE200108150,2001,10815,CLE,MIN,CLE08,2,8,10
CLE200108160,2001,10816,CLE,MIN,CLE08,1,6,7
CLE200108170,2001,10817,CLE,ANA,CLE08,7,2,9
CLE200108180,2001,10818,CLE,ANA,CLE08,2,4,6
CLE200108190,2001,10819,CLE,ANA,CLE08,4,1,5
CLE200108280,2001,10828,CLE,BOS,CLE08,3,8,11
CLE200108290,2001,10829,CLE,BOS,CLE08,1,2,3
CLE200108300,2001,10830,CLE,BOS,CLE08,1,3,4
CLE200109070,2001,10907,CLE,CHA,CLE08,10,7,17
CLE200109080,2001,10908,CLE,CHA,CLE08,7,8,15
CLE200109090,2001,10909,CLE,CHA,CLE08,8,9,17
CLE200109100,2001,10910,CLE,CHA,CLE08,7,1,8
CLE200109180,2001,10918,CLE,KCA,CLE08,2,11,13
CLE200109190,2001,10919,CLE,KCA,CLE08,3,11,14
CLE200109200,2001,10920,CLE,KCA,CLE08,4,2,6
CLE200109240,2001,10924,CLE,TOR,CLE08,3,2,5
CLE200109250,2001,10925,CLE,TOR,CLE08,7,11,18
CLE200109280,2001,10928,CLE,MIN,CLE08,1,0,1
CLE200109290,2001,10929,CLE,MIN,CLE08,8,9,17
CLE200109300,2001,10930,CLE,MIN,CLE08,1,9,10
CLE200110130,2001,11013,CLE,SEA,CLE08,2,17,19
CLE200110140,2001,11014,CLE,SEA,CLE08,6,2,8
CLE200204080,2002,20408,CLE,MIN,CLE08,5,9,14
CLE200204090,2002,20409,CLE,MIN,CLE08,4,5,9
CLE200204100,2002,20410,CLE,MIN,CLE08,3,9,12
CLE200204110,2002,20411,CLE,MIN,CLE08,4,8,12
CLE200204120,2002,20412,CLE,KCA,CLE08,1,3,4
CLE200204130,2002,20413,CLE,KCA,CLE08,7,8,15
CLE200204220,2002,20422,CLE,CHA,CLE08,2,4,6
CLE200204230,2002,20423,CLE,CHA,CLE08,5,1,6
CLE200204240,2002,20424,CLE,CHA,CLE08,9,2,11
CLE200204250,2002,20425,CLE,CHA,CLE08,6,3,9
CLE200204300,2002,20430,CLE,ANA,CLE08,21,2,23
CLE200205010,2002,20501,CLE,ANA,CLE08,7,2,9
CLE200205020,2002,20502,CLE,ANA,CLE08,8,0,8
CLE200205030,2002,20503,CLE,TEX,CLE08,4,2,6
CLE200205040,2002,20504,CLE,TEX,CLE08,0,3,3
CLE200205050,2002,20505,CLE,TEX,CLE08,2,9,11
CLE200205140,2002,20514,CLE,BAL,CLE08,5,6,11
CLE200205150,2002,20515,CLE,BAL,CLE08,1,3,4
CLE200205170,2002,20517,CLE,KCA,CLE08,6,2,8
CLE200205181,2002,20518,CLE,KCA,CLE08,4,2,6
CLE200205182,2002,20518,CLE,KCA,CLE08,1,4,5
CLE200205190,2002,20519,CLE,KCA,CLE08,5,4,9
CLE200205270,2002,20527,CLE,DET,CLE08,4,1,5
CLE200205280,2002,20528,CLE,DET,CLE08,2,4,6
CLE200205290,2002,20529,CLE,DET,CLE08,9,5,14
CLE200205300,2002,20530,CLE,DET,CLE08,7,11,18
CLE200205310,2002,20531,CLE,CHA,CLE08,0,7,7
CLE200206010,2002,20601,CLE,CHA,CLE08,4,8,12
CLE200206020,2002,20602,CLE,CHA,CLE08,3,4,7
CLE200206070,2002,20607,CLE,NYN,CLE08,4,3,7
CLE200206080,2002,20608,CLE,NYN,CLE08,8,6,14
CLE200206090,2002,20609,CLE,NYN,CLE08,3,8,11
CLE200206100,2002,20610,CLE,PHI,CLE08,3,1,4
CLE200206110,2002,20611,CLE,PHI,CLE08,1,5,6
CLE200206120,2002,20612,CLE,PHI,CLE08,7,3,10
CLE200206130,2002,20613,CLE,BAL,CLE08,1,2,3
CLE200206280,2002,20628,CLE,ARI,CLE08,2,8,10
CLE200206290,2002,20629,CLE,ARI,CLE08,4,2,6
CLE200206300,2002,20630,CLE,ARI,CLE08,5,2,7
CLE200207110,2002,20711,CLE,NYA,CLE08,7,4,11
CLE200207120,2002,20712,CLE,NYA,CLE08,1,2,3
CLE200207130,2002,20713,CLE,NYA,CLE08,14,5,19
CLE200207140,2002,20714,CLE,NYA,CLE08,7,10,17
CLE200207150,2002,20715,CLE,CHA,CLE08,1,7,8
CLE200207160,2002,20716,CLE,CHA,CLE08,5,4,9
CLE200207170,2002,20717,CLE,MIN,CLE08,8,5,13
CLE200207180,2002,20718,CLE,MIN,CLE08,8,6,14
CLE200207230,2002,20723,CLE,NYA,CLE08,3,9,12
CLE200207240,2002,20724,CLE,NYA,CLE08,14,7,21
CLE200207260,2002,20726,CLE,DET,CLE08,8,5,13
CLE200207270,2002,20727,CLE,DET,CLE08,5,1,6
CLE200207280,2002,20728,CLE,DET,CLE08,6,9,15
CLE200208060,2002,20806,CLE,TBA,CLE08,2,4,6
CLE200208070,2002,20807,CLE,TBA,CLE08,2,6,8
CLE200208080,2002,20808,CLE,TBA,CLE08,4,2,6
CLE200208090,2002,20809,CLE,TEX,CLE08,3,2,5
CLE200208100,2002,20810,CLE,TEX,CLE08,3,4,7
CLE200208110,2002,20811,CLE,TEX,CLE08,11,5,16
CLE200208190,2002,20819,CLE,OAK,CLE08,8,1,9
CLE200208200,2002,20820,CLE,OAK,CLE08,6,3,9
CLE200208210,2002,20821,CLE,OAK,CLE08,6,0,6
CLE200208220,2002,20822,CLE,OAK,CLE08,9,3,12
CLE200208230,2002,20823,CLE,SEA,CLE08,2,4,6
CLE200208240,2002,20824,CLE,SEA,CLE08,3,5,8
CLE200208250,2002,20825,CLE,SEA,CLE08,12,4,16
CLE200208260,2002,20826,CLE,DET,CLE08,2,8,10
CLE200208270,2002,20827,CLE,DET,CLE08,8,5,13
CLE200208280,2002,20828,CLE,DET,CLE08,1,2,3
CLE200208300,2002,20830,CLE,BOS,CLE08,15,5,20
CLE200208310,2002,20831,CLE,BOS,CLE08,7,8,15
CLE200209010,2002,20901,CLE,BOS,CLE08,7,1,8
CLE200209090,2002,20909,CLE,TOR,CLE08,11,9,20
CLE200209100,2002,20910,CLE,TOR,CLE08,5,4,9
CLE200209110,2002,20911,CLE,TOR,CLE08,6,5,11
CLE200209120,2002,20912,CLE,MIN,CLE08,4,5,9
CLE200209130,2002,20913,CLE,MIN,CLE08,5,12,17
CLE200209140,2002,20914,CLE,MIN,CLE08,3,2,5
CLE200209150,2002,20915,CLE,MIN,CLE08,5,0,5
CLE200209270,2002,20927,CLE,KCA,CLE08,3,8,11
CLE200209280,2002,20928,CLE,KCA,CLE08,5,6,11
CLE200209290,2002,20929,CLE,KCA,CLE08,3,7,10
CLE200304080,2003,30408,CLE,CHA,CLE08,5,3,8
CLE200304090,2003,30409,CLE,CHA,CLE08,2,5,7
CLE200304100,2003,30410,CLE,CHA,CLE08,7,2,9
CLE200304110,2003,30411,CLE,KCA,CLE08,1,0,1
CLE200304120,2003,30412,CLE,KCA,CLE08,5,2,7
CLE200304130,2003,30413,CLE,KCA,CLE08,1,6,7
CLE200304140,2003,30414,CLE,KCA,CLE08,12,4,16
CLE200304150,2003,30415,CLE,BAL,CLE08,3,8,11
CLE200304160,2003,30416,CLE,BAL,CLE08,4,3,7
CLE200304170,2003,30417,CLE,BAL,CLE08,6,4,10
CLE200304290,2003,30429,CLE,ANA,CLE08,10,1,11
CLE200304300,2003,30430,CLE,ANA,CLE08,6,2,8
CLE200305020,2003,30502,CLE,TEX,CLE08,5,6,11
CLE200305030,2003,30503,CLE,TEX,CLE08,6,5,11
CLE200305040,2003,30504,CLE,TEX,CLE08,1,3,4
CLE200305130,2003,30513,CLE,SEA,CLE08,8,3,11
CLE200305140,2003,30514,CLE,SEA,CLE08,2,7,9
CLE200305150,2003,30515,CLE,SEA,CLE08,9,1,10
CLE200305160,2003,30516,CLE,OAK,CLE08,2,3,5
CLE200305170,2003,30517,CLE,OAK,CLE08,2,4,6
CLE200305180,2003,30518,CLE,OAK,CLE08,8,5,13
CLE200305190,2003,30519,CLE,DET,CLE08,9,10,19
CLE200305200,2003,30520,CLE,DET,CLE08,4,6,10
CLE200305210,2003,30521,CLE,DET,CLE08,0,4,4
CLE200305220,2003,30522,CLE,DET,CLE08,3,2,5
CLE200305300,2003,30530,CLE,CHA,CLE08,3,7,10
CLE200306010,2003,30601,CLE,CHA,CLE08,4,5,9
CLE200306020,2003,30602,CLE,CHA,CLE08,2,5,7
CLE200306100,2003,30610,CLE,SDN,CLE08,5,8,13
CLE200306110,2003,30611,CLE,SDN,CLE08,2,3,5
CLE200306120,2003,30612,CLE,SDN,CLE08,9,4,13
CLE200306130,2003,30613,CLE,LAN,CLE08,4,3,7
CLE200306140,2003,30614,CLE,LAN,CLE08,5,2,7
CLE200306150,2003,30615,CLE,LAN,CLE08,4,3,7
CLE200306240,2003,30624,CLE,KCA,CLE08,3,1,4
CLE200306250,2003,30625,CLE,KCA,CLE08,3,1,4
CLE200306260,2003,30626,CLE,KCA,CLE08,4,1,5
CLE200306270,2003,30627,CLE,CIN,CLE08,0,3,3
CLE200306280,2003,30628,CLE,CIN,CLE08,5,4,9
CLE200306290,2003,30629,CLE,CIN,CLE08,1,3,4
CLE200307080,2003,30708,CLE,NYA,CLE08,0,4,4
CLE200307090,2003,30709,CLE,NYA,CLE08,6,2,8
CLE200307100,2003,30710,CLE,NYA,CLE08,2,3,5
CLE200307110,2003,30711,CLE,CHA,CLE08,5,12,17
CLE200307121,2003,30712,CLE,CHA,CLE08,7,4,11
CLE200307122,2003,30712,CLE,CHA,CLE08,2,4,6
CLE200307130,2003,30713,CLE,CHA,CLE08,7,4,11
CLE200307230,2003,30723,CLE,DET,CLE08,1,4,5
CLE200307240,2003,30724,CLE,DET,CLE08,7,4,11
CLE200307250,2003,30725,CLE,MIN,CLE08,6,5,11
CLE200307260,2003,30726,CLE,MIN,CLE08,2,9,11
CLE200307270,2003,30727,CLE,MIN,CLE08,2,3,5
CLE200308050,2003,30805,CLE,SEA,CLE08,2,1,3
CLE200308060,2003,30806,CLE,SEA,CLE08,6,10,16
CLE200308070,2003,30807,CLE,SEA,CLE08,0,3,3
CLE200308080,2003,30808,CLE,ANA,CLE08,5,2,7
CLE200308091,2003,30809,CLE,ANA,CLE08,2,3,5
CLE200308092,2003,30809,CLE,ANA,CLE08,2,3,5
CLE200308100,2003,30810,CLE,ANA,CLE08,1,3,4
CLE200308150,2003,30815,CLE,TBA,CLE08,0,1,1
CLE200308160,2003,30816,CLE,TBA,CLE08,5,3,8
CLE200308170,2003,30817,CLE,TBA,CLE08,4,5,9
CLE200308180,2003,30818,CLE,TBA,CLE08,7,4,11
CLE200308190,2003,30819,CLE,MIN,CLE08,8,2,10
CLE200308200,2003,30820,CLE,MIN,CLE08,4,3,7
CLE200308260,2003,30826,CLE,DET,CLE08,5,4,9
CLE200308270,2003,30827,CLE,DET,CLE08,7,9,16
CLE200308280,2003,30828,CLE,DET,CLE08,3,8,11
CLE200308290,2003,30829,CLE,TOR,CLE08,7,3,10
CLE200308300,2003,30830,CLE,TOR,CLE08,9,3,12
CLE200308310,2003,30831,CLE,TOR,CLE08,4,5,9
CLE200309120,2003,30912,CLE,MIN,CLE08,3,4,7
CLE200309130,2003,30913,CLE,MIN,CLE08,2,0,2
CLE200309140,2003,30914,CLE,MIN,CLE08,5,3,8
CLE200309150,2003,30915,CLE,MIN,CLE08,13,6,19
CLE200309160,2003,30916,CLE,KCA,CLE08,12,8,20
CLE200309170,2003,30917,CLE,KCA,CLE08,1,9,10
CLE200309180,2003,30918,CLE,KCA,CLE08,3,2,5
CLE200309190,2003,30919,CLE,BOS,CLE08,2,0,2
CLE200309200,2003,30920,CLE,BOS,CLE08,4,13,17
CLE200309210,2003,30921,CLE,BOS,CLE08,2,0,2
CLE200404120,2004,40412,CLE,MIN,CLE08,3,6,9
CLE200404140,2004,40414,CLE,MIN,CLE08,10,6,16
CLE200404150,2004,40415,CLE,MIN,CLE08,3,0,3
CLE200404160,2004,40416,CLE,DET,CLE08,3,10,13
CLE200404170,2004,40417,CLE,DET,CLE08,6,1,7
CLE200404180,2004,40418,CLE,DET,CLE08,7,9,16
CLE200404190,2004,40419,CLE,DET,CLE08,10,4,14
CLE200404200,2004,40420,CLE,KCA,CLE08,15,5,20
CLE200404220,2004,40422,CLE,KCA,CLE08,4,5,9
CLE200404300,2004,40430,CLE,BAL,CLE08,2,11,13
CLE200405010,2004,40501,CLE,BAL,CLE08,2,3,5
CLE200405030,2004,40503,CLE,BOS,CLE08,1,2,3
CLE200405040,2004,40504,CLE,BOS,CLE08,6,7,13
CLE200405050,2004,40505,CLE,BOS,CLE08,9,5,14
CLE200405060,2004,40506,CLE,BOS,CLE08,5,2,7
CLE200405140,2004,40514,CLE,TBA,CLE08,7,8,15
CLE200405150,2004,40515,CLE,TBA,CLE08,7,9,16
CLE200405160,2004,40516,CLE,TBA,CLE08,0,10,10
CLE200405170,2004,40517,CLE,CHA,CLE08,2,7,9
CLE200405180,2004,40518,CLE,CHA,CLE08,4,2,6
CLE200405190,2004,40519,CLE,CHA,CLE08,15,3,18
CLE200405250,2004,40525,CLE,SEA,CLE08,5,4,9
CLE200405260,2004,40526,CLE,SEA,CLE08,7,3,10
CLE200405270,2004,40527,CLE,SEA,CLE08,5,9,14
CLE200405280,2004,40528,CLE,OAK,CLE08,0,1,1
CLE200405290,2004,40529,CLE,OAK,CLE08,6,8,14
CLE200405300,2004,40530,CLE,OAK,CLE08,3,4,7
CLE200406010,2004,40601,CLE,TEX,CLE08,6,5,11
CLE200406020,2004,40602,CLE,TEX,CLE08,5,3,8
CLE200406080,2004,40608,CLE,FLO,CLE08,7,5,12
CLE200406090,2004,40609,CLE,FLO,CLE08,1,8,9
CLE200406100,2004,40610,CLE,FLO,CLE08,4,1,5
CLE200406110,2004,40611,CLE,CIN,CLE08,5,6,11
CLE200406120,2004,40612,CLE,CIN,CLE08,7,8,15
CLE200406130,2004,40613,CLE,CIN,CLE08,8,10,18
CLE200406140,2004,40614,CLE,BAL,CLE08,0,14,14
CLE200406250,2004,40625,CLE,COL,CLE08,10,8,18
CLE200406260,2004,40626,CLE,COL,CLE08,3,4,7
CLE200406270,2004,40627,CLE,COL,CLE08,3,5,8
CLE200407050,2004,40705,CLE,TEX,CLE08,8,5,13
CLE200407060,2004,40706,CLE,TEX,CLE08,1,4,5
CLE200407070,2004,40707,CLE,TEX,CLE08,9,8,17
CLE200407080,2004,40708,CLE,TEX,CLE08,10,0,10
CLE200407090,2004,40709,CLE,OAK,CLE08,4,5,9
CLE200407100,2004,40710,CLE,OAK,CLE08,16,7,23
CLE200407110,2004,40711,CLE,OAK,CLE08,1,4,5
CLE200407210,2004,40721,CLE,CHA,CLE08,14,0,14
CLE200407220,2004,40722,CLE,CHA,CLE08,3,0,3
CLE200407230,2004,40723,CLE,KCA,CLE08,2,3,5
CLE200407241,2004,40724,CLE,KCA,CLE08,2,10,12
CLE200407242,2004,40724,CLE,KCA,CLE08,3,4,7
CLE200407250,2004,40725,CLE,KCA,CLE08,1,5,6
CLE200407260,2004,40726,CLE,DET,CLE08,13,4,17
CLE200407270,2004,40727,CLE,DET,CLE08,6,10,16
CLE200407280,2004,40728,CLE,DET,CLE08,4,5,9
CLE200408100,2004,40810,CLE,TOR,CLE08,0,2,2
CLE200408110,2004,40811,CLE,TOR,CLE08,2,3,5
CLE200408120,2004,40812,CLE,TOR,CLE08,2,6,8
CLE200408130,2004,40813,CLE,MIN,CLE08,2,8,10
CLE200408140,2004,40814,CLE,MIN,CLE08,1,7,8
CLE200408150,2004,40815,CLE,MIN,CLE08,4,2,6
CLE200408230,2004,40823,CLE,NYA,CLE08,6,4,10
CLE200408240,2004,40824,CLE,NYA,CLE08,5,4,9
CLE200408250,2004,40825,CLE,NYA,CLE08,3,4,7
CLE200408260,2004,40826,CLE,CHA,CLE08,14,9,23
CLE200408270,2004,40827,CLE,CHA,CLE08,3,6,9
CLE200408280,2004,40828,CLE,CHA,CLE08,5,3,8
CLE200408290,2004,40829,CLE,CHA,CLE08,0,9,9
CLE200409030,2004,40903,CLE,ANA,CLE08,10,5,15
CLE200409040,2004,40904,CLE,ANA,CLE08,6,1,7
CLE200409050,2004,40905,CLE,ANA,CLE08,2,1,3
CLE200409140,2004,40914,CLE,DET,CLE08,11,3,14
CLE200409150,2004,40915,CLE,DET,CLE08,3,5,8
CLE200409160,2004,40916,CLE,DET,CLE08,6,4,10
CLE200409170,2004,40917,CLE,KCA,CLE08,6,4,10
CLE200409180,2004,40918,CLE,KCA,CLE08,7,1,8
CLE200409190,2004,40919,CLE,KCA,CLE08,3,8,11
CLE200409230,2004,40923,CLE,MIN,CLE08,7,9,16
CLE200409240,2004,40924,CLE,MIN,CLE08,8,2,10
CLE200409250,2004,40925,CLE,MIN,CLE08,3,5,8
CLE200409260,2004,40926,CLE,MIN,CLE08,6,2,8
CLE200504110,2005,50411,CLE,CHA,CLE08,2,1,3
CLE200504130,2005,50413,CLE,CHA,CLE08,5,4,9
CLE200504140,2005,50414,CLE,CHA,CLE08,6,8,14
CLE200504150,2005,50415,CLE,MIN,CLE08,3,2,5
CLE200504160,2005,50416,CLE,MIN,CLE08,6,4,10
CLE200504170,2005,50417,CLE,MIN,CLE08,1,2,3
CLE200504270,2005,50427,CLE,DET,CLE08,10,3,13
CLE200504280,2005,50428,CLE,DET,CLE08,3,2,5
CLE200504290,2005,50429,CLE,KCA,CLE08,0,6,6
CLE200504300,2005,50430,CLE,KCA,CLE08,8,1,9
CLE200505010,2005,50501,CLE,KCA,CLE08,6,5,11
CLE200505130,2005,50513,CLE,TOR,CLE08,4,6,10
CLE200505140,2005,50514,CLE,TOR,CLE08,2,3,5
CLE200505150,2005,50515,CLE,TOR,CLE08,5,2,7
CLE200505160,2005,50516,CLE,ANA,CLE08,3,1,4
CLE200505170,2005,50517,CLE,ANA,CLE08,5,13,18
CLE200505180,2005,50518,CLE,ANA,CLE08,2,1,3
CLE200505230,2005,50523,CLE,MIN,CLE08,1,2,3
CLE200505240,2005,50524,CLE,MIN,CLE08,6,3,9
CLE200505250,2005,50525,CLE,MIN,CLE08,2,3,5
CLE200505260,2005,50526,CLE,MIN,CLE08,5,4,9
CLE200505270,2005,50527,CLE,OAK,CLE08,1,4,5
CLE200505280,2005,50528,CLE,OAK,CLE08,3,6,9
CLE200505290,2005,50529,CLE,OAK,CLE08,2,6,8
CLE200506140,2005,50614,CLE,COL,CLE08,2,11,13
CLE200506150,2005,50615,CLE,COL,CLE08,6,7,13
CLE200506160,2005,50616,CLE,COL,CLE08,1,2,3
CLE200506170,2005,50617,CLE,ARI,CLE08,6,13,19
CLE200506180,2005,50618,CLE,ARI,CLE08,1,3,4
CLE200506190,2005,50619,CLE,ARI,CLE08,2,3,5
CLE200506200,2005,50620,CLE,BOS,CLE08,10,9,19
CLE200506210,2005,50621,CLE,BOS,CLE08,9,2,11
CLE200506220,2005,50622,CLE,BOS,CLE08,5,4,9
CLE200506240,2005,50624,CLE,CIN,CLE08,5,4,9
CLE200506250,2005,50625,CLE,CIN,CLE08,7,12,19
CLE200506260,2005,50626,CLE,CIN,CLE08,3,4,7
CLE200507041,2005,50704,CLE,DET,CLE08,3,9,12
CLE200507042,2005,50704,CLE,DET,CLE08,0,6,6
CLE200507050,2005,50705,CLE,DET,CLE08,3,2,5
CLE200507060,2005,50706,CLE,DET,CLE08,7,3,10
CLE200507140,2005,50714,CLE,CHA,CLE08,1,0,1
CLE200507150,2005,50715,CLE,CHA,CLE08,7,1,8
CLE200507160,2005,50716,CLE,CHA,CLE08,7,5,12
CLE200507170,2005,50717,CLE,CHA,CLE08,4,0,4
CLE200507180,2005,50718,CLE,KCA,CLE08,2,6,8
CLE200507190,2005,50719,CLE,KCA,CLE08,4,0,4
CLE200507200,2005,50720,CLE,KCA,CLE08,5,3,8
CLE200507210,2005,50721,CLE,KCA,CLE08,1,10,11
CLE200507220,2005,50722,CLE,SEA,CLE08,4,3,7
CLE200507230,2005,50723,CLE,SEA,CLE08,3,4,7
CLE200507240,2005,50724,CLE,SEA,CLE08,3,6,9
CLE200508020,2005,50802,CLE,NYA,CLE08,5,6,11
CLE200508030,2005,50803,CLE,NYA,CLE08,4,7,11
CLE200508040,2005,50804,CLE,NYA,CLE08,4,3,7
CLE200508120,2005,50812,CLE,TBA,CLE08,8,6,14
CLE200508130,2005,50813,CLE,TBA,CLE08,8,2,10
CLE200508140,2005,50814,CLE,TBA,CLE08,1,0,1
CLE200508160,2005,50816,CLE,TEX,CLE08,2,8,10
CLE200508170,2005,50817,CLE,TEX,CLE08,3,0,3
CLE200508180,2005,50818,CLE,TEX,CLE08,4,9,13
CLE200508190,2005,50819,CLE,BAL,CLE08,4,5,9
CLE200508200,2005,50820,CLE,BAL,CLE08,1,6,7
CLE200508210,2005,50821,CLE,BAL,CLE08,1,5,6
CLE200508290,2005,50829,CLE,DET,CLE08,8,10,18
CLE200508310,2005,50831,CLE,DET,CLE08,4,3,7
CLE200509080,2005,50908,CLE,DET,CLE08,2,4,6
CLE200509090,2005,50909,CLE,MIN,CLE08,2,4,6
CLE200509100,2005,50910,CLE,MIN,CLE08,5,7,12
CLE200509110,2005,50911,CLE,MIN,CLE08,4,12,16
CLE200509120,2005,50912,CLE,OAK,CLE08,2,0,2
CLE200509130,2005,50913,CLE,OAK,CLE08,2,5,7
CLE200509140,2005,50914,CLE,OAK,CLE08,4,6,10
CLE200509160,2005,50916,CLE,KCA,CLE08,1,3,4
CLE200509170,2005,50917,CLE,KCA,CLE08,4,5,9
CLE200509180,2005,50918,CLE,KCA,CLE08,0,11,11
CLE200509270,2005,50927,CLE,TBA,CLE08,5,4,9
CLE200509280,2005,50928,CLE,TBA,CLE08,1,0,1
CLE200509290,2005,50929,CLE,TBA,CLE08,0,6,6
CLE200509300,2005,50930,CLE,CHA,CLE08,3,2,5
CLE200510010,2005,51001,CLE,CHA,CLE08,4,3,7
CLE200510020,2005,51002,CLE,CHA,CLE08,3,1,4
CLE200604070,2006,60407,CLE,MIN,CLE08,6,11,17
CLE200604080,2006,60408,CLE,MIN,CLE08,0,3,3
CLE200604090,2006,60409,CLE,MIN,CLE08,2,3,5
CLE200604110,2006,60411,CLE,SEA,CLE08,5,9,14
CLE200604120,2006,60412,CLE,SEA,CLE08,11,9,20
CLE200604130,2006,60413,CLE,SEA,CLE08,9,5,14
CLE200604250,2006,60425,CLE,BOS,CLE08,8,6,14
CLE200604260,2006,60426,CLE,BOS,CLE08,1,7,8
CLE200604270,2006,60427,CLE,BOS,CLE08,3,15,18
CLE200604280,2006,60428,CLE,TEX,CLE08,6,7,13
CLE200604290,2006,60429,CLE,TEX,CLE08,7,5,12
CLE200604300,2006,60430,CLE,TEX,CLE08,8,4,12
CLE200605010,2006,60501,CLE,CHA,CLE08,8,6,14
CLE200605020,2006,60502,CLE,CHA,CLE08,1,7,8
CLE200605120,2006,60512,CLE,DET,CLE08,5,4,9
CLE200605130,2006,60513,CLE,DET,CLE08,3,0,3
CLE200605140,2006,60514,CLE,DET,CLE08,3,2,5
CLE200605160,2006,60516,CLE,KCA,CLE08,4,6,10
CLE200605170,2006,60517,CLE,KCA,CLE08,0,5,5
CLE200605180,2006,60518,CLE,KCA,CLE08,5,6,11
CLE200605190,2006,60519,CLE,PIT,CLE08,1,4,5
CLE200605200,2006,60520,CLE,PIT,CLE08,9,6,15
CLE200605210,2006,60521,CLE,PIT,CLE08,2,3,5
CLE200605290,2006,60529,CLE,CHA,CLE08,11,0,11
CLE200605300,2006,60530,CLE,CHA,CLE08,3,4,7
CLE200605310,2006,60531,CLE,CHA,CLE08,0,5,5
CLE200606010,2006,60601,CLE,CHA,CLE08,8,12,20
CLE200606020,2006,60602,CLE,ANA,CLE08,10,3,13
CLE200606030,2006,60603,CLE,ANA,CLE08,2,14,16
CLE200606040,2006,60604,CLE,ANA,CLE08,14,2,16
CLE200606060,2006,60606,CLE,OAK,CLE08,7,6,13
CLE200606070,2006,60607,CLE,OAK,CLE08,2,11,13
CLE200606080,2006,60608,CLE,OAK,CLE08,4,1,5
CLE200606190,2006,60619,CLE,CHN,CLE08,12,8,20
CLE200606200,2006,60620,CLE,CHN,CLE08,2,4,6
CLE200606210,2006,60621,CLE,CHN,CLE08,9,2,11
CLE200606230,2006,60623,CLE,CIN,CLE08,3,0,3
CLE200606240,2006,60624,CLE,CIN,CLE08,0,4,4
CLE200606250,2006,60625,CLE,CIN,CLE08,4,2,6
CLE200607030,2006,60703,CLE,NYA,CLE08,2,5,7
CLE200607040,2006,60704,CLE,NYA,CLE08,1,19,20
CLE200607050,2006,60705,CLE,NYA,CLE08,11,3,14
CLE200607060,2006,60706,CLE,NYA,CLE08,10,4,14
CLE200607070,2006,60707,CLE,BAL,CLE08,0,9,9
CLE200607080,2006,60708,CLE,BAL,CLE08,7,4,11
CLE200607090,2006,60709,CLE,BAL,CLE08,5,4,9
CLE200607210,2006,60721,CLE,MIN,CLE08,14,6,20
CLE200607220,2006,60722,CLE,MIN,CLE08,0,11,11
CLE200607230,2006,60723,CLE,MIN,CLE08,3,1,4
CLE200607240,2006,60724,CLE,DET,CLE08,9,7,16
CLE200607250,2006,60725,CLE,DET,CLE08,7,12,19
CLE200607260,2006,60726,CLE,DET,CLE08,4,1,5
CLE200607280,2006,60728,CLE,SEA,CLE08,0,1,1
CLE200607290,2006,60729,CLE,SEA,CLE08,3,1,4
CLE200607300,2006,60730,CLE,SEA,CLE08,7,3,10
CLE200608080,2006,60808,CLE,ANA,CLE08,5,4,9
CLE200608090,2006,60809,CLE,ANA,CLE08,0,4,4
CLE200608100,2006,60810,CLE,ANA,CLE08,2,14,16
CLE200608110,2006,60811,CLE,KCA,CLE08,3,4,7
CLE200608121,2006,60812,CLE,KCA,CLE08,4,5,9
CLE200608122,2006,60812,CLE,KCA,CLE08,5,6,11
CLE200608130,2006,60813,CLE,KCA,CLE08,0,13,13
CLE200608250,2006,60825,CLE,DET,CLE08,2,4,6
CLE200608260,2006,60826,CLE,DET,CLE08,5,8,13
CLE200608270,2006,60827,CLE,DET,CLE08,7,1,8
CLE200608280,2006,60828,CLE,TOR,CLE08,4,6,10
CLE200608290,2006,60829,CLE,TOR,CLE08,2,5,7
CLE200608300,2006,60830,CLE,TOR,CLE08,2,3,5
CLE200609120,2006,60912,CLE,KCA,CLE08,5,3,8
CLE200609130,2006,60913,CLE,KCA,CLE08,6,2,8
CLE200609140,2006,60914,CLE,MIN,CLE08,9,4,13
CLE200609150,2006,60915,CLE,MIN,CLE08,4,5,9
CLE200609160,2006,60916,CLE,MIN,CLE08,4,1,5
CLE200609170,2006,60917,CLE,MIN,CLE08,6,1,7
CLE200609250,2006,60925,CLE,CHA,CLE08,1,14,15
CLE200609260,2006,60926,CLE,CHA,CLE08,0,6,6
CLE200609270,2006,60927,CLE,CHA,CLE08,2,1,3
CLE200609280,2006,60928,CLE,TBA,CLE08,4,5,9
CLE200609290,2006,60929,CLE,TBA,CLE08,1,2,3
CLE200609300,2006,60930,CLE,TBA,CLE08,1,6,7
CLE200610010,2006,61001,CLE,TBA,CLE08,3,6,9
CLE200704100,2007,70410,CLE,ANA,MIL06,6,7,13
CLE200704110,2007,70411,CLE,ANA,MIL06,4,1,5
CLE200704120,2007,70412,CLE,ANA,MIL06,2,4,6
CLE200704130,2007,70413,CLE,CHA,CLE08,6,4,10
CLE200704140,2007,70414,CLE,CHA,CLE08,0,4,4
CLE200704150,2007,70415,CLE,CHA,CLE08,1,2,3
CLE200704250,2007,70425,CLE,TEX,CLE08,7,8,15
CLE200704260,2007,70426,CLE,TEX,CLE08,4,9,13
CLE200704270,2007,70427,CLE,BAL,CLE08,4,5,9
CLE200704280,2007,70428,CLE,BAL,CLE08,7,4,11
CLE200704290,2007,70429,CLE,BAL,CLE08,1,6,7
CLE200705010,2007,70501,CLE,TOR,CLE08,4,12,16
CLE200705020,2007,70502,CLE,TOR,CLE08,6,7,13
CLE200705030,2007,70503,CLE,TOR,CLE08,5,6,11
CLE200705150,2007,70515,CLE,MIN,CLE08,7,15,22
CLE200705160,2007,70516,CLE,MIN,CLE08,1,7,8
CLE200705170,2007,70517,CLE,MIN,CLE08,0,2,2
CLE200705180,2007,70518,CLE,CIN,CLE08,4,9,13
CLE200705190,2007,70519,CLE,CIN,CLE08,10,5,15
CLE200705200,2007,70520,CLE,CIN,CLE08,3,5,8
CLE200705210,2007,70521,CLE,SEA,CLE08,2,5,7
CLE200705310,2007,70531,CLE,DET,CLE08,5,11,16
CLE200706010,2007,70601,CLE,DET,CLE08,11,12,23
CLE200706020,2007,70602,CLE,DET,CLE08,9,5,14
CLE200706030,2007,70603,CLE,DET,CLE08,9,2,11
CLE200706050,2007,70605,CLE,KCA,CLE08,0,1,1
CLE200706060,2007,70606,CLE,KCA,CLE08,4,3,7
CLE200706070,2007,70607,CLE,KCA,CLE08,3,8,11
CLE200706110,2007,70611,CLE,SEA,CLE08,8,7,15
CLE200706150,2007,70615,CLE,ATL,CLE08,5,4,9
CLE200706160,2007,70616,CLE,ATL,CLE08,6,2,8
CLE200706170,2007,70617,CLE,ATL,CLE08,2,5,7
CLE200706180,2007,70618,CLE,PHI,CLE08,1,10,11
CLE200706190,2007,70619,CLE,PHI,CLE08,9,6,15
CLE200706200,2007,70620,CLE,PHI,CLE08,6,10,16
CLE200706250,2007,70625,CLE,OAK,CLE08,2,5,7
CLE200706260,2007,70626,CLE,OAK,CLE08,5,8,13
CLE200706270,2007,70627,CLE,OAK,CLE08,13,7,20
CLE200706280,2007,70628,CLE,OAK,CLE08,3,4,7
CLE200706290,2007,70629,CLE,TBA,CLE08,1,2,3
CLE200706300,2007,70630,CLE,TBA,CLE08,6,8,14
CLE200707010,2007,70701,CLE,TBA,CLE08,2,3,5
CLE200707020,2007,70702,CLE,TBA,CLE08,2,10,12
CLE200707130,2007,70713,CLE,KCA,CLE08,4,5,9
CLE200707140,2007,70714,CLE,KCA,CLE08,6,5,11
CLE200707150,2007,70715,CLE,KCA,CLE08,3,5,8
CLE200707160,2007,70716,CLE,CHA,CLE08,11,10,21
CLE200707170,2007,70717,CLE,CHA,CLE08,5,6,11
CLE200707180,2007,70718,CLE,CHA,CLE08,5,1,6
CLE200707230,2007,70723,CLE,BOS,CLE08,6,2,8
CLE200707240,2007,70724,CLE,BOS,CLE08,1,0,1
CLE200707250,2007,70725,CLE,BOS,CLE08,0,1,1
CLE200707260,2007,70726,CLE,BOS,CLE08,14,9,23
CLE200707270,2007,70727,CLE,MIN,CLE08,4,10,14
CLE200707280,2007,70728,CLE,MIN,CLE08,3,2,5
CLE200707290,2007,70729,CLE,MIN,CLE08,4,1,5
CLE200707310,2007,70731,CLE,TEX,CLE08,3,1,4
CLE200708010,2007,70801,CLE,TEX,CLE08,9,6,15
CLE200708020,2007,70802,CLE,TEX,CLE08,0,5,5
CLE200708100,2007,70810,CLE,NYA,CLE08,6,1,7
CLE200708110,2007,70811,CLE,NYA,CLE08,11,2,13
CLE200708120,2007,70812,CLE,NYA,CLE08,5,3,8
CLE200708140,2007,70814,CLE,DET,CLE08,6,2,8
CLE200708150,2007,70815,CLE,DET,CLE08,2,5,7
CLE200708270,2007,70827,CLE,MIN,CLE08,3,8,11
CLE200708280,2007,70828,CLE,MIN,CLE08,5,6,11
CLE200708290,2007,70829,CLE,MIN,CLE08,3,4,7
CLE200708300,2007,70830,CLE,SEA,CLE08,5,6,11
CLE200708310,2007,70831,CLE,CHA,CLE08,5,8,13
CLE200709010,2007,70901,CLE,CHA,CLE08,0,7,7
CLE200709020,2007,70902,CLE,CHA,CLE08,8,0,8
CLE200709140,2007,70914,CLE,KCA,CLE08,4,5,9
CLE200709150,2007,70915,CLE,KCA,CLE08,0,6,6
CLE200709160,2007,70916,CLE,KCA,CLE08,4,3,7
CLE200709170,2007,70917,CLE,DET,CLE08,5,6,11
CLE200709180,2007,70918,CLE,DET,CLE08,4,7,11
CLE200709190,2007,70919,CLE,DET,CLE08,2,4,6
CLE200709210,2007,70921,CLE,OAK,CLE08,3,4,7
CLE200709220,2007,70922,CLE,OAK,CLE08,9,3,12
CLE200709230,2007,70923,CLE,OAK,CLE08,2,6,8
CLE200710040,2007,71004,CLE,NYA,CLE08,3,12,15
CLE200710050,2007,71005,CLE,NYA,CLE08,1,2,3
CLE200710150,2007,71015,CLE,BOS,CLE08,2,4,6
CLE200710160,2007,71016,CLE,BOS,CLE08,3,7,10
CLE200710180,2007,71018,CLE,BOS,CLE08,7,1,8
CLE200803310,2008,80331,CLE,CHA,CLE08,8,10,18
CLE200804020,2008,80402,CLE,CHA,CLE08,2,7,9
CLE200804030,2008,80403,CLE,CHA,CLE08,2,1,3
CLE200804110,2008,80411,CLE,OAK,CLE08,9,7,16
CLE200804120,2008,80412,CLE,OAK,CLE08,7,3,10
CLE200804130,2008,80413,CLE,OAK,CLE08,1,7,8
CLE200804140,2008,80414,CLE,BOS,CLE08,6,4,10
CLE200804150,2008,80415,CLE,BOS,CLE08,5,3,8
CLE200804160,2008,80416,CLE,DET,CLE08,13,2,15
CLE200804170,2008,80417,CLE,DET,CLE08,1,11,12
CLE200804250,2008,80425,CLE,NYA,CLE08,4,6,10
CLE200804260,2008,80426,CLE,NYA,CLE08,3,4,7
CLE200804270,2008,80427,CLE,NYA,CLE08,1,0,1
CLE200804280,2008,80428,CLE,NYA,CLE08,5,2,7
CLE200804290,2008,80429,CLE,SEA,CLE08,7,2,9
CLE200804300,2008,80430,CLE,SEA,CLE08,3,8,11
CLE200805010,2008,80501,CLE,SEA,CLE08,2,3,5
CLE200805030,2008,80503,CLE,KCA,CLE08,4,2,6
CLE200805040,2008,80504,CLE,KCA,CLE08,2,0,2
CLE200805090,2008,80509,CLE,TOR,CLE08,1,6,7
CLE200805100,2008,80510,CLE,TOR,CLE08,0,12,12
CLE200805121,2008,80512,CLE,TOR,CLE08,0,3,3
CLE200805122,2008,80512,CLE,TOR,CLE08,3,0,3
CLE200805130,2008,80513,CLE,OAK,CLE08,0,4,4
CLE200805140,2008,80514,CLE,OAK,CLE08,0,2,2
CLE200805150,2008,80515,CLE,OAK,CLE08,2,4,6
CLE200805230,2008,80523,CLE,TEX,CLE08,13,9,22
CLE200805240,2008,80524,CLE,TEX,CLE08,2,5,7
CLE200805250,2008,80525,CLE,TEX,CLE08,2,1,3
CLE200805260,2008,80526,CLE,CHA,CLE08,6,3,9
CLE200805270,2008,80527,CLE,CHA,CLE08,2,8,10
CLE200805280,2008,80528,CLE,CHA,CLE08,6,5,11
CLE200806100,2008,80610,CLE,MIN,CLE08,0,1,1
CLE200806110,2008,80611,CLE,MIN,CLE08,8,5,13
CLE200806120,2008,80612,CLE,MIN,CLE08,2,12,14
CLE200806130,2008,80613,CLE,SDN,CLE08,5,9,14
CLE200806140,2008,80614,CLE,SDN,CLE08,8,3,11
CLE200806150,2008,80615,CLE,SDN,CLE08,3,7,10
CLE200806240,2008,80624,CLE,SFN,CLE08,3,2,5
CLE200806250,2008,80625,CLE,SFN,CLE08,4,1,5
CLE200806260,2008,80626,CLE,SFN,CLE08,1,4,5
CLE200806270,2008,80627,CLE,CIN,CLE08,0,6,6
CLE200806280,2008,80628,CLE,CIN,CLE08,5,0,5
CLE200806290,2008,80629,CLE,CIN,CLE08,9,5,14
CLE200807100,2008,80710,CLE,TBA,CLE08,2,13,15
CLE200807110,2008,80711,CLE,TBA,CLE08,0,5,5
CLE200807120,2008,80712,CLE,TBA,CLE08,4,8,12
CLE200807130,2008,80713,CLE,TBA,CLE08,2,5,7
CLE200807250,2008,80725,CLE,MIN,CLE08,4,5,9
CLE200807260,2008,80726,CLE,MIN,CLE08,11,4,15
CLE200807270,2008,80727,CLE,MIN,CLE08,4,2,6
CLE200807280,2008,80728,CLE,DET,CLE08,0,5,5
CLE200807290,2008,80729,CLE,DET,CLE08,8,5,13
CLE200807300,2008,80730,CLE,DET,CLE08,14,12,26
CLE200807310,2008,80731,CLE,DET,CLE08,4,9,13
CLE200808110,2008,80811,CLE,BAL,CLE08,8,13,21
CLE200808120,2008,80812,CLE,BAL,CLE08,5,7,12
CLE200808130,2008,80813,CLE,BAL,CLE08,6,1,7
CLE200808140,2008,80814,CLE,BAL,CLE08,11,6,17
CLE200808150,2008,80815,CLE,ANA,CLE08,2,3,5
CLE200808160,2008,80816,CLE,ANA,CLE08,4,3,7
CLE200808170,2008,80817,CLE,ANA,CLE08,3,4,7
CLE200808190,2008,80819,CLE,KCA,CLE08,4,9,13
CLE200808200,2008,80820,CLE,KCA,CLE08,5,8,13
CLE200808210,2008,80821,CLE,KCA,CLE08,3,10,13
CLE200808290,2008,80829,CLE,SEA,CLE08,3,2,5
CLE200808300,2008,80830,CLE,SEA,CLE08,4,3,7
CLE200808310,2008,80831,CLE,SEA,CLE08,6,4,10
CLE200809010,2008,80901,CLE,CHA,CLE08,0,5,5
CLE200809020,2008,80902,CLE,CHA,CLE08,3,9,12
CLE200809030,2008,80903,CLE,CHA,CLE08,4,2,6
CLE200809120,2008,80912,CLE,KCA,CLE08,5,12,17
CLE200809131,2008,80913,CLE,KCA,CLE08,8,3,11
CLE200809132,2008,80913,CLE,KCA,CLE08,8,4,12
CLE200809140,2008,80914,CLE,KCA,CLE08,13,3,16
CLE200809150,2008,80915,CLE,MIN,CLE08,1,3,4
CLE200809160,2008,80916,CLE,MIN,CLE08,9,12,21
CLE200809170,2008,80917,CLE,MIN,CLE08,4,6,10
CLE200809190,2008,80919,CLE,DET,CLE08,5,6,11
CLE200809200,2008,80920,CLE,DET,CLE08,3,6,9
CLE200809210,2008,80921,CLE,DET,CLE08,5,10,15
CLE200904100,2009,90410,CLE,TOR,CLE08,13,7,20
CLE200904110,2009,90411,CLE,TOR,CLE08,5,4,9
CLE200904120,2009,90412,CLE,TOR,CLE08,4,8,12
CLE200904210,2009,90421,CLE,KCA,CLE08,7,8,15
CLE200904220,2009,90422,CLE,KCA,CLE08,2,0,2
CLE200904230,2009,90423,CLE,KCA,CLE08,2,5,7
CLE200904240,2009,90424,CLE,MIN,CLE08,5,1,6
CLE200904250,2009,90425,CLE,MIN,CLE08,7,1,8
CLE200904260,2009,90426,CLE,MIN,CLE08,2,4,6
CLE200904270,2009,90427,CLE,BOS,CLE08,3,1,4
CLE200904280,2009,90428,CLE,BOS,CLE08,8,9,17
CLE200904290,2009,90429,CLE,BOS,CLE08,6,5,11
CLE200905080,2009,90508,CLE,DET,CLE08,1,0,1
CLE200905090,2009,90509,CLE,DET,CLE08,4,0,4
CLE200905100,2009,90510,CLE,DET,CLE08,5,3,8
CLE200905110,2009,90511,CLE,CHA,CLE08,4,9,13
CLE200905120,2009,90512,CLE,CHA,CLE08,7,4,11
CLE200905130,2009,90513,CLE,CHA,CLE08,0,4,4
CLE200905250,2009,90525,CLE,TBA,CLE08,10,11,21
CLE200905260,2009,90526,CLE,TBA,CLE08,1,5,6
CLE200905270,2009,90527,CLE,TBA,CLE08,7,12,19
CLE200905280,2009,90528,CLE,TBA,CLE08,1,2,3
CLE200905290,2009,90529,CLE,NYA,CLE08,3,1,4
CLE200905300,2009,90530,CLE,NYA,CLE08,10,5,15
CLE200905310,2009,90531,CLE,NYA,CLE08,4,5,9
CLE200906010,2009,90601,CLE,NYA,CLE08,5,2,7
CLE200906090,2009,90609,CLE,KCA,CLE08,4,8,12
CLE200906100,2009,90610,CLE,KCA,CLE08,9,0,9
CLE200906110,2009,90611,CLE,KCA,CLE08,3,4,7
CLE200906120,2009,90612,CLE,SLN,CLE08,3,7,10
CLE200906130,2009,90613,CLE,SLN,CLE08,3,1,4
CLE200906140,2009,90614,CLE,SLN,CLE08,0,3,3
CLE200906150,2009,90615,CLE,MIL,CLE08,14,12,26
CLE200906160,2009,90616,CLE,MIL,CLE08,7,5,12
CLE200906170,2009,90617,CLE,MIL,CLE08,9,8,17
CLE200906260,2009,90626,CLE,CIN,CLE08,2,9,11
CLE200906270,2009,90627,CLE,CIN,CLE08,7,3,10
CLE200906280,2009,90628,CLE,CIN,CLE08,8,1,9
CLE200906290,2009,90629,CLE,CHA,CLE08,6,3,9
CLE200906300,2009,90630,CLE,CHA,CLE08,11,4,15
CLE200907010,2009,90701,CLE,CHA,CLE08,6,2,8
CLE200907030,2009,90703,CLE,OAK,CLE08,3,15,18
CLE200907040,2009,90704,CLE,OAK,CLE08,2,5,7
CLE200907050,2009,90705,CLE,OAK,CLE08,5,2,7
CLE200907160,2009,90716,CLE,SEA,CLE08,1,4,5
CLE200907170,2009,90717,CLE,SEA,CLE08,6,2,8
CLE200907180,2009,90718,CLE,SEA,CLE08,3,1,4
CLE200907190,2009,90719,CLE,SEA,CLE08,5,3,8
CLE200907310,2009,90731,CLE,DET,CLE08,5,6,11
CLE200908010,2009,90801,CLE,DET,CLE08,4,3,7
CLE200908020,2009,90802,CLE,DET,CLE08,1,11,12
CLE200908040,2009,90804,CLE,MIN,CLE08,10,1,11
CLE200908050,2009,90805,CLE,MIN,CLE08,1,8,9
CLE200908060,2009,90806,CLE,MIN,CLE08,1,2,3
CLE200908110,2009,90811,CLE,TEX,CLE08,0,5,5
CLE200908120,2009,90812,CLE,TEX,CLE08,5,0,5
CLE200908130,2009,90813,CLE,TEX,CLE08,4,1,5
CLE200908180,2009,90818,CLE,ANA,CLE08,5,4,9
CLE200908190,2009,90819,CLE,ANA,CLE08,3,0,3
CLE200908200,2009,90820,CLE,ANA,CLE08,3,11,14
CLE200908210,2009,90821,CLE,SEA,CLE08,9,4,13
CLE200908220,2009,90822,CLE,SEA,CLE08,3,4,7
CLE200908230,2009,90823,CLE,SEA,CLE08,1,6,7
CLE200909040,2009,90904,CLE,MIN,CLE08,2,5,7
CLE200909050,2009,90905,CLE,MIN,CLE08,4,1,5
CLE200909060,2009,90906,CLE,MIN,CLE08,1,3,4
CLE200909081,2009,90908,CLE,TEX,CLE08,11,9,20
CLE200909082,2009,90908,CLE,TEX,CLE08,10,5,15
CLE200909090,2009,90909,CLE,TEX,CLE08,10,0,10
CLE200909110,2009,90911,CLE,KCA,CLE08,2,1,3
CLE200909120,2009,90912,CLE,KCA,CLE08,6,13,19
CLE200909130,2009,90913,CLE,KCA,CLE08,7,0,7
CLE200909220,2009,90922,CLE,DET,CLE08,3,1,4
CLE200909230,2009,90923,CLE,DET,CLE08,11,3,14
CLE200909240,2009,90924,CLE,DET,CLE08,6,5,11
CLE200909250,2009,90925,CLE,BAL,CLE08,2,4,6
CLE200909260,2009,90926,CLE,BAL,CLE08,8,9,17
CLE200909270,2009,90927,CLE,BAL,CLE08,0,9,9
CLE200909280,2009,90928,CLE,CHA,CLE08,6,1,7
CLE200909301,2009,90930,CLE,CHA,CLE08,1,5,6
CLE200909302,2009,90930,CLE,CHA,CLE08,1,0,1
COL200004100,2000,410,COL,CIN,DEN02,5,7,12
COL200004110,2000,411,COL,CIN,DEN02,10,3,13
COL200004120,2000,412,COL,CIN,DEN02,5,7,12
COL200004130,2000,413,COL,SLN,DEN02,6,12,18
COL200004140,2000,414,COL,SLN,DEN02,2,6,8
COL200004161,2000,416,COL,SLN,DEN02,9,3,12
COL200004162,2000,416,COL,SLN,DEN02,13,14,27
COL200004280,2000,428,COL,NYN,DEN02,5,12,17
COL200004290,2000,429,COL,NYN,DEN02,13,6,19
COL200004300,2000,430,COL,NYN,DEN02,14,11,25
COL200005010,2000,501,COL,MON,DEN02,8,15,23
COL200005020,2000,502,COL,MON,DEN02,6,12,18
COL200005030,2000,503,COL,MON,DEN02,7,16,23
COL200005120,2000,512,COL,SFN,DEN02,7,15,22
COL200005130,2000,513,COL,SFN,DEN02,9,10,19
COL200005140,2000,514,COL,SFN,DEN02,7,11,18
COL200005230,2000,523,COL,CHN,DEN02,7,10,17
COL200005240,2000,524,COL,CHN,DEN02,4,9,13
COL200005250,2000,525,COL,CHN,DEN02,6,5,11
COL200005260,2000,526,COL,PIT,DEN02,2,1,3
COL200005270,2000,527,COL,PIT,DEN02,6,7,13
COL200005280,2000,528,COL,PIT,DEN02,2,11,13
COL200005290,2000,529,COL,HOU,DEN02,7,8,15
COL200005300,2000,530,COL,HOU,DEN02,7,10,17
COL200005310,2000,531,COL,HOU,DEN02,6,8,14
COL200006090,2000,609,COL,TEX,DEN02,2,3,5
COL200006100,2000,610,COL,TEX,DEN02,6,12,18
COL200006110,2000,611,COL,TEX,DEN02,8,9,17
COL200006130,2000,613,COL,HOU,DEN02,6,3,9
COL200006140,2000,614,COL,HOU,DEN02,8,4,12
COL200006150,2000,615,COL,HOU,DEN02,4,5,9
COL200006170,2000,617,COL,ARI,DEN02,5,14,19
COL200006180,2000,618,COL,ARI,DEN02,2,19,21
COL200006260,2000,626,COL,SFN,DEN02,6,15,21
COL200006270,2000,627,COL,SFN,DEN02,12,7,19
COL200006280,2000,628,COL,SFN,DEN02,13,17,30
COL200006290,2000,629,COL,SFN,DEN02,4,11,15
COL200007130,2000,713,COL,CIN,DEN02,15,6,21
COL200007140,2000,714,COL,CIN,DEN02,9,2,11
COL200007150,2000,715,COL,CIN,DEN02,7,4,11
COL200007171,2000,717,COL,OAK,DEN02,11,10,21
COL200007172,2000,717,COL,OAK,DEN02,9,10,19
COL200007180,2000,718,COL,OAK,DEN02,3,18,21
COL200007210,2000,721,COL,SDN,DEN02,5,1,6
COL200007220,2000,722,COL,SDN,DEN02,4,9,13
COL200007230,2000,723,COL,SDN,DEN02,6,4,10
COL200007240,2000,724,COL,LAN,DEN02,4,1,5
COL200007250,2000,725,COL,LAN,DEN02,6,4,10
COL200007260,2000,726,COL,LAN,DEN02,4,11,15
COL200007270,2000,727,COL,LAN,DEN02,16,11,27
COL200008040,2000,804,COL,PHI,DEN02,1,8,9
COL200008050,2000,805,COL,PHI,DEN02,6,7,13
COL200008060,2000,806,COL,PHI,DEN02,10,9,19
COL200008070,2000,807,COL,PIT,DEN02,8,7,15
COL200008080,2000,808,COL,PIT,DEN02,1,6,7
COL200008090,2000,809,COL,PIT,DEN02,3,4,7
COL200008180,2000,818,COL,FLO,DEN02,9,8,17
COL200008190,2000,819,COL,FLO,DEN02,3,10,13
COL200008200,2000,820,COL,FLO,DEN02,4,13,17
COL200008210,2000,821,COL,ATL,DEN02,7,4,11
COL200008220,2000,822,COL,ATL,DEN02,6,7,13
COL200008230,2000,823,COL,ATL,DEN02,5,2,7
COL200009010,2000,901,COL,MIL,DEN02,3,5,8
COL200009020,2000,902,COL,MIL,DEN02,8,3,11
COL200009030,2000,903,COL,MIL,DEN02,6,4,10
COL200009040,2000,904,COL,CHN,DEN02,2,6,8
COL200009050,2000,905,COL,CHN,DEN02,2,10,12
COL200009060,2000,906,COL,CHN,DEN02,8,5,13
COL200009080,2000,908,COL,LAN,DEN02,5,8,13
COL200009090,2000,909,COL,LAN,DEN02,6,7,13
COL200009100,2000,910,COL,LAN,DEN02,12,1,13
COL200009190,2000,919,COL,SDN,DEN02,7,2,9
COL200009200,2000,920,COL,SDN,DEN02,15,11,26
COL200009210,2000,921,COL,SDN,DEN02,4,13,17
COL200009220,2000,922,COL,FLO,DEN02,8,4,12
COL200009230,2000,923,COL,FLO,DEN02,3,1,4
COL200009240,2000,924,COL,FLO,DEN02,3,9,12
COL200009250,2000,925,COL,ARI,DEN02,6,4,10
COL200009260,2000,926,COL,ARI,DEN02,6,7,13
COL200009270,2000,927,COL,ARI,DEN02,4,6,10
COL200009280,2000,928,COL,ARI,DEN02,12,3,15
COL200104020,2001,10402,COL,SLN,DEN02,0,8,8
COL200104040,2001,10404,COL,SLN,DEN02,9,13,22
COL200104050,2001,10405,COL,SLN,DEN02,2,11,13
COL200104060,2001,10406,COL,SDN,DEN02,10,6,16
COL200104070,2001,10407,COL,SDN,DEN02,14,10,24
COL200104080,2001,10408,COL,SDN,DEN02,11,3,14
COL200104130,2001,10413,COL,ARI,DEN02,7,3,10
COL200104140,2001,10414,COL,ARI,DEN02,8,9,17
COL200104150,2001,10415,COL,ARI,DEN02,7,10,17
COL200104240,2001,10424,COL,CHN,DEN02,1,14,15
COL200104250,2001,10425,COL,CHN,DEN02,5,6,11
COL200104260,2001,10426,COL,CHN,DEN02,7,2,9
COL200104270,2001,10427,COL,CIN,DEN02,12,9,21
COL200104280,2001,10428,COL,CIN,DEN02,9,4,13
COL200104290,2001,10429,COL,CIN,DEN02,7,14,21
COL200105070,2001,10507,COL,NYN,DEN02,10,9,19
COL200105080,2001,10508,COL,NYN,DEN02,4,12,16
COL200105090,2001,10509,COL,NYN,DEN02,0,6,6
COL200105100,2001,10510,COL,NYN,DEN02,2,8,10
COL200105110,2001,10511,COL,MON,DEN02,4,13,17
COL200105120,2001,10512,COL,MON,DEN02,8,4,12
COL200105130,2001,10513,COL,MON,DEN02,14,10,24
COL200105210,2001,10521,COL,LAN,DEN02,3,6,9
COL200105220,2001,10522,COL,LAN,DEN02,8,11,19
COL200105230,2001,10523,COL,LAN,DEN02,6,4,10
COL200106010,2001,10601,COL,SFN,DEN02,11,7,18
COL200106020,2001,10602,COL,SFN,DEN02,5,7,12
COL200106030,2001,10603,COL,SFN,DEN02,2,11,13
COL200106050,2001,10605,COL,HOU,DEN02,4,9,13
COL200106060,2001,10606,COL,HOU,DEN02,8,9,17
COL200106070,2001,10607,COL,HOU,DEN02,2,1,3
COL200106080,2001,10608,COL,SLN,DEN02,1,9,10
COL200106090,2001,10609,COL,SLN,DEN02,8,2,10
COL200106100,2001,10610,COL,SLN,DEN02,3,12,15
COL200106120,2001,10612,COL,SEA,DEN02,10,9,19
COL200106141,2001,10614,COL,SEA,DEN02,2,8,10
COL200106142,2001,10614,COL,SEA,DEN02,5,1,6
COL200106210,2001,10621,COL,ARI,DEN02,14,5,19
COL200106220,2001,10622,COL,ARI,DEN02,5,4,9
COL200106230,2001,10623,COL,ARI,DEN02,9,5,14
COL200106240,2001,10624,COL,ARI,DEN02,6,7,13
COL200106250,2001,10625,COL,SDN,DEN02,6,4,10
COL200106260,2001,10626,COL,SDN,DEN02,11,3,14
COL200106270,2001,10627,COL,SDN,DEN02,9,10,19
COL200107060,2001,10706,COL,ANA,DEN02,6,5,11
COL200107070,2001,10707,COL,ANA,DEN02,10,3,13
COL200107080,2001,10708,COL,ANA,DEN02,11,3,14
COL200107200,2001,10720,COL,LAN,DEN02,3,11,14
COL200107210,2001,10721,COL,LAN,DEN02,22,7,29
COL200107220,2001,10722,COL,LAN,DEN02,9,8,17
COL200107230,2001,10723,COL,SFN,DEN02,2,8,10
COL200107240,2001,10724,COL,SFN,DEN02,4,6,10
COL200107250,2001,10725,COL,SFN,DEN02,9,3,12
COL200107310,2001,10731,COL,PHI,DEN02,6,7,13
COL200108010,2001,10801,COL,PHI,DEN02,8,1,9
COL200108020,2001,10802,COL,PHI,DEN02,4,2,6
COL200108030,2001,10803,COL,PIT,DEN02,7,12,19
COL200108040,2001,10804,COL,PIT,DEN02,6,3,9
COL200108050,2001,10805,COL,PIT,DEN02,5,4,9
COL200108140,2001,10814,COL,ATL,DEN02,4,5,9
COL200108150,2001,10815,COL,ATL,DEN02,7,2,9
COL200108160,2001,10816,COL,ATL,DEN02,4,1,5
COL200108170,2001,10817,COL,FLO,DEN02,5,12,17
COL200108180,2001,10818,COL,FLO,DEN02,3,8,11
COL200108190,2001,10819,COL,FLO,DEN02,5,6,11
COL200109040,2001,10904,COL,LAN,DEN02,2,5,7
COL200109050,2001,10905,COL,LAN,DEN02,7,2,9
COL200109060,2001,10906,COL,LAN,DEN02,9,5,14
COL200109070,2001,10907,COL,SFN,DEN02,2,3,5
COL200109080,2001,10908,COL,SFN,DEN02,7,3,10
COL200109090,2001,10909,COL,SFN,DEN02,9,4,13
COL200109170,2001,10917,COL,ARI,DEN02,7,3,10
COL200109180,2001,10918,COL,ARI,DEN02,9,10,19
COL200109190,2001,10919,COL,ARI,DEN02,2,8,10
COL200109240,2001,10924,COL,SDN,DEN02,11,15,26
COL200109250,2001,10925,COL,SDN,DEN02,8,7,15
COL200109260,2001,10926,COL,SDN,DEN02,3,1,4
COL200109270,2001,10927,COL,SDN,DEN02,9,13,22
COL200109280,2001,10928,COL,MIL,DEN02,5,6,11
COL200109290,2001,10929,COL,MIL,DEN02,12,14,26
COL200109300,2001,10930,COL,MIL,DEN02,0,10,10
COL200204080,2002,20408,COL,HOU,DEN02,8,4,12
COL200204090,2002,20409,COL,HOU,DEN02,5,10,15
COL200204100,2002,20410,COL,HOU,DEN02,1,4,5
COL200204110,2002,20411,COL,ARI,DEN02,8,4,12
COL200204120,2002,20412,COL,ARI,DEN02,8,3,11
COL200204130,2002,20413,COL,ARI,DEN02,7,5,12
COL200204140,2002,20414,COL,ARI,DEN02,6,3,9
COL200204150,2002,20415,COL,LAN,DEN02,5,2,7
COL200204160,2002,20416,COL,LAN,DEN02,4,6,10
COL200204170,2002,20417,COL,LAN,DEN02,6,3,9
COL200204260,2002,20426,COL,PHI,DEN02,1,4,5
COL200204270,2002,20427,COL,PHI,DEN02,6,8,14
COL200204280,2002,20428,COL,PHI,DEN02,2,4,6
COL200204300,2002,20430,COL,PIT,DEN02,0,10,10
COL200205010,2002,20501,COL,PIT,DEN02,0,6,6
COL200205020,2002,20502,COL,PIT,DEN02,2,7,9
COL200205130,2002,20513,COL,FLO,DEN02,3,7,10
COL200205140,2002,20514,COL,FLO,DEN02,6,2,8
COL200205150,2002,20515,COL,FLO,DEN02,2,7,9
COL200205160,2002,20516,COL,FLO,DEN02,3,10,13
COL200205170,2002,20517,COL,ATL,DEN02,4,2,6
COL200205180,2002,20518,COL,ATL,DEN02,3,7,10
COL200205190,2002,20519,COL,ATL,DEN02,2,1,3
COL200205210,2002,20521,COL,SDN,DEN02,6,7,13
COL200205220,2002,20522,COL,SDN,DEN02,3,5,8
COL200205230,2002,20523,COL,SDN,DEN02,3,16,19
COL200205240,2002,20524,COL,SFN,DEN02,5,8,13
COL200205250,2002,20525,COL,SFN,DEN02,3,6,9
COL200205260,2002,20526,COL,SFN,DEN02,6,10,16
COL200206030,2002,20603,COL,LAN,DEN02,11,5,16
COL200206040,2002,20604,COL,LAN,DEN02,10,4,14
COL200206050,2002,20605,COL,LAN,DEN02,6,8,14
COL200206140,2002,20614,COL,CLE,DEN02,5,3,8
COL200206150,2002,20615,COL,CLE,DEN02,4,7,11
COL200206160,2002,20616,COL,CLE,DEN02,5,4,9
COL200206180,2002,20618,COL,NYA,DEN02,10,5,15
COL200206190,2002,20619,COL,NYA,DEN02,20,10,30
COL200206200,2002,20620,COL,NYA,DEN02,11,14,25
COL200206210,2002,20621,COL,TBA,DEN02,7,8,15
COL200206220,2002,20622,COL,TBA,DEN02,5,6,11
COL200206230,2002,20623,COL,TBA,DEN02,5,6,11
COL200207010,2002,20701,COL,SFN,DEN02,8,6,14
COL200207020,2002,20702,COL,SFN,DEN02,18,5,23
COL200207030,2002,20703,COL,SFN,DEN02,4,14,18
COL200207050,2002,20705,COL,SDN,DEN02,6,9,15
COL200207060,2002,20706,COL,SDN,DEN02,2,3,5
COL200207070,2002,20707,COL,SDN,DEN02,7,1,8
COL200207170,2002,20717,COL,ARI,DEN02,12,3,15
COL200207180,2002,20718,COL,ARI,DEN02,4,6,10
COL200207190,2002,20719,COL,MIL,DEN02,5,9,14
COL200207200,2002,20720,COL,MIL,DEN02,5,6,11
COL200207210,2002,20721,COL,MIL,DEN02,4,6,10
COL200208060,2002,20806,COL,CIN,DEN02,6,7,13
COL200208070,2002,20807,COL,CIN,DEN02,2,7,9
COL200208080,2002,20808,COL,CIN,DEN02,3,10,13
COL200208090,2002,20809,COL,CHN,DEN02,0,2,2
COL200208100,2002,20810,COL,CHN,DEN02,15,1,16
COL200208110,2002,20811,COL,CHN,DEN02,12,9,21
COL200208200,2002,20820,COL,MON,DEN02,6,8,14
COL200208210,2002,20821,COL,MON,DEN02,13,5,18
COL200208220,2002,20822,COL,MON,DEN02,6,14,20
COL200208230,2002,20823,COL,NYN,DEN02,4,10,14
COL200208240,2002,20824,COL,NYN,DEN02,5,2,7
COL200208250,2002,20825,COL,NYN,DEN02,7,4,11
COL200208260,2002,20826,COL,SFN,DEN02,4,3,7
COL200208270,2002,20827,COL,SFN,DEN02,7,4,11
COL200208280,2002,20828,COL,SFN,DEN02,9,1,10
COL200208290,2002,20829,COL,SFN,DEN02,10,6,16
COL200209060,2002,20906,COL,SDN,DEN02,3,7,10
COL200209070,2002,20907,COL,SDN,DEN02,3,5,8
COL200209080,2002,20908,COL,SDN,DEN02,9,4,13
COL200209120,2002,20912,COL,LAN,DEN02,1,7,8
COL200209130,2002,20913,COL,LAN,DEN02,4,5,9
COL200209140,2002,20914,COL,LAN,DEN02,16,3,19
COL200209150,2002,20915,COL,LAN,DEN02,4,5,9
COL200209170,2002,20917,COL,SLN,DEN02,11,4,15
COL200209180,2002,20918,COL,SLN,DEN02,8,5,13
COL200209190,2002,20919,COL,SLN,DEN02,12,6,18
COL200209200,2002,20920,COL,ARI,DEN02,4,9,13
COL200209210,2002,20921,COL,ARI,DEN02,8,15,23
COL200209220,2002,20922,COL,ARI,DEN02,7,11,18
COL200304040,2003,30404,COL,ARI,DEN02,1,2,3
COL200304050,2003,30405,COL,ARI,DEN02,3,4,7
COL200304060,2003,30406,COL,ARI,DEN02,3,8,11
COL200304080,2003,30408,COL,SLN,DEN02,15,12,27
COL200304090,2003,30409,COL,SLN,DEN02,4,9,13
COL200304100,2003,30410,COL,SLN,DEN02,6,7,13
COL200304180,2003,30418,COL,SDN,DEN02,1,12,13
COL200304190,2003,30419,COL,SDN,DEN02,9,10,19
COL200304200,2003,30420,COL,SDN,DEN02,0,8,8
COL200304250,2003,30425,COL,CHN,DEN02,11,7,18
COL200304260,2003,30426,COL,CHN,DEN02,5,8,13
COL200304270,2003,30427,COL,CHN,DEN02,3,6,9
COL200304290,2003,30429,COL,CIN,DEN02,5,10,15
COL200304300,2003,30430,COL,CIN,DEN02,13,11,24
COL200305010,2003,30501,COL,CIN,DEN02,7,2,9
COL200305120,2003,30512,COL,NYN,DEN02,9,6,15
COL200305130,2003,30513,COL,NYN,DEN02,8,9,17
COL200305140,2003,30514,COL,NYN,DEN02,5,6,11
COL200305150,2003,30515,COL,MON,DEN02,2,4,6
COL200305160,2003,30516,COL,MON,DEN02,4,1,5
COL200305170,2003,30517,COL,MON,DEN02,6,4,10
COL200305180,2003,30518,COL,MON,DEN02,0,4,4
COL200305230,2003,30523,COL,SFN,DEN02,7,10,17
COL200305240,2003,30524,COL,SFN,DEN02,5,1,6
COL200305250,2003,30525,COL,SFN,DEN02,1,5,6
COL200305260,2003,30526,COL,SFN,DEN02,7,12,19
COL200305270,2003,30527,COL,LAN,DEN02,3,7,10
COL200305280,2003,30528,COL,LAN,DEN02,0,6,6
COL200305290,2003,30529,COL,LAN,DEN02,5,12,17
COL200306030,2003,30603,COL,CLE,DEN02,3,7,10
COL200306040,2003,30604,COL,CLE,DEN02,1,2,3
COL200306050,2003,30605,COL,CLE,DEN02,4,7,11
COL200306071,2003,30607,COL,KCA,DEN02,13,11,24
COL200306072,2003,30607,COL,KCA,DEN02,9,5,14
COL200306080,2003,30608,COL,KCA,DEN02,7,8,15
COL200306160,2003,30616,COL,SDN,DEN02,7,5,12
COL200306170,2003,30617,COL,SDN,DEN02,4,3,7
COL200306180,2003,30618,COL,SDN,DEN02,3,5,8
COL200306190,2003,30619,COL,SDN,DEN02,5,10,15
COL200306200,2003,30620,COL,DET,DEN02,7,5,12
COL200306210,2003,30621,COL,DET,DEN02,6,9,15
COL200306220,2003,30622,COL,DET,DEN02,3,5,8
COL200306300,2003,30630,COL,ARI,DEN02,8,7,15
COL200307010,2003,30701,COL,ARI,DEN02,4,7,11
COL200307020,2003,30702,COL,ARI,DEN02,2,6,8
COL200307030,2003,30703,COL,ARI,DEN02,8,4,12
COL200307090,2003,30709,COL,SFN,DEN02,7,11,18
COL200307100,2003,30710,COL,SFN,DEN02,3,11,14
COL200307110,2003,30711,COL,LAN,DEN02,6,7,13
COL200307120,2003,30712,COL,LAN,DEN02,3,5,8
COL200307130,2003,30713,COL,LAN,DEN02,9,3,12
COL200307250,2003,30725,COL,MIL,DEN02,3,7,10
COL200307260,2003,30726,COL,MIL,DEN02,8,13,21
COL200307270,2003,30727,COL,MIL,DEN02,1,6,7
COL200308050,2003,30805,COL,PHI,DEN02,7,2,9
COL200308060,2003,30806,COL,PHI,DEN02,1,5,6
COL200308070,2003,30807,COL,PHI,DEN02,3,4,7
COL200308080,2003,30808,COL,PIT,DEN02,6,13,19
COL200308090,2003,30809,COL,PIT,DEN02,10,4,14
COL200308100,2003,30810,COL,PIT,DEN02,5,3,8
COL200308190,2003,30819,COL,FLO,DEN02,2,10,12
COL200308200,2003,30820,COL,FLO,DEN02,3,9,12
COL200308210,2003,30821,COL,FLO,DEN02,4,5,9
COL200308220,2003,30822,COL,ATL,DEN02,9,3,12
COL200308230,2003,30823,COL,ATL,DEN02,5,4,9
COL200308240,2003,30824,COL,ATL,DEN02,12,6,18
COL200308260,2003,30826,COL,SFN,DEN02,3,1,4
COL200308270,2003,30827,COL,SFN,DEN02,6,4,10
COL200308280,2003,30828,COL,SFN,DEN02,1,6,7
COL200309050,2003,30905,COL,LAN,DEN02,8,7,15
COL200309060,2003,30906,COL,LAN,DEN02,10,2,12
COL200309070,2003,30907,COL,LAN,DEN02,6,2,8
COL200309160,2003,30916,COL,HOU,DEN02,14,4,18
COL200309170,2003,30917,COL,HOU,DEN02,5,7,12
COL200309180,2003,30918,COL,HOU,DEN02,6,0,6
COL200309190,2003,30919,COL,SDN,DEN02,5,6,11
COL200309200,2003,30920,COL,SDN,DEN02,11,3,14
COL200309210,2003,30921,COL,SDN,DEN02,3,5,8
COL200309230,2003,30923,COL,ARI,DEN02,9,20,29
COL200309240,2003,30924,COL,ARI,DEN02,6,3,9
COL200309250,2003,30925,COL,ARI,DEN02,8,7,15
COL200404120,2004,40412,COL,ARI,DEN02,4,7,11
COL200404140,2004,40414,COL,ARI,DEN02,4,14,18
COL200404150,2004,40415,COL,ARI,DEN02,11,10,21
COL200404200,2004,40420,COL,LAN,DEN02,1,7,8
COL200404210,2004,40421,COL,LAN,DEN02,9,4,13
COL200404220,2004,40422,COL,LAN,DEN02,1,7,8
COL200404230,2004,40423,COL,HOU,DEN02,13,7,20
COL200404240,2004,40424,COL,HOU,DEN02,8,5,13
COL200404250,2004,40425,COL,HOU,DEN02,1,4,5
COL200404260,2004,40426,COL,FLO,DEN02,6,3,9
COL200404270,2004,40427,COL,FLO,DEN02,10,13,23
COL200404280,2004,40428,COL,FLO,DEN02,9,4,13
COL200405011,2004,40501,COL,ATL,DEN02,2,3,5
COL200405012,2004,40501,COL,ATL,DEN02,11,7,18
COL200405020,2004,40502,COL,ATL,DEN02,4,13,17
COL200405110,2004,40511,COL,PIT,DEN02,15,10,25
COL200405131,2004,40513,COL,PIT,DEN02,5,7,12
COL200405132,2004,40513,COL,PIT,DEN02,11,2,13
COL200405140,2004,40514,COL,PHI,DEN02,6,4,10
COL200405150,2004,40515,COL,PHI,DEN02,16,5,21
COL200405160,2004,40516,COL,PHI,DEN02,6,7,13
COL200405170,2004,40517,COL,PHI,DEN02,6,7,13
COL200405250,2004,40525,COL,SDN,DEN02,11,6,17
COL200405260,2004,40526,COL,SDN,DEN02,6,13,19
COL200405270,2004,40527,COL,SDN,DEN02,4,3,7
COL200406040,2004,40604,COL,SFN,DEN02,13,7,20
COL200406050,2004,40605,COL,SFN,DEN02,2,11,13
COL200406060,2004,40606,COL,SFN,DEN02,16,4,20
COL200406070,2004,40607,COL,SFN,DEN02,10,5,15
COL200406150,2004,40615,COL,BOS,DEN02,3,6,9
COL200406160,2004,40616,COL,BOS,DEN02,6,7,13
COL200406170,2004,40617,COL,BOS,DEN02,11,0,11
COL200406180,2004,40618,COL,BAL,DEN02,3,5,8
COL200406190,2004,40619,COL,BAL,DEN02,6,11,17
COL200406200,2004,40620,COL,BAL,DEN02,4,2,6
COL200406290,2004,40629,COL,MIL,DEN02,6,3,9
COL200406300,2004,40630,COL,MIL,DEN02,5,4,9
COL200407010,2004,40701,COL,MIL,DEN02,10,9,19
COL200407020,2004,40702,COL,DET,DEN02,8,9,17
COL200407030,2004,40703,COL,DET,DEN02,6,11,17
COL200407040,2004,40704,COL,DET,DEN02,8,10,18
COL200407150,2004,40715,COL,SFN,DEN02,7,5,12
COL200407160,2004,40716,COL,SFN,DEN02,1,7,8
COL200407170,2004,40717,COL,SFN,DEN02,4,0,4
COL200407180,2004,40718,COL,SFN,DEN02,9,10,19
COL200407190,2004,40719,COL,SDN,DEN02,13,6,19
COL200407200,2004,40720,COL,SDN,DEN02,9,7,16
COL200407260,2004,40726,COL,LAN,DEN02,9,7,16
COL200407270,2004,40727,COL,LAN,DEN02,2,7,9
COL200407280,2004,40728,COL,LAN,DEN02,4,5,9
COL200407290,2004,40729,COL,LAN,DEN02,3,2,5
COL200407300,2004,40730,COL,ARI,DEN02,1,4,5
COL200407310,2004,40731,COL,ARI,DEN02,4,8,12
COL200408010,2004,40801,COL,ARI,DEN02,2,10,12
COL200408030,2004,40803,COL,CHN,DEN02,5,3,8
COL200408040,2004,40804,COL,CHN,DEN02,11,8,19
COL200408050,2004,40805,COL,CHN,DEN02,5,1,6
COL200408060,2004,40806,COL,CIN,DEN02,5,8,13
COL200408070,2004,40807,COL,CIN,DEN02,5,9,14
COL200408080,2004,40808,COL,CIN,DEN02,14,7,21
COL200408170,2004,40817,COL,NYN,DEN02,4,6,10
COL200408191,2004,40819,COL,NYN,DEN02,10,3,13
COL200408192,2004,40819,COL,NYN,DEN02,4,2,6
COL200408200,2004,40820,COL,MON,DEN02,4,3,7
COL200408210,2004,40821,COL,MON,DEN02,2,5,7
COL200408220,2004,40822,COL,MON,DEN02,8,2,10
COL200409070,2004,40907,COL,SFN,DEN02,7,8,15
COL200409080,2004,40908,COL,SFN,DEN02,5,3,8
COL200409090,2004,40909,COL,SDN,DEN02,7,9,16
COL200409100,2004,40910,COL,SDN,DEN02,10,4,14
COL200409110,2004,40911,COL,SDN,DEN02,2,13,15
COL200409120,2004,40912,COL,SDN,DEN02,15,2,17
COL200409170,2004,40917,COL,LAN,DEN02,8,6,14
COL200409180,2004,40918,COL,LAN,DEN02,1,8,9
COL200409190,2004,40919,COL,LAN,DEN02,7,6,13
COL200409220,2004,40922,COL,ARI,DEN02,2,4,6
COL200409231,2004,40923,COL,ARI,DEN02,1,7,8
COL200409232,2004,40923,COL,ARI,DEN02,1,2,3
COL200409240,2004,40924,COL,SLN,DEN02,5,4,9
COL200409250,2004,40925,COL,SLN,DEN02,10,6,16
COL200409260,2004,40926,COL,SLN,DEN02,9,3,12
COL200504040,2005,50404,COL,SDN,DEN02,10,12,22
COL200504060,2005,50406,COL,SDN,DEN02,14,6,20
COL200504150,2005,50415,COL,SFN,DEN02,13,6,19
COL200504160,2005,50416,COL,SFN,DEN02,4,5,9
COL200504170,2005,50417,COL,SFN,DEN02,8,6,14
COL200504180,2005,50418,COL,ARI,DEN02,5,3,8
COL200504190,2005,50419,COL,ARI,DEN02,1,8,9
COL200504220,2005,50422,COL,LAN,DEN02,1,9,10
COL200504230,2005,50423,COL,LAN,DEN02,6,8,14
COL200504240,2005,50424,COL,LAN,DEN02,8,6,14
COL200504260,2005,50426,COL,FLO,DEN02,9,3,12
COL200505090,2005,50509,COL,ATL,DEN02,6,7,13
COL200505100,2005,50510,COL,ATL,DEN02,9,5,14
COL200505110,2005,50511,COL,ATL,DEN02,5,6,11
COL200505120,2005,50512,COL,ARI,DEN02,6,3,9
COL200505130,2005,50513,COL,ARI,DEN02,3,18,21
COL200505140,2005,50514,COL,ARI,DEN02,10,4,14
COL200505150,2005,50515,COL,ARI,DEN02,5,4,9
COL200505170,2005,50517,COL,SFN,DEN02,4,9,13
COL200505180,2005,50518,COL,SFN,DEN02,3,2,5
COL200505190,2005,50519,COL,SFN,DEN02,1,3,4
COL200505300,2005,50530,COL,SLN,DEN02,5,4,9
COL200505310,2005,50531,COL,SLN,DEN02,1,2,3
COL200506010,2005,50601,COL,SLN,DEN02,8,6,14
COL200506020,2005,50602,COL,SLN,DEN02,7,8,15
COL200506030,2005,50603,COL,CIN,DEN02,4,12,16
COL200506040,2005,50604,COL,CIN,DEN02,5,7,12
COL200506050,2005,50605,COL,CIN,DEN02,6,8,14
COL200506060,2005,50606,COL,CHA,DEN02,9,3,12
COL200506070,2005,50607,COL,CHA,DEN02,2,1,3
COL200506080,2005,50608,COL,CHA,DEN02,15,5,20
COL200506100,2005,50610,COL,DET,DEN02,0,2,2
COL200506110,2005,50611,COL,DET,DEN02,6,4,10
COL200506120,2005,50612,COL,DET,DEN02,3,7,10
COL200506240,2005,50624,COL,KCA,DEN02,4,12,16
COL200506250,2005,50625,COL,KCA,DEN02,2,4,6
COL200506260,2005,50626,COL,KCA,DEN02,4,9,13
COL200506270,2005,50627,COL,HOU,DEN02,11,5,16
COL200506280,2005,50628,COL,HOU,DEN02,5,6,11
COL200506290,2005,50629,COL,HOU,DEN02,7,1,8
COL200507040,2005,50704,COL,LAN,DEN02,4,3,7
COL200507050,2005,50705,COL,LAN,DEN02,1,6,7
COL200507060,2005,50706,COL,LAN,DEN02,9,5,14
COL200507070,2005,50707,COL,LAN,DEN02,5,8,13
COL200507080,2005,50708,COL,SDN,DEN02,12,2,14
COL200507090,2005,50709,COL,SDN,DEN02,0,1,1
COL200507100,2005,50710,COL,SDN,DEN02,8,5,13
COL200507250,2005,50725,COL,NYN,DEN02,3,5,8
COL200507260,2005,50726,COL,NYN,DEN02,3,4,7
COL200507270,2005,50727,COL,NYN,DEN02,9,3,12
COL200507280,2005,50728,COL,PHI,DEN02,8,5,13
COL200507290,2005,50729,COL,PHI,DEN02,5,3,8
COL200507300,2005,50730,COL,PHI,DEN02,8,7,15
COL200507310,2005,50731,COL,PHI,DEN02,2,9,11
COL200508081,2005,50808,COL,FLO,DEN02,3,4,7
COL200508082,2005,50808,COL,FLO,DEN02,3,5,8
COL200508090,2005,50809,COL,PIT,DEN02,12,4,16
COL200508100,2005,50810,COL,PIT,DEN02,5,6,11
COL200508110,2005,50811,COL,PIT,DEN02,11,3,14
COL200508120,2005,50812,COL,WAS,DEN02,4,2,6
COL200508130,2005,50813,COL,WAS,DEN02,8,0,8
COL200508140,2005,50814,COL,WAS,DEN02,9,2,11
COL200508150,2005,50815,COL,MIL,DEN02,2,11,13
COL200508160,2005,50816,COL,MIL,DEN02,6,4,10
COL200508170,2005,50817,COL,MIL,DEN02,2,0,2
COL200508190,2005,50819,COL,CHN,DEN02,5,3,8
COL200508200,2005,50820,COL,CHN,DEN02,2,4,6
COL200508210,2005,50821,COL,CHN,DEN02,7,9,16
COL200509020,2005,50902,COL,LAN,DEN02,3,11,14
COL200509030,2005,50903,COL,LAN,DEN02,1,11,12
COL200509040,2005,50904,COL,LAN,DEN02,6,7,13
COL200509090,2005,50909,COL,ARI,DEN02,7,1,8
COL200509100,2005,50910,COL,ARI,DEN02,8,5,13
COL200509110,2005,50911,COL,ARI,DEN02,2,7,9
COL200509190,2005,50919,COL,SDN,DEN02,8,7,15
COL200509200,2005,50920,COL,SDN,DEN02,1,20,21
COL200509210,2005,50921,COL,SDN,DEN02,5,2,7
COL200509220,2005,50922,COL,SDN,DEN02,2,4,6
COL200509230,2005,50923,COL,SFN,DEN02,7,6,13
COL200509240,2005,50924,COL,SFN,DEN02,0,6,6
COL200509250,2005,50925,COL,SFN,DEN02,6,2,8
COL200604030,2006,60403,COL,ARI,DEN02,2,3,5
COL200604050,2006,60405,COL,ARI,DEN02,4,2,6
COL200604060,2006,60406,COL,ARI,DEN02,12,5,17
COL200604140,2006,60414,COL,PHI,DEN02,10,8,18
COL200604150,2006,60415,COL,PHI,DEN02,6,10,16
COL200604160,2006,60416,COL,PHI,DEN02,1,0,1
COL200604170,2006,60417,COL,SDN,DEN02,5,2,7
COL200604180,2006,60418,COL,SDN,DEN02,2,3,5
COL200604190,2006,60419,COL,SDN,DEN02,13,4,17
COL200604210,2006,60421,COL,SFN,DEN02,8,9,17
COL200604220,2006,60422,COL,SFN,DEN02,6,4,10
COL200604230,2006,60423,COL,SFN,DEN02,2,3,5
COL200605030,2006,60503,COL,CIN,DEN02,0,3,3
COL200605040,2006,60504,COL,CIN,DEN02,7,1,8
COL200605050,2006,60505,COL,HOU,DEN02,4,5,9
COL200605060,2006,60506,COL,HOU,DEN02,0,5,5
COL200605070,2006,60507,COL,HOU,DEN02,3,5,8
COL200605150,2006,60515,COL,LAN,DEN02,5,4,9
COL200605160,2006,60516,COL,LAN,DEN02,1,5,6
COL200605170,2006,60517,COL,LAN,DEN02,3,2,5
COL200605190,2006,60519,COL,TOR,DEN02,3,8,11
COL200605200,2006,60520,COL,TOR,DEN02,1,5,6
COL200605210,2006,60521,COL,TOR,DEN02,3,5,8
COL200606020,2006,60602,COL,FLO,DEN02,4,2,6
COL200606030,2006,60603,COL,FLO,DEN02,13,0,13
COL200606040,2006,60604,COL,FLO,DEN02,4,3,7
COL200606050,2006,60605,COL,PIT,DEN02,5,2,7
COL200606060,2006,60606,COL,PIT,DEN02,4,5,9
COL200606070,2006,60607,COL,PIT,DEN02,9,16,25
COL200606090,2006,60609,COL,LAN,DEN02,3,0,3
COL200606100,2006,60610,COL,LAN,DEN02,9,12,21
COL200606110,2006,60611,COL,LAN,DEN02,6,5,11
COL200606190,2006,60619,COL,OAK,DEN02,0,7,7
COL200606200,2006,60620,COL,OAK,DEN02,0,6,6
COL200606210,2006,60621,COL,OAK,DEN02,3,2,5
COL200606230,2006,60623,COL,TEX,DEN02,8,6,14
COL200606240,2006,60624,COL,TEX,DEN02,6,11,17
COL200606250,2006,60625,COL,TEX,DEN02,0,3,3
COL200607030,2006,60703,COL,SFN,DEN02,9,6,15
COL200607040,2006,60704,COL,SFN,DEN02,1,6,7
COL200607050,2006,60705,COL,SFN,DEN02,3,5,8
COL200607070,2006,60707,COL,ARI,DEN02,4,3,7
COL200607080,2006,60708,COL,ARI,DEN02,8,7,15
COL200607090,2006,60709,COL,ARI,DEN02,8,5,13
COL200607240,2006,60724,COL,SLN,DEN02,0,7,7
COL200607250,2006,60725,COL,SLN,DEN02,1,0,1
COL200607260,2006,60726,COL,SLN,DEN02,6,1,7
COL200607270,2006,60727,COL,SDN,DEN02,8,9,17
COL200607280,2006,60728,COL,SDN,DEN02,1,3,4
COL200607290,2006,60729,COL,SDN,DEN02,4,2,6
COL200607300,2006,60730,COL,SDN,DEN02,1,3,4
COL200607310,2006,60731,COL,MIL,DEN02,2,4,6
COL200608010,2006,60801,COL,MIL,DEN02,1,0,1
COL200608020,2006,60802,COL,MIL,DEN02,2,8,10
COL200608110,2006,60811,COL,CHN,DEN02,2,10,12
COL200608120,2006,60812,COL,CHN,DEN02,4,8,12
COL200608130,2006,60813,COL,CHN,DEN02,8,7,15
COL200608140,2006,60814,COL,ARI,DEN02,3,4,7
COL200608150,2006,60815,COL,ARI,DEN02,2,1,3
COL200608160,2006,60816,COL,ARI,DEN02,9,5,14
COL200608170,2006,60817,COL,ARI,DEN02,4,8,12
COL200608250,2006,60825,COL,SDN,DEN02,5,13,18
COL200608260,2006,60826,COL,SDN,DEN02,5,2,7
COL200608270,2006,60827,COL,SDN,DEN02,3,6,9
COL200608290,2006,60829,COL,NYN,DEN02,10,5,15
COL200608300,2006,60830,COL,NYN,DEN02,11,3,14
COL200608310,2006,60831,COL,NYN,DEN02,4,8,12
COL200609070,2006,60907,COL,WAS,DEN02,5,10,15
COL200609080,2006,60908,COL,WAS,DEN02,8,11,19
COL200609090,2006,60909,COL,WAS,DEN02,5,9,14
COL200609100,2006,60910,COL,WAS,DEN02,9,13,22
COL200609180,2006,60918,COL,SFN,DEN02,8,20,28
COL200609190,2006,60919,COL,SFN,DEN02,4,12,16
COL200609200,2006,60920,COL,SFN,DEN02,7,4,11
COL200609210,2006,60921,COL,ATL,DEN02,6,3,9
COL200609220,2006,60922,COL,ATL,DEN02,4,6,10
COL200609230,2006,60923,COL,ATL,DEN02,9,10,19
COL200609240,2006,60924,COL,ATL,DEN02,8,9,17
COL200609260,2006,60926,COL,LAN,DEN02,11,4,15
COL200609270,2006,60927,COL,LAN,DEN02,6,4,10
COL200609280,2006,60928,COL,LAN,DEN02,19,11,30
COL200704020,2007,70402,COL,ARI,DEN02,8,6,14
COL200704030,2007,70403,COL,ARI,DEN02,3,4,7
COL200704040,2007,70404,COL,ARI,DEN02,4,11,15
COL200704160,2007,70416,COL,SFN,DEN02,8,0,8
COL200704170,2007,70417,COL,SFN,DEN02,3,5,8
COL200704180,2007,70418,COL,LAN,DEN02,2,7,9
COL200704190,2007,70419,COL,LAN,DEN02,8,1,9
COL200704200,2007,70420,COL,SDN,DEN02,11,1,12
COL200704210,2007,70421,COL,SDN,DEN02,7,3,10
COL200704220,2007,70422,COL,SDN,DEN02,2,4,6
COL200704270,2007,70427,COL,ATL,DEN02,9,7,16
COL200704280,2007,70428,COL,ATL,DEN02,6,2,8
COL200704290,2007,70429,COL,ATL,DEN02,7,9,16
COL200705100,2007,70510,COL,SFN,DEN02,3,5,8
COL200705110,2007,70511,COL,SFN,DEN02,8,3,11
COL200705120,2007,70512,COL,SFN,DEN02,2,6,8
COL200705130,2007,70513,COL,SFN,DEN02,15,2,17
COL200705150,2007,70515,COL,ARI,DEN02,3,0,3
COL200705160,2007,70516,COL,ARI,DEN02,3,5,8
COL200705170,2007,70517,COL,ARI,DEN02,3,1,4
COL200705180,2007,70518,COL,KCA,DEN02,5,2,7
COL200705190,2007,70519,COL,KCA,DEN02,4,6,10
COL200705200,2007,70520,COL,KCA,DEN02,10,5,15
COL200705280,2007,70528,COL,SLN,DEN02,2,6,8
COL200705290,2007,70529,COL,SLN,DEN02,3,8,11
COL200705300,2007,70530,COL,SLN,DEN02,8,4,12
COL200705310,2007,70531,COL,SLN,DEN02,7,3,10
COL200706010,2007,70601,COL,CIN,DEN02,4,2,6
COL200706020,2007,70602,COL,CIN,DEN02,1,4,5
COL200706030,2007,70603,COL,CIN,DEN02,9,10,19
COL200706050,2007,70605,COL,HOU,DEN02,4,1,5
COL200706060,2007,70606,COL,HOU,DEN02,7,8,15
COL200706070,2007,70607,COL,HOU,DEN02,6,7,13
COL200706150,2007,70615,COL,TBA,DEN02,2,12,14
COL200706160,2007,70616,COL,TBA,DEN02,5,10,15
COL200706170,2007,70617,COL,TBA,DEN02,7,4,11
COL200706190,2007,70619,COL,NYA,DEN02,1,3,4
COL200706200,2007,70620,COL,NYA,DEN02,1,6,7
COL200706210,2007,70621,COL,NYA,DEN02,3,4,7
COL200707020,2007,70702,COL,NYN,DEN02,2,6,8
COL200707030,2007,70703,COL,NYN,DEN02,3,11,14
COL200707040,2007,70704,COL,NYN,DEN02,7,17,24
COL200707060,2007,70706,COL,PHI,DEN02,6,7,13
COL200707070,2007,70707,COL,PHI,DEN02,3,6,9
COL200707080,2007,70708,COL,PHI,DEN02,8,4,12
COL200707230,2007,70723,COL,SDN,DEN02,5,7,12
COL200707240,2007,70724,COL,SDN,DEN02,5,3,8
COL200707250,2007,70725,COL,SDN,DEN02,2,10,12
COL200707260,2007,70726,COL,LAN,DEN02,5,4,9
COL200707280,2007,70728,COL,LAN,DEN02,2,6,8
COL200707290,2007,70729,COL,LAN,DEN02,6,9,15
COL200708060,2007,70806,COL,MIL,DEN02,2,6,8
COL200708070,2007,70807,COL,MIL,DEN02,4,11,15
COL200708080,2007,70808,COL,MIL,DEN02,4,19,23
COL200708090,2007,70809,COL,CHN,DEN02,10,2,12
COL200708100,2007,70810,COL,CHN,DEN02,6,2,8
COL200708110,2007,70811,COL,CHN,DEN02,2,15,17
COL200708120,2007,70812,COL,CHN,DEN02,3,6,9
COL200708200,2007,70820,COL,PIT,DEN02,4,2,6
COL200708210,2007,70821,COL,PIT,DEN02,2,9,11
COL200708220,2007,70822,COL,PIT,DEN02,11,2,13
COL200708230,2007,70823,COL,PIT,DEN02,5,1,6
COL200708240,2007,70824,COL,WAS,DEN02,5,6,11
COL200708250,2007,70825,COL,WAS,DEN02,1,5,6
COL200708260,2007,70826,COL,WAS,DEN02,5,10,15
COL200709030,2007,70903,COL,SFN,DEN02,4,7,11
COL200709040,2007,70904,COL,SFN,DEN02,5,6,11
COL200709050,2007,70905,COL,SFN,DEN02,5,3,8
COL200709070,2007,70907,COL,SDN,DEN02,4,10,14
COL200709080,2007,70908,COL,SDN,DEN02,3,1,4
COL200709090,2007,70909,COL,SDN,DEN02,2,4,6
COL200709140,2007,70914,COL,FLO,DEN02,7,6,13
COL200709150,2007,70915,COL,FLO,DEN02,10,2,12
COL200709160,2007,70916,COL,FLO,DEN02,0,13,13
COL200709181,2007,70918,COL,LAN,DEN02,1,3,4
COL200709182,2007,70918,COL,LAN,DEN02,8,9,17
COL200709190,2007,70919,COL,LAN,DEN02,5,6,11
COL200709200,2007,70920,COL,LAN,DEN02,4,9,13
COL200709280,2007,70928,COL,ARI,DEN02,4,2,6
COL200709290,2007,70929,COL,ARI,DEN02,1,11,12
COL200709300,2007,70930,COL,ARI,DEN02,3,4,7
COL200710010,2007,71001,COL,SDN,DEN02,8,9,17
COL200710060,2007,71006,COL,PHI,DEN02,1,2,3
COL200710140,2007,71014,COL,ARI,DEN02,1,4,5
COL200710150,2007,71015,COL,ARI,DEN02,4,6,10
COL200710270,2007,71027,COL,BOS,DEN02,10,5,15
COL200710280,2007,71028,COL,BOS,DEN02,4,3,7
COL200804040,2008,80404,COL,ARI,DEN02,8,1,9
COL200804050,2008,80405,COL,ARI,DEN02,7,2,9
COL200804060,2008,80406,COL,ARI,DEN02,5,2,7
COL200804070,2008,80407,COL,ATL,DEN02,1,2,3
COL200804080,2008,80408,COL,ATL,DEN02,3,4,7
COL200804090,2008,80409,COL,ATL,DEN02,6,12,18
COL200804210,2008,80421,COL,PHI,DEN02,9,5,14
COL200804220,2008,80422,COL,PHI,DEN02,8,6,14
COL200804230,2008,80423,COL,CHN,DEN02,7,6,13
COL200804240,2008,80424,COL,CHN,DEN02,2,4,6
COL200805020,2008,80502,COL,LAN,DEN02,11,6,17
COL200805030,2008,80503,COL,LAN,DEN02,12,7,19
COL200805040,2008,80504,COL,LAN,DEN02,2,7,9
COL200805050,2008,80505,COL,SLN,DEN02,6,5,11
COL200805060,2008,80506,COL,SLN,DEN02,6,5,11
COL200805070,2008,80507,COL,SLN,DEN02,3,4,7
COL200805080,2008,80508,COL,SLN,DEN02,3,9,12
COL200805160,2008,80516,COL,MIN,DEN02,4,2,6
COL200805170,2008,80517,COL,MIN,DEN02,2,3,5
COL200805180,2008,80518,COL,MIN,DEN02,2,6,8
COL200805190,2008,80519,COL,SFN,DEN02,3,4,7
COL200805200,2008,80520,COL,SFN,DEN02,6,5,11
COL200805210,2008,80521,COL,SFN,DEN02,3,2,5
COL200805230,2008,80523,COL,NYN,DEN02,5,6,11
COL200805240,2008,80524,COL,NYN,DEN02,9,2,11
COL200805250,2008,80525,COL,NYN,DEN02,1,4,5
COL200806060,2008,80606,COL,MIL,DEN02,4,6,10
COL200806070,2008,80607,COL,MIL,DEN02,2,7,9
COL200806080,2008,80608,COL,MIL,DEN02,3,2,5
COL200806100,2008,80610,COL,SFN,DEN02,5,10,15
COL200806110,2008,80611,COL,SFN,DEN02,0,1,1
COL200806120,2008,80612,COL,SFN,DEN02,10,7,17
COL200806160,2008,80616,COL,ATL,DEN02,7,1,8
COL200806170,2008,80617,COL,CLE,DEN02,2,10,12
COL200806180,2008,80618,COL,CLE,DEN02,2,4,6
COL200806190,2008,80619,COL,CLE,DEN02,3,6,9
COL200806200,2008,80620,COL,NYN,DEN02,7,2,9
COL200806210,2008,80621,COL,NYN,DEN02,1,7,8
COL200806220,2008,80622,COL,NYN,DEN02,3,1,4
COL200806300,2008,80630,COL,SDN,DEN02,15,8,23
COL200807010,2008,80701,COL,SDN,DEN02,0,4,4
COL200807020,2008,80702,COL,SDN,DEN02,1,8,9
COL200807030,2008,80703,COL,FLO,DEN02,5,6,11
COL200807040,2008,80704,COL,FLO,DEN02,17,18,35
COL200807050,2008,80705,COL,FLO,DEN02,6,12,18
COL200807060,2008,80706,COL,FLO,DEN02,10,5,15
COL200807170,2008,80717,COL,PIT,DEN02,3,5,8
COL200807180,2008,80718,COL,PIT,DEN02,2,5,7
COL200807190,2008,80719,COL,PIT,DEN02,1,7,8
COL200807200,2008,80720,COL,PIT,DEN02,3,11,14
COL200807210,2008,80721,COL,LAN,DEN02,16,10,26
COL200807220,2008,80722,COL,LAN,DEN02,1,10,11
COL200807230,2008,80723,COL,LAN,DEN02,3,5,8
COL200808040,2008,80804,COL,WAS,DEN02,9,4,13
COL200808050,2008,80805,COL,WAS,DEN02,2,8,10
COL200808071,2008,80807,COL,WAS,DEN02,6,3,9
COL200808072,2008,80807,COL,WAS,DEN02,6,3,9
COL200808080,2008,80808,COL,SDN,DEN02,3,6,9
COL200808090,2008,80809,COL,SDN,DEN02,8,3,11
COL200808100,2008,80810,COL,SDN,DEN02,16,7,23
COL200808120,2008,80812,COL,ARI,DEN02,4,2,6
COL200808130,2008,80813,COL,ARI,DEN02,5,6,11
COL200808140,2008,80814,COL,ARI,DEN02,6,2,8
COL200808220,2008,80822,COL,CIN,DEN02,8,5,13
COL200808230,2008,80823,COL,CIN,DEN02,6,7,13
COL200808240,2008,80824,COL,CIN,DEN02,3,4,7
COL200809010,2008,80901,COL,SFN,DEN02,0,4,4
COL200809020,2008,80902,COL,SFN,DEN02,5,6,11
COL200809030,2008,80903,COL,SFN,DEN02,9,2,11
COL200809050,2008,80905,COL,HOU,DEN02,3,5,8
COL200809060,2008,80906,COL,HOU,DEN02,2,0,2
COL200809070,2008,80907,COL,HOU,DEN02,7,5,12
COL200809120,2008,80912,COL,LAN,DEN02,7,2,9
COL200809130,2008,80913,COL,LAN,DEN02,5,1,6
COL200809140,2008,80914,COL,LAN,DEN02,0,1,1
COL200809150,2008,80915,COL,SDN,DEN02,11,5,16
COL200809160,2008,80916,COL,SDN,DEN02,3,10,13
COL200809170,2008,80917,COL,SDN,DEN02,0,1,1
COL200809190,2008,80919,COL,ARI,DEN02,2,3,5
COL200809200,2008,80920,COL,ARI,DEN02,5,3,8
COL200809210,2008,80921,COL,ARI,DEN02,13,4,17
COL200904100,2009,90410,COL,PHI,DEN02,3,10,13
COL200904110,2009,90411,COL,PHI,DEN02,8,4,12
COL200904120,2009,90412,COL,PHI,DEN02,7,5,12
COL200904240,2009,90424,COL,LAN,DEN02,6,5,11
COL200904250,2009,90425,COL,LAN,DEN02,6,5,11
COL200904260,2009,90426,COL,LAN,DEN02,4,10,14
COL200904270,2009,90427,COL,SDN,DEN02,7,12,19
COL200904280,2009,90428,COL,SDN,DEN02,4,3,7
COL200904290,2009,90429,COL,SDN,DEN02,5,7,12
COL200905060,2009,90506,COL,SFN,DEN02,1,11,12
COL200905070,2009,90507,COL,SFN,DEN02,8,3,11
COL200905080,2009,90508,COL,FLO,DEN02,8,3,11
COL200905090,2009,90509,COL,FLO,DEN02,3,1,4
COL200905100,2009,90510,COL,FLO,DEN02,2,3,5
COL200905120,2009,90512,COL,HOU,DEN02,1,12,13
COL200905130,2009,90513,COL,HOU,DEN02,15,11,26
COL200905140,2009,90514,COL,HOU,DEN02,5,3,8
COL200905250,2009,90525,COL,LAN,DEN02,16,6,22
COL200905260,2009,90526,COL,LAN,DEN02,7,1,8
COL200905270,2009,90527,COL,LAN,DEN02,8,6,14
COL200905290,2009,90529,COL,SDN,DEN02,0,3,3
COL200905300,2009,90530,COL,SDN,DEN02,7,8,15
COL200905310,2009,90531,COL,SDN,DEN02,5,2,7
COL200906120,2009,90612,COL,SEA,DEN02,4,6,10
COL200906130,2009,90613,COL,SEA,DEN02,3,5,8
COL200906140,2009,90614,COL,SEA,DEN02,1,7,8
COL200906160,2009,90616,COL,TBA,DEN02,12,4,16
COL200906170,2009,90617,COL,TBA,DEN02,3,5,8
COL200906180,2009,90618,COL,TBA,DEN02,3,4,7
COL200906190,2009,90619,COL,PIT,DEN02,3,7,10
COL200906200,2009,90620,COL,PIT,DEN02,7,9,16
COL200906210,2009,90621,COL,PIT,DEN02,4,5,9
COL200907030,2009,90703,COL,ARI,DEN02,0,5,5
COL200907040,2009,90704,COL,ARI,DEN02,11,7,18
COL200907050,2009,90705,COL,ARI,DEN02,4,3,7
COL200907060,2009,90706,COL,WAS,DEN02,0,1,1
COL200907070,2009,90707,COL,WAS,DEN02,4,5,9
COL200907080,2009,90708,COL,WAS,DEN02,4,10,14
COL200907090,2009,90709,COL,ATL,DEN02,6,7,13
COL200907100,2009,90710,COL,ATL,DEN02,4,1,5
COL200907110,2009,90711,COL,ATL,DEN02,4,3,7
COL200907120,2009,90712,COL,ATL,DEN02,7,8,15
COL200907200,2009,90720,COL,ARI,DEN02,6,10,16
COL200907210,2009,90721,COL,ARI,DEN02,6,5,11
COL200907220,2009,90722,COL,ARI,DEN02,3,4,7
COL200907240,2009,90724,COL,SFN,DEN02,3,1,4
COL200907250,2009,90725,COL,SFN,DEN02,2,8,10
COL200907260,2009,90726,COL,SFN,DEN02,2,4,6
COL200908070,2009,90807,COL,CHN,DEN02,2,6,8
COL200908080,2009,90808,COL,CHN,DEN02,6,5,11
COL200908090,2009,90809,COL,CHN,DEN02,5,11,16
COL200908100,2009,90810,COL,CHN,DEN02,5,11,16
COL200908110,2009,90811,COL,PIT,DEN02,7,3,10
COL200908120,2009,90812,COL,PIT,DEN02,0,8,8
COL200908130,2009,90813,COL,PIT,DEN02,1,10,11
COL200908210,2009,90821,COL,SFN,DEN02,6,3,9
COL200908220,2009,90822,COL,SFN,DEN02,11,14,25
COL200908230,2009,90823,COL,SFN,DEN02,2,4,6
COL200908240,2009,90824,COL,SFN,DEN02,4,6,10
COL200908250,2009,90825,COL,LAN,DEN02,4,5,9
COL200908260,2009,90826,COL,LAN,DEN02,6,1,7
COL200908270,2009,90827,COL,LAN,DEN02,3,2,5
COL200909010,2009,90901,COL,NYN,DEN02,3,8,11
COL200909020,2009,90902,COL,NYN,DEN02,2,5,7
COL200909030,2009,90903,COL,NYN,DEN02,8,3,11
COL200909040,2009,90904,COL,ARI,DEN02,4,5,9
COL200909050,2009,90905,COL,ARI,DEN02,1,4,5
COL200909060,2009,90906,COL,ARI,DEN02,5,13,18
COL200909070,2009,90907,COL,CIN,DEN02,3,4,7
COL200909080,2009,90908,COL,CIN,DEN02,1,3,4
COL200909090,2009,90909,COL,CIN,DEN02,3,4,7
COL200909100,2009,90910,COL,CIN,DEN02,1,5,6
COL200909220,2009,90922,COL,SDN,DEN02,10,11,21
COL200909230,2009,90923,COL,SDN,DEN02,6,3,9
COL200909240,2009,90924,COL,SDN,DEN02,5,4,9
COL200909250,2009,90925,COL,SLN,DEN02,1,2,3
COL200909260,2009,90926,COL,SLN,DEN02,6,3,9
COL200909270,2009,90927,COL,SLN,DEN02,3,4,7
COL200909290,2009,90929,COL,MIL,DEN02,5,7,12
COL200909300,2009,90930,COL,MIL,DEN02,6,10,16
COL200910010,2009,91001,COL,MIL,DEN02,2,9,11
COL200910110,2009,91011,COL,PHI,DEN02,6,5,11
COL200910120,2009,91012,COL,PHI,DEN02,5,4,9
DET200004110,2000,411,DET,SEA,DET05,2,5,7
DET200004120,2000,412,DET,SEA,DET05,4,0,4
DET200004130,2000,413,DET,SEA,DET05,0,2,2
DET200004140,2000,414,DET,TBA,DET05,5,10,15
DET200004150,2000,415,DET,TBA,DET05,7,0,7
DET200004160,2000,416,DET,TBA,DET05,7,6,13
DET200004180,2000,418,DET,BOS,DET05,7,0,7
DET200004190,2000,419,DET,BOS,DET05,10,0,10
DET200004280,2000,428,DET,CHA,DET05,3,2,5
DET200004290,2000,429,DET,CHA,DET05,2,1,3
DET200004300,2000,430,DET,CHA,DET05,3,4,7
DET200005080,2000,508,DET,KCA,DET05,4,1,5
DET200005100,2000,510,DET,KCA,DET05,6,0,6
DET200005120,2000,512,DET,NYA,DET05,7,9,16
DET200005130,2000,513,DET,NYA,DET05,3,6,9
DET200005140,2000,514,DET,NYA,DET05,1,2,3
DET200005230,2000,523,DET,CLE,DET05,4,10,14
DET200005240,2000,524,DET,CLE,DET05,9,10,19
DET200005250,2000,525,DET,CLE,DET05,4,1,5
DET200005260,2000,526,DET,TOR,DET05,8,2,10
DET200005270,2000,527,DET,TOR,DET05,3,4,7
DET200005280,2000,528,DET,TOR,DET05,12,7,19
DET200005290,2000,529,DET,TEX,DET05,3,2,5
DET200005300,2000,530,DET,TEX,DET05,4,7,11
DET200005310,2000,531,DET,TEX,DET05,13,5,18
DET200006090,2000,609,DET,SLN,DET05,2,4,6
DET200006100,2000,610,DET,SLN,DET05,1,10,11
DET200006110,2000,611,DET,SLN,DET05,7,3,10
DET200006120,2000,612,DET,TOR,DET05,4,2,6
DET200006130,2000,613,DET,TOR,DET05,3,16,19
DET200006140,2000,614,DET,TOR,DET05,8,1,9
DET200006160,2000,616,DET,CLE,DET05,2,5,7
DET200006170,2000,617,DET,CLE,DET05,6,8,14
DET200006180,2000,618,DET,CLE,DET05,9,4,13
DET200006270,2000,627,DET,NYA,DET05,6,7,13
DET200006280,2000,628,DET,NYA,DET05,6,13,19
DET200006290,2000,629,DET,NYA,DET05,8,0,8
DET200007130,2000,713,DET,HOU,DET05,2,8,10
DET200007140,2000,714,DET,HOU,DET05,9,4,13
DET200007150,2000,715,DET,HOU,DET05,6,11,17
DET200007160,2000,716,DET,CIN,DET05,2,6,8
DET200007170,2000,717,DET,CIN,DET05,1,3,4
DET200007180,2000,718,DET,CIN,DET05,5,4,9
DET200007210,2000,721,DET,KCA,DET05,4,0,4
DET200007221,2000,722,DET,KCA,DET05,8,5,13
DET200007222,2000,722,DET,KCA,DET05,6,10,16
DET200007230,2000,723,DET,KCA,DET05,9,12,21
DET200007240,2000,724,DET,TBA,DET05,4,2,6
DET200007250,2000,725,DET,TBA,DET05,4,6,10
DET200007260,2000,726,DET,TBA,DET05,6,2,8
DET200008040,2000,804,DET,MIN,DET05,3,1,4
DET200008050,2000,805,DET,MIN,DET05,3,4,7
DET200008060,2000,806,DET,MIN,DET05,7,3,10
DET200008070,2000,807,DET,BAL,DET05,4,3,7
DET200008080,2000,808,DET,BAL,DET05,1,4,5
DET200008090,2000,809,DET,BAL,DET05,5,2,7
DET200008100,2000,810,DET,BAL,DET05,3,14,17
DET200008180,2000,818,DET,OAK,DET05,1,10,11
DET200008190,2000,819,DET,OAK,DET05,3,4,7
DET200008200,2000,820,DET,OAK,DET05,5,4,9
DET200008210,2000,821,DET,OAK,DET05,1,3,4
DET200008220,2000,822,DET,SEA,DET05,8,4,12
DET200008230,2000,823,DET,SEA,DET05,5,6,11
DET200008240,2000,824,DET,SEA,DET05,3,10,13
DET200009010,2000,901,DET,TEX,DET05,5,7,12
DET200009020,2000,902,DET,TEX,DET05,3,5,8
DET200009030,2000,903,DET,TEX,DET05,4,1,5
DET200009040,2000,904,DET,ANA,DET05,0,5,5
DET200009050,2000,905,DET,ANA,DET05,5,7,12
DET200009060,2000,906,DET,ANA,DET05,1,0,1
DET200009070,2000,907,DET,ANA,DET05,6,4,10
DET200009150,2000,915,DET,BOS,DET05,7,6,13
DET200009161,2000,916,DET,BOS,DET05,8,5,13
DET200009162,2000,916,DET,BOS,DET05,2,12,14
DET200009170,2000,917,DET,BOS,DET05,4,5,9
DET200009180,2000,918,DET,CHA,DET05,2,5,7
DET200009190,2000,919,DET,CHA,DET05,6,2,8
DET200009200,2000,920,DET,CHA,DET05,13,6,19
DET200009290,2000,929,DET,MIN,DET05,0,1,1
DET200009300,2000,930,DET,MIN,DET05,5,6,11
DET200010010,2000,1001,DET,MIN,DET05,11,12,23
DET200104030,2001,10403,DET,MIN,DET05,3,2,5
DET200104050,2001,10405,DET,MIN,DET05,9,5,14
DET200104120,2001,10412,DET,CLE,DET05,5,3,8
DET200104130,2001,10413,DET,CLE,DET05,9,8,17
DET200104140,2001,10414,DET,CLE,DET05,0,1,1
DET200104170,2001,10417,DET,CHA,DET05,4,7,11
DET200104180,2001,10418,DET,CHA,DET05,6,4,10
DET200104190,2001,10419,DET,CHA,DET05,3,1,4
DET200104240,2001,10424,DET,BAL,DET05,8,3,11
DET200104250,2001,10425,DET,BAL,DET05,6,4,10
DET200104260,2001,10426,DET,BAL,DET05,2,8,10
DET200104270,2001,10427,DET,TBA,DET05,2,4,6
DET200104280,2001,10428,DET,TBA,DET05,7,3,10
DET200104290,2001,10429,DET,TBA,DET05,1,6,7
DET200105080,2001,10508,DET,TEX,DET05,4,5,9
DET200105090,2001,10509,DET,TEX,DET05,2,3,5
DET200105100,2001,10510,DET,TEX,DET05,5,6,11
DET200105110,2001,10511,DET,ANA,DET05,6,7,13
DET200105120,2001,10512,DET,ANA,DET05,1,4,5
DET200105130,2001,10513,DET,ANA,DET05,14,2,16
DET200105250,2001,10525,DET,CHA,DET05,8,4,12
DET200105260,2001,10526,DET,CHA,DET05,8,0,8
DET200105270,2001,10527,DET,CHA,DET05,3,2,5
DET200105280,2001,10528,DET,CLE,DET05,6,12,18
DET200105290,2001,10529,DET,CLE,DET05,6,4,10
DET200105300,2001,10530,DET,CLE,DET05,8,4,12
DET200106080,2001,10608,DET,MIL,DET05,4,9,13
DET200106090,2001,10609,DET,MIL,DET05,5,6,11
DET200106100,2001,10610,DET,MIL,DET05,8,3,11
DET200106120,2001,10612,DET,PIT,DET05,13,3,16
DET200106130,2001,10613,DET,PIT,DET05,3,6,9
DET200106140,2001,10614,DET,PIT,DET05,4,6,10
DET200106180,2001,10618,DET,NYA,DET05,10,1,11
DET200106190,2001,10619,DET,NYA,DET05,1,7,8
DET200106200,2001,10620,DET,NYA,DET05,2,5,7
DET200106220,2001,10622,DET,MIN,DET05,4,5,9
DET200106230,2001,10623,DET,MIN,DET05,9,10,19
DET200106240,2001,10624,DET,MIN,DET05,14,5,19
DET200106250,2001,10625,DET,MIN,DET05,6,3,9
DET200107030,2001,10703,DET,KCA,DET05,4,8,12
DET200107040,2001,10704,DET,KCA,DET05,4,6,10
DET200107050,2001,10705,DET,KCA,DET05,1,7,8
DET200107060,2001,10706,DET,CHN,DET05,15,9,24
DET200107070,2001,10707,DET,CHN,DET05,10,6,16
DET200107080,2001,10708,DET,CHN,DET05,6,9,15
DET200107181,2001,10718,DET,NYA,DET05,8,5,13
DET200107182,2001,10718,DET,NYA,DET05,4,12,16
DET200107190,2001,10719,DET,NYA,DET05,2,11,13
DET200107270,2001,10727,DET,CLE,DET05,7,4,11
DET200107281,2001,10728,DET,CLE,DET05,6,4,10
DET200107282,2001,10728,DET,CLE,DET05,2,4,6
DET200107290,2001,10729,DET,CLE,DET05,3,8,11
DET200107310,2001,10731,DET,SEA,DET05,2,4,6
DET200108010,2001,10801,DET,SEA,DET05,7,1,8
DET200108020,2001,10802,DET,SEA,DET05,2,1,3
DET200108030,2001,10803,DET,OAK,DET05,2,1,3
DET200108040,2001,10804,DET,OAK,DET05,10,1,11
DET200108050,2001,10805,DET,OAK,DET05,4,1,5
DET200108060,2001,10806,DET,OAK,DET05,6,3,9
DET200108140,2001,10814,DET,ANA,DET05,7,1,8
DET200108150,2001,10815,DET,ANA,DET05,1,5,6
DET200108160,2001,10816,DET,ANA,DET05,4,2,6
DET200108170,2001,10817,DET,KCA,DET05,2,4,6
DET200108180,2001,10818,DET,KCA,DET05,8,4,12
DET200108190,2001,10819,DET,KCA,DET05,3,4,7
DET200108280,2001,10828,DET,CHA,DET05,8,6,14
DET200108290,2001,10829,DET,CHA,DET05,8,3,11
DET200108300,2001,10830,DET,CHA,DET05,1,3,4
DET200109070,2001,10907,DET,TOR,DET05,2,1,3
DET200109080,2001,10908,DET,TOR,DET05,3,4,7
DET200109090,2001,10909,DET,TOR,DET05,6,3,9
DET200109100,2001,10910,DET,MIN,DET05,3,2,5
DET200109280,2001,10928,DET,BOS,DET05,1,4,5
DET200109290,2001,10929,DET,BOS,DET05,2,7,9
DET200109300,2001,10930,DET,BOS,DET05,8,5,13
DET200110020,2001,11002,DET,MIN,DET05,5,0,5
DET200110030,2001,11003,DET,MIN,DET05,5,9,14
DET200110040,2001,11004,DET,MIN,DET05,5,4,9
DET200110061,2001,11006,DET,KCA,DET05,8,3,11
DET200110062,2001,11006,DET,KCA,DET05,1,2,3
DET200110070,2001,11007,DET,KCA,DET05,10,4,14
DET200204050,2002,20405,DET,CLE,DET05,10,1,11
DET200204060,2002,20406,DET,CLE,DET05,5,3,8
DET200204070,2002,20407,DET,CLE,DET05,5,1,6
DET200204090,2002,20409,DET,CHA,DET05,8,2,10
DET200204100,2002,20410,DET,CHA,DET05,7,5,12
DET200204160,2002,20416,DET,TBA,DET05,3,9,12
DET200204170,2002,20417,DET,TBA,DET05,6,7,13
DET200204180,2002,20418,DET,TBA,DET05,6,4,10
DET200204260,2002,20426,DET,MIN,DET05,2,3,5
DET200204270,2002,20427,DET,MIN,DET05,1,5,6
DET200204280,2002,20428,DET,MIN,DET05,4,5,9
DET200204290,2002,20429,DET,KCA,DET05,4,0,4
DET200204300,2002,20430,DET,KCA,DET05,3,9,12
DET200205010,2002,20501,DET,KCA,DET05,6,7,13
DET200205140,2002,20514,DET,ANA,DET05,9,2,11
DET200205150,2002,20515,DET,ANA,DET05,10,1,11
DET200205170,2002,20517,DET,TEX,DET05,3,6,9
DET200205180,2002,20518,DET,TEX,DET05,7,8,15
DET200205190,2002,20519,DET,TEX,DET05,1,2,3
DET200205200,2002,20520,DET,CLE,DET05,3,4,7
DET200205210,2002,20521,DET,CLE,DET05,1,5,6
DET200205220,2002,20522,DET,CLE,DET05,0,2,2
DET200205310,2002,20531,DET,TOR,DET05,4,2,6
DET200206010,2002,20601,DET,TOR,DET05,4,1,5
DET200206020,2002,20602,DET,TOR,DET05,7,6,13
DET200206030,2002,20603,DET,BOS,DET05,6,7,13
DET200206040,2002,20604,DET,BOS,DET05,10,5,15
DET200206050,2002,20605,DET,BOS,DET05,11,0,11
DET200206060,2002,20606,DET,BOS,DET05,4,3,7
DET200206070,2002,20607,DET,PHI,DET05,11,1,12
DET200206080,2002,20608,DET,PHI,DET05,2,1,3
DET200206090,2002,20609,DET,PHI,DET05,7,5,12
DET200206100,2002,20610,DET,MON,DET05,4,6,10
DET200206110,2002,20611,DET,MON,DET05,1,2,3
DET200206120,2002,20612,DET,MON,DET05,2,1,3
DET200206280,2002,20628,DET,PIT,DET05,3,1,4
DET200206290,2002,20629,DET,PIT,DET05,1,2,3
DET200206300,2002,20630,DET,PIT,DET05,6,2,8
DET200207110,2002,20711,DET,CHA,DET05,9,2,11
DET200207120,2002,20712,DET,CHA,DET05,1,2,3
DET200207131,2002,20713,DET,CHA,DET05,3,5,8
DET200207132,2002,20713,DET,CHA,DET05,1,3,4
DET200207140,2002,20714,DET,CHA,DET05,6,4,10
DET200207150,2002,20715,DET,BOS,DET05,3,4,7
DET200207160,2002,20716,DET,BOS,DET05,9,4,13
DET200207190,2002,20719,DET,MIN,DET05,5,1,6
DET200207200,2002,20720,DET,MIN,DET05,14,4,18
DET200207210,2002,20721,DET,MIN,DET05,4,2,6
DET200207230,2002,20723,DET,KCA,DET05,1,10,11
DET200207240,2002,20724,DET,KCA,DET05,0,3,3
DET200207250,2002,20725,DET,KCA,DET05,2,5,7
DET200208050,2002,20805,DET,ANA,DET05,6,3,9
DET200208060,2002,20806,DET,TEX,DET05,2,8,10
DET200208070,2002,20807,DET,TEX,DET05,7,2,9
DET200208080,2002,20808,DET,TEX,DET05,1,2,3
DET200208090,2002,20809,DET,BAL,DET05,0,3,3
DET200208100,2002,20810,DET,BAL,DET05,3,2,5
DET200208110,2002,20811,DET,BAL,DET05,1,2,3
DET200208190,2002,20819,DET,SEA,DET05,3,4,7
DET200208200,2002,20820,DET,SEA,DET05,3,6,9
DET200208210,2002,20821,DET,SEA,DET05,8,2,10
DET200208220,2002,20822,DET,SEA,DET05,4,2,6
DET200208230,2002,20823,DET,OAK,DET05,9,1,10
DET200208240,2002,20824,DET,OAK,DET05,12,3,15
DET200208250,2002,20825,DET,OAK,DET05,10,7,17
DET200208300,2002,20830,DET,CHA,DET05,4,3,7
DET200208310,2002,20831,DET,CHA,DET05,9,4,13
DET200209010,2002,20901,DET,CHA,DET05,7,0,7
DET200209020,2002,20902,DET,CLE,DET05,11,1,12
DET200209030,2002,20903,DET,CLE,DET05,0,4,4
DET200209040,2002,20904,DET,CLE,DET05,9,3,12
DET200209130,2002,20913,DET,KCA,DET05,2,4,6
DET200209140,2002,20914,DET,KCA,DET05,5,1,6
DET200209150,2002,20915,DET,KCA,DET05,9,3,12
DET200209160,2002,20916,DET,KCA,DET05,2,5,7
DET200209170,2002,20917,DET,MIN,DET05,7,4,11
DET200209180,2002,20918,DET,MIN,DET05,2,0,2
DET200209200,2002,20920,DET,NYA,DET05,5,1,6
DET200209210,2002,20921,DET,NYA,DET05,3,2,5
DET200209220,2002,20922,DET,NYA,DET05,4,3,7
DET200303310,2003,30331,DET,MIN,DET05,3,1,4
DET200304020,2003,30402,DET,MIN,DET05,8,1,9
DET200304030,2003,30403,DET,MIN,DET05,3,0,3
DET200304090,2003,30409,DET,KCA,DET05,9,6,15
DET200304100,2003,30410,DET,KCA,DET05,4,2,6
DET200304110,2003,30411,DET,CHA,DET05,5,0,5
DET200304120,2003,30412,DET,CHA,DET05,3,4,7
DET200304130,2003,30413,DET,CHA,DET05,3,2,5
DET200304290,2003,30429,DET,BAL,DET05,11,3,14
DET200305011,2003,30501,DET,BAL,DET05,5,2,7
DET200305012,2003,30501,DET,BAL,DET05,6,4,10
DET200305020,2003,30502,DET,TBA,DET05,2,0,2
DET200305030,2003,30503,DET,TBA,DET05,8,6,14
DET200305040,2003,30504,DET,TBA,DET05,3,7,10
DET200305130,2003,30513,DET,OAK,DET05,3,1,4
DET200305140,2003,30514,DET,OAK,DET05,1,2,3
DET200305150,2003,30515,DET,OAK,DET05,11,2,13
DET200305160,2003,30516,DET,SEA,DET05,6,3,9
DET200305170,2003,30517,DET,SEA,DET05,6,3,9
DET200305180,2003,30518,DET,SEA,DET05,6,2,8
DET200305260,2003,30526,DET,CLE,DET05,5,6,11
DET200305270,2003,30527,DET,CLE,DET05,5,2,7
DET200305280,2003,30528,DET,CLE,DET05,8,2,10
DET200305300,2003,30530,DET,NYA,DET05,6,0,6
DET200305310,2003,30531,DET,NYA,DET05,2,4,6
DET200306010,2003,30601,DET,NYA,DET05,10,9,19
DET200306100,2003,30610,DET,LAN,DET05,3,1,4
DET200306110,2003,30611,DET,LAN,DET05,3,1,4
DET200306120,2003,30612,DET,LAN,DET05,3,2,5
DET200306130,2003,30613,DET,COL,DET05,7,2,9
DET200306140,2003,30614,DET,COL,DET05,7,9,16
DET200306150,2003,30615,DET,COL,DET05,5,4,9
DET200306170,2003,30617,DET,CLE,DET05,7,4,11
DET200306180,2003,30618,DET,CLE,DET05,4,1,5
DET200306190,2003,30619,DET,CLE,DET05,10,3,13
DET200306270,2003,30627,DET,ARI,DET05,8,3,11
DET200306280,2003,30628,DET,ARI,DET05,7,0,7
DET200306290,2003,30629,DET,ARI,DET05,5,3,8
DET200306300,2003,30630,DET,TOR,DET05,2,6,8
DET200307010,2003,30701,DET,TOR,DET05,0,5,5
DET200307020,2003,30702,DET,TOR,DET05,8,2,10
DET200307080,2003,30708,DET,CHA,DET05,1,2,3
DET200307090,2003,30709,DET,CHA,DET05,2,4,6
DET200307100,2003,30710,DET,CHA,DET05,0,1,1
DET200307110,2003,30711,DET,BOS,DET05,5,3,8
DET200307120,2003,30712,DET,BOS,DET05,4,2,6
DET200307130,2003,30713,DET,BOS,DET05,0,3,3
DET200307250,2003,30725,DET,KCA,DET05,8,3,11
DET200307260,2003,30726,DET,KCA,DET05,1,5,6
DET200307270,2003,30727,DET,KCA,DET05,5,1,6
DET200308050,2003,30805,DET,OAK,DET05,7,2,9
DET200308060,2003,30806,DET,OAK,DET05,9,3,12
DET200308070,2003,30807,DET,OAK,DET05,2,3,5
DET200308080,2003,30808,DET,MIN,DET05,4,3,7
DET200308090,2003,30809,DET,MIN,DET05,8,4,12
DET200308100,2003,30810,DET,MIN,DET05,4,3,7
DET200308180,2003,30818,DET,TEX,DET05,4,2,6
DET200308190,2003,30819,DET,TEX,DET05,5,4,9
DET200308200,2003,30820,DET,TEX,DET05,6,0,6
DET200308210,2003,30821,DET,ANA,DET05,10,7,17
DET200308220,2003,30822,DET,ANA,DET05,6,5,11
DET200308230,2003,30823,DET,ANA,DET05,14,8,22
DET200308240,2003,30824,DET,ANA,DET05,9,10,19
DET200308290,2003,30829,DET,CHA,DET05,4,8,12
DET200308300,2003,30830,DET,CHA,DET05,5,2,7
DET200308310,2003,30831,DET,CHA,DET05,6,1,7
DET200309010,2003,30901,DET,CLE,DET05,7,4,11
DET200309020,2003,30902,DET,CLE,DET05,6,8,14
DET200309030,2003,30903,DET,CLE,DET05,5,6,11
DET200309040,2003,30904,DET,CLE,DET05,1,2,3
DET200309120,2003,30912,DET,KCA,DET05,0,3,3
DET200309130,2003,30913,DET,KCA,DET05,7,0,7
DET200309140,2003,30914,DET,KCA,DET05,7,2,9
DET200309150,2003,30915,DET,KCA,DET05,10,4,14
DET200309160,2003,30916,DET,TOR,DET05,9,6,15
DET200309170,2003,30917,DET,TOR,DET05,6,0,6
DET200309180,2003,30918,DET,TOR,DET05,10,6,16
DET200309250,2003,30925,DET,MIN,DET05,4,5,9
DET200309260,2003,30926,DET,MIN,DET05,5,4,9
DET200309270,2003,30927,DET,MIN,DET05,8,9,17
DET200309280,2003,30928,DET,MIN,DET05,4,9,13
DET200404080,2004,40408,DET,MIN,DET05,6,10,16
DET200404100,2004,40410,DET,MIN,DET05,10,5,15
DET200404110,2004,40411,DET,MIN,DET05,5,6,11
DET200404130,2004,40413,DET,TOR,DET05,7,5,12
DET200404140,2004,40414,DET,TOR,DET05,3,5,8
DET200404150,2004,40415,DET,TOR,DET05,11,0,11
DET200404230,2004,40423,DET,CLE,DET05,3,17,20
DET200404240,2004,40424,DET,CLE,DET05,2,5,7
DET200404250,2004,40425,DET,CLE,DET05,3,2,5
DET200404270,2004,40427,DET,ANA,DET05,10,4,14
DET200404280,2004,40428,DET,ANA,DET05,2,10,12
DET200404290,2004,40429,DET,ANA,DET05,12,3,15
DET200404300,2004,40430,DET,SEA,DET05,3,1,4
DET200405010,2004,40501,DET,SEA,DET05,2,4,6
DET200405020,2004,40502,DET,SEA,DET05,12,2,14
DET200405110,2004,40511,DET,OAK,DET05,5,4,9
DET200405120,2004,40512,DET,OAK,DET05,2,1,3
DET200405130,2004,40513,DET,OAK,DET05,1,3,4
DET200405140,2004,40514,DET,TEX,DET05,1,7,8
DET200405150,2004,40515,DET,TEX,DET05,6,1,7
DET200405160,2004,40516,DET,TEX,DET05,1,3,4
DET200405280,2004,40528,DET,BAL,DET05,7,5,12
DET200405290,2004,40529,DET,BAL,DET05,8,4,12
DET200405300,2004,40530,DET,BAL,DET05,7,3,10
DET200405310,2004,40531,DET,KCA,DET05,4,8,12
DET200406010,2004,40601,DET,KCA,DET05,5,3,8
DET200406020,2004,40602,DET,KCA,DET05,0,2,2
DET200406030,2004,40603,DET,KCA,DET05,9,6,15
DET200406080,2004,40608,DET,ATL,DET05,4,3,7
DET200406090,2004,40609,DET,ATL,DET05,2,4,6
DET200406100,2004,40610,DET,ATL,DET05,4,7,11
DET200406110,2004,40611,DET,FLO,DET05,4,8,12
DET200406120,2004,40612,DET,FLO,DET05,2,6,8
DET200406130,2004,40613,DET,FLO,DET05,9,2,11
DET200406250,2004,40625,DET,ARI,DET05,1,2,3
DET200406260,2004,40626,DET,ARI,DET05,6,7,13
DET200406270,2004,40627,DET,ARI,DET05,5,9,14
DET200406290,2004,40629,DET,CLE,DET05,7,9,16
DET200406300,2004,40630,DET,CLE,DET05,5,12,17
DET200407010,2004,40701,DET,CLE,DET05,7,6,13
DET200407150,2004,40715,DET,NYA,DET05,5,1,6
DET200407160,2004,40716,DET,NYA,DET05,0,8,8
DET200407170,2004,40717,DET,NYA,DET05,5,3,8
DET200407180,2004,40718,DET,NYA,DET05,2,4,6
DET200407190,2004,40719,DET,MIN,DET05,3,1,4
DET200407200,2004,40720,DET,MIN,DET05,5,4,9
DET200407210,2004,40721,DET,KCA,DET05,2,4,6
DET200407220,2004,40722,DET,KCA,DET05,13,7,20
DET200407290,2004,40729,DET,CHA,DET05,2,3,5
DET200407300,2004,40730,DET,CHA,DET05,4,5,9
DET200407310,2004,40731,DET,CHA,DET05,2,3,5
DET200408010,2004,40801,DET,CHA,DET05,6,4,10
DET200408030,2004,40803,DET,TEX,DET05,5,4,9
DET200408040,2004,40804,DET,TEX,DET05,8,0,8
DET200408050,2004,40805,DET,TEX,DET05,2,1,3
DET200408060,2004,40806,DET,BOS,DET05,3,4,7
DET200408070,2004,40807,DET,BOS,DET05,7,4,11
DET200408080,2004,40808,DET,BOS,DET05,11,9,20
DET200408200,2004,40820,DET,SEA,DET05,3,8,11
DET200408210,2004,40821,DET,SEA,DET05,10,11,21
DET200408220,2004,40822,DET,SEA,DET05,5,3,8
DET200408230,2004,40823,DET,CHA,DET05,0,7,7
DET200408240,2004,40824,DET,CHA,DET05,9,5,14
DET200408250,2004,40825,DET,CHA,DET05,4,5,9
DET200409060,2004,40906,DET,KCA,DET05,3,7,10
DET200409070,2004,40907,DET,KCA,DET05,6,2,8
DET200409091,2004,40909,DET,KCA,DET05,26,5,31
DET200409092,2004,40909,DET,KCA,DET05,0,8,8
DET200409100,2004,40910,DET,MIN,DET05,4,1,5
DET200409110,2004,40911,DET,MIN,DET05,3,2,5
DET200409120,2004,40912,DET,MIN,DET05,8,5,13
DET200409130,2004,40913,DET,MIN,DET05,5,3,8
DET200409200,2004,40920,DET,CLE,DET05,1,3,4
DET200409210,2004,40921,DET,CLE,DET05,8,7,15
DET200409220,2004,40922,DET,CLE,DET05,7,6,13
DET200409270,2004,40927,DET,CHA,DET05,2,4,6
DET200409280,2004,40928,DET,CHA,DET05,4,6,10
DET200409290,2004,40929,DET,CHA,DET05,11,2,13
DET200410010,2004,41001,DET,TBA,DET05,4,1,5
DET200410020,2004,41002,DET,TBA,DET05,1,5,6
DET200410030,2004,41003,DET,TBA,DET05,7,4,11
DET200504040,2005,50404,DET,KCA,DET05,2,11,13
DET200504060,2005,50406,DET,KCA,DET05,7,2,9
DET200504070,2005,50407,DET,KCA,DET05,3,7,10
DET200504080,2005,50408,DET,CLE,DET05,4,3,7
DET200504090,2005,50409,DET,CLE,DET05,1,11,12
DET200504100,2005,50410,DET,CLE,DET05,7,6,13
DET200504200,2005,50420,DET,CHA,DET05,9,1,10
DET200504210,2005,50421,DET,CHA,DET05,4,3,7
DET200504220,2005,50422,DET,MIN,DET05,4,5,9
DET200504250,2005,50425,DET,MIN,DET05,4,6,10
DET200505020,2005,50502,DET,BOS,DET05,3,8,11
DET200505030,2005,50503,DET,BOS,DET05,5,3,8
DET200505040,2005,50504,DET,BOS,DET05,4,3,7
DET200505050,2005,50505,DET,BOS,DET05,2,1,3
DET200505141,2005,50514,DET,ANA,DET05,4,2,6
DET200505142,2005,50514,DET,ANA,DET05,2,3,5
DET200505150,2005,50515,DET,ANA,DET05,9,3,12
DET200505170,2005,50517,DET,TBA,DET05,3,4,7
DET200505180,2005,50518,DET,TBA,DET05,4,6,10
DET200505190,2005,50519,DET,TBA,DET05,6,2,8
DET200505200,2005,50520,DET,ARI,DET05,6,2,8
DET200505210,2005,50521,DET,ARI,DET05,2,3,5
DET200505220,2005,50522,DET,ARI,DET05,1,0,1
DET200505310,2005,50531,DET,TEX,DET05,8,2,10
DET200506010,2005,50601,DET,TEX,DET05,4,6,10
DET200506020,2005,50602,DET,TEX,DET05,5,6,11
DET200506030,2005,50603,DET,BAL,DET05,3,5,8
DET200506040,2005,50604,DET,BAL,DET05,14,7,21
DET200506050,2005,50605,DET,BAL,DET05,6,2,8
DET200506140,2005,50614,DET,SDN,DET05,4,8,12
DET200506150,2005,50615,DET,SDN,DET05,2,8,10
DET200506160,2005,50616,DET,SDN,DET05,1,3,4
DET200506170,2005,50617,DET,SFN,DET05,4,0,4
DET200506180,2005,50618,DET,SFN,DET05,2,8,10
DET200506190,2005,50619,DET,SFN,DET05,8,10,18
DET200506280,2005,50628,DET,CHA,DET05,2,1,3
DET200506290,2005,50629,DET,CHA,DET05,4,3,7
DET200506300,2005,50630,DET,CHA,DET05,6,1,7
DET200507010,2005,50701,DET,NYA,DET05,2,10,12
DET200507020,2005,50702,DET,NYA,DET05,8,4,12
DET200507030,2005,50703,DET,NYA,DET05,1,0,1
DET200507140,2005,50714,DET,KCA,DET05,12,9,21
DET200507150,2005,50715,DET,KCA,DET05,1,4,5
DET200507160,2005,50716,DET,KCA,DET05,3,5,8
DET200507170,2005,50717,DET,KCA,DET05,5,0,5
DET200507210,2005,50721,DET,MIN,DET05,10,5,15
DET200507220,2005,50722,DET,MIN,DET05,6,12,18
DET200507231,2005,50723,DET,MIN,DET05,1,2,3
DET200507232,2005,50723,DET,MIN,DET05,5,2,7
DET200507240,2005,50724,DET,MIN,DET05,2,5,7
DET200508020,2005,50802,DET,SEA,DET05,4,1,5
DET200508030,2005,50803,DET,SEA,DET05,7,10,17
DET200508040,2005,50804,DET,SEA,DET05,1,3,4
DET200508050,2005,50805,DET,CLE,DET05,9,6,15
DET200508060,2005,50806,DET,CLE,DET05,4,2,6
DET200508070,2005,50807,DET,CLE,DET05,6,5,11
DET200508150,2005,50815,DET,BOS,DET05,6,7,13
DET200508160,2005,50816,DET,BOS,DET05,10,7,17
DET200508170,2005,50817,DET,BOS,DET05,5,6,11
DET200508190,2005,50819,DET,TOR,DET05,5,9,14
DET200508200,2005,50820,DET,TOR,DET05,2,3,5
DET200508210,2005,50821,DET,TOR,DET05,6,17,23
DET200508230,2005,50823,DET,OAK,DET05,1,4,5
DET200508240,2005,50824,DET,OAK,DET05,9,2,11
DET200508250,2005,50825,DET,OAK,DET05,11,1,12
DET200509050,2005,50905,DET,CLE,DET05,2,0,2
DET200509060,2005,50906,DET,CLE,DET05,6,1,7
DET200509070,2005,50907,DET,CLE,DET05,4,1,5
DET200509090,2005,50909,DET,KCA,DET05,12,2,14
DET200509100,2005,50910,DET,KCA,DET05,3,4,7
DET200509110,2005,50911,DET,KCA,DET05,4,14,18
DET200509120,2005,50912,DET,MIN,DET05,2,1,3
DET200509130,2005,50913,DET,MIN,DET05,9,3,12
DET200509140,2005,50914,DET,MIN,DET05,2,4,6
DET200509230,2005,50923,DET,SEA,DET05,2,1,3
DET200509240,2005,50924,DET,SEA,DET05,1,7,8
DET200509250,2005,50925,DET,SEA,DET05,1,8,9
DET200509260,2005,50926,DET,CHA,DET05,3,4,7
DET200509270,2005,50927,DET,CHA,DET05,2,3,5
DET200509280,2005,50928,DET,CHA,DET05,8,2,10
DET200509290,2005,50929,DET,CHA,DET05,4,2,6
DET200604100,2006,60410,DET,CHA,DET05,5,3,8
DET200604120,2006,60412,DET,CHA,DET05,4,3,7
DET200604130,2006,60413,DET,CHA,DET05,13,9,22
DET200604140,2006,60414,DET,CLE,DET05,1,5,6
DET200604150,2006,60415,DET,CLE,DET05,7,2,9
DET200604160,2006,60416,DET,CLE,DET05,0,1,1
DET200604170,2006,60417,DET,CLE,DET05,10,2,12
DET200604280,2006,60428,DET,MIN,DET05,0,9,9
DET200604290,2006,60429,DET,MIN,DET05,1,18,19
DET200604300,2006,60430,DET,MIN,DET05,0,6,6
DET200605010,2006,60501,DET,KCA,DET05,2,3,5
DET200605020,2006,60502,DET,KCA,DET05,1,4,5
DET200605030,2006,60503,DET,ANA,DET05,1,2,3
DET200605040,2006,60504,DET,ANA,DET05,7,2,9
DET200605160,2006,60516,DET,MIN,DET05,4,7,11
DET200605170,2006,60517,DET,MIN,DET05,0,2,2
DET200605180,2006,60518,DET,MIN,DET05,3,5,8
DET200605190,2006,60519,DET,CIN,DET05,9,4,13
DET200605200,2006,60520,DET,CIN,DET05,6,7,13
DET200605210,2006,60521,DET,CIN,DET05,0,1,1
DET200605260,2006,60526,DET,CLE,DET05,3,8,11
DET200605270,2006,60527,DET,CLE,DET05,1,3,4
DET200605280,2006,60528,DET,CLE,DET05,9,0,9
DET200605290,2006,60529,DET,NYA,DET05,4,0,4
DET200605300,2006,60530,DET,NYA,DET05,11,6,17
DET200605310,2006,60531,DET,NYA,DET05,6,1,7
DET200606010,2006,60601,DET,NYA,DET05,6,7,13
DET200606020,2006,60602,DET,BOS,DET05,3,2,5
DET200606030,2006,60603,DET,BOS,DET05,2,6,8
DET200606040,2006,60604,DET,BOS,DET05,8,3,11
DET200606120,2006,60612,DET,TBA,DET05,3,4,7
DET200606130,2006,60613,DET,TBA,DET05,1,7,8
DET200606140,2006,60614,DET,TBA,DET05,5,1,6
DET200606150,2006,60615,DET,TBA,DET05,2,6,8
DET200606230,2006,60623,DET,SLN,DET05,6,10,16
DET200606240,2006,60624,DET,SLN,DET05,6,7,13
DET200606250,2006,60625,DET,SLN,DET05,1,4,5
DET200606260,2006,60626,DET,HOU,DET05,4,10,14
DET200606270,2006,60627,DET,HOU,DET05,0,4,4
DET200606280,2006,60628,DET,HOU,DET05,0,5,5
DET200607130,2006,60713,DET,KCA,DET05,4,6,10
DET200607140,2006,60714,DET,KCA,DET05,9,10,19
DET200607150,2006,60715,DET,KCA,DET05,0,6,6
DET200607160,2006,60716,DET,KCA,DET05,9,6,15
DET200607180,2006,60718,DET,CHA,DET05,7,1,8
DET200607190,2006,60719,DET,CHA,DET05,2,5,7
DET200607200,2006,60720,DET,CHA,DET05,1,2,3
DET200607210,2006,60721,DET,OAK,DET05,4,7,11
DET200607220,2006,60722,DET,OAK,DET05,9,5,14
DET200607230,2006,60723,DET,OAK,DET05,4,8,12
DET200608040,2006,60804,DET,CLE,DET05,6,7,13
DET200608050,2006,60805,DET,CLE,DET05,3,4,7
DET200608060,2006,60806,DET,CLE,DET05,0,1,1
DET200608070,2006,60807,DET,MIN,DET05,3,9,12
DET200608080,2006,60808,DET,MIN,DET05,4,2,6
DET200608090,2006,60809,DET,MIN,DET05,4,3,7
DET200608170,2006,60817,DET,TEX,DET05,2,4,6
DET200608180,2006,60818,DET,TEX,DET05,2,1,3
DET200608190,2006,60819,DET,TEX,DET05,3,1,4
DET200608200,2006,60820,DET,TEX,DET05,7,6,13
DET200608210,2006,60821,DET,CHA,DET05,1,7,8
DET200608220,2006,60822,DET,CHA,DET05,0,4,4
DET200608230,2006,60823,DET,CHA,DET05,7,5,12
DET200608240,2006,60824,DET,CHA,DET05,10,0,10
DET200609010,2006,60901,DET,ANA,DET05,0,9,9
DET200609020,2006,60902,DET,ANA,DET05,7,2,9
DET200609030,2006,60903,DET,ANA,DET05,2,1,3
DET200609040,2006,60904,DET,SEA,DET05,2,6,8
DET200609050,2006,60905,DET,SEA,DET05,4,3,7
DET200609060,2006,60906,DET,SEA,DET05,5,4,9
DET200609120,2006,60912,DET,TEX,DET05,2,3,5
DET200609130,2006,60913,DET,TEX,DET05,11,3,14
DET200609150,2006,60915,DET,BAL,DET05,2,17,19
DET200609160,2006,60916,DET,BAL,DET05,0,2,2
DET200609170,2006,60917,DET,BAL,DET05,12,8,20
DET200609260,2006,60926,DET,TOR,DET05,3,4,7
DET200609270,2006,60927,DET,TOR,DET05,7,4,11
DET200609280,2006,60928,DET,TOR,DET05,8,6,14
DET200609290,2006,60929,DET,KCA,DET05,9,7,16
DET200609300,2006,60930,DET,KCA,DET05,9,6,15
DET200610010,2006,61001,DET,KCA,DET05,10,8,18
DET200610060,2006,61006,DET,NYA,DET05,0,6,6
DET200610070,2006,61007,DET,NYA,DET05,3,8,11
DET200610130,2006,61013,DET,OAK,DET05,0,3,3
DET200610140,2006,61014,DET,OAK,DET05,3,6,9
DET200610210,2006,61021,DET,SLN,DET05,7,2,9
DET200610220,2006,61022,DET,SLN,DET05,1,3,4
DET200704020,2007,70402,DET,TOR,DET05,5,3,8
DET200704040,2007,70404,DET,TOR,DET05,9,10,19
DET200704160,2007,70416,DET,KCA,DET05,5,12,17
DET200704170,2007,70417,DET,KCA,DET05,6,7,13
DET200704180,2007,70418,DET,KCA,DET05,4,3,7
DET200704200,2007,70420,DET,CHA,DET05,5,4,9
DET200704210,2007,70421,DET,CHA,DET05,7,5,12
DET200704220,2007,70422,DET,CHA,DET05,5,6,11
DET200704270,2007,70427,DET,MIN,DET05,5,3,8
DET200704280,2007,70428,DET,MIN,DET05,11,3,14
DET200704290,2007,70429,DET,MIN,DET05,3,4,7
DET200704300,2007,70430,DET,BAL,DET05,4,8,12
DET200705010,2007,70501,DET,BAL,DET05,4,5,9
DET200705020,2007,70502,DET,BAL,DET05,2,3,5
DET200705080,2007,70508,DET,SEA,DET05,7,9,16
DET200705090,2007,70509,DET,SEA,DET05,9,2,11
DET200705100,2007,70510,DET,SEA,DET05,3,7,10
DET200705180,2007,70518,DET,SLN,DET05,4,14,18
DET200705190,2007,70519,DET,SLN,DET05,7,8,15
DET200705200,2007,70520,DET,SLN,DET05,3,6,9
DET200705220,2007,70522,DET,ANA,DET05,6,3,9
DET200705230,2007,70523,DET,ANA,DET05,7,8,15
DET200705240,2007,70524,DET,ANA,DET05,0,12,12
DET200705250,2007,70525,DET,CLE,DET05,7,4,11
DET200705260,2007,70526,DET,CLE,DET05,6,3,9
DET200705270,2007,70527,DET,CLE,DET05,5,3,8
DET200706080,2007,70608,DET,NYN,DET05,3,0,3
DET200706090,2007,70609,DET,NYN,DET05,7,8,15
DET200706100,2007,70610,DET,NYN,DET05,7,15,22
DET200706120,2007,70612,DET,MIL,DET05,0,4,4
DET200706130,2007,70613,DET,MIL,DET05,3,2,5
DET200706140,2007,70614,DET,MIL,DET05,6,5,11
DET200706250,2007,70625,DET,TEX,DET05,8,3,11
DET200706260,2007,70626,DET,TEX,DET05,9,6,15
DET200706280,2007,70628,DET,TEX,DET05,2,5,7
DET200706290,2007,70629,DET,MIN,DET05,11,1,12
DET200706300,2007,70630,DET,MIN,DET05,8,5,13
DET200707010,2007,70701,DET,MIN,DET05,0,1,1
DET200707030,2007,70703,DET,CLE,DET05,5,4,9
DET200707040,2007,70704,DET,CLE,DET05,4,6,10
DET200707050,2007,70705,DET,CLE,DET05,3,12,15
DET200707060,2007,70706,DET,BOS,DET05,2,9,11
DET200707070,2007,70707,DET,BOS,DET05,2,3,5
DET200707080,2007,70708,DET,BOS,DET05,5,6,11
DET200707200,2007,70720,DET,KCA,DET05,10,2,12
DET200707210,2007,70721,DET,KCA,DET05,8,10,18
DET200707220,2007,70722,DET,KCA,DET05,5,2,7
DET200708030,2007,70803,DET,CHA,DET05,7,4,11
DET200708040,2007,70804,DET,CHA,DET05,7,5,12
DET200708050,2007,70805,DET,CHA,DET05,3,1,4
DET200708060,2007,70806,DET,TBA,DET05,4,6,10
DET200708070,2007,70807,DET,TBA,DET05,6,9,15
DET200708080,2007,70808,DET,TBA,DET05,7,1,8
DET200708090,2007,70809,DET,TBA,DET05,8,1,9
DET200708100,2007,70810,DET,OAK,DET05,16,10,26
DET200708110,2007,70811,DET,OAK,DET05,2,5,7
DET200708120,2007,70812,DET,OAK,DET05,6,11,17
DET200708130,2007,70813,DET,OAK,DET05,7,2,9
DET200708210,2007,70821,DET,CLE,DET05,1,2,3
DET200708220,2007,70822,DET,CLE,DET05,11,8,19
DET200708230,2007,70823,DET,CLE,DET05,3,1,4
DET200708240,2007,70824,DET,NYA,DET05,6,9,15
DET200708250,2007,70825,DET,NYA,DET05,7,2,9
DET200708260,2007,70826,DET,NYA,DET05,4,5,9
DET200708270,2007,70827,DET,NYA,DET05,0,16,16
DET200709040,2007,70904,DET,CHA,DET05,3,1,4
DET200709050,2007,70905,DET,CHA,DET05,1,2,3
DET200709060,2007,70906,DET,CHA,DET05,2,3,5
DET200709070,2007,70907,DET,SEA,DET05,1,6,7
DET200709080,2007,70908,DET,SEA,DET05,6,12,18
DET200709090,2007,70909,DET,SEA,DET05,14,7,21
DET200709100,2007,70910,DET,TOR,DET05,4,5,9
DET200709111,2007,70911,DET,TEX,DET05,13,6,19
DET200709112,2007,70911,DET,TEX,DET05,1,4,5
DET200709120,2007,70912,DET,TEX,DET05,1,5,6
DET200709210,2007,70921,DET,KCA,DET05,4,5,9
DET200709220,2007,70922,DET,KCA,DET05,7,4,11
DET200709230,2007,70923,DET,KCA,DET05,2,7,9
DET200709240,2007,70924,DET,MIN,DET05,2,0,2
DET200709250,2007,70925,DET,MIN,DET05,0,8,8
DET200709260,2007,70926,DET,MIN,DET05,4,9,13
DET200803310,2008,80331,DET,KCA,DET05,5,4,9
DET200804020,2008,80402,DET,KCA,DET05,4,0,4
DET200804030,2008,80403,DET,KCA,DET05,4,1,5
DET200804040,2008,80404,DET,CHA,DET05,8,5,13
DET200804050,2008,80405,DET,CHA,DET05,5,3,8
DET200804060,2008,80406,DET,CHA,DET05,13,2,15
DET200804140,2008,80414,DET,MIN,DET05,9,11,20
DET200804150,2008,80415,DET,MIN,DET05,5,6,11
DET200804220,2008,80422,DET,TEX,DET05,2,10,12
DET200804230,2008,80423,DET,TEX,DET05,6,19,25
DET200804240,2008,80424,DET,TEX,DET05,2,8,10
DET200804250,2008,80425,DET,ANA,DET05,4,3,7
DET200804260,2008,80426,DET,ANA,DET05,4,6,10
DET200804270,2008,80427,DET,ANA,DET05,6,2,8
DET200805050,2008,80505,DET,BOS,DET05,6,3,9
DET200805060,2008,80506,DET,BOS,DET05,5,0,5
DET200805070,2008,80507,DET,BOS,DET05,9,10,19
DET200805080,2008,80508,DET,BOS,DET05,5,1,6
DET200805090,2008,80509,DET,NYA,DET05,5,6,11
DET200805100,2008,80510,DET,NYA,DET05,5,2,7
DET200805200,2008,80520,DET,SEA,DET05,8,12,20
DET200805210,2008,80521,DET,SEA,DET05,4,9,13
DET200805220,2008,80522,DET,SEA,DET05,2,9,11
DET200805230,2008,80523,DET,MIN,DET05,9,4,13
DET200805240,2008,80524,DET,MIN,DET05,3,19,22
DET200805250,2008,80525,DET,MIN,DET05,6,1,7
DET200806060,2008,80606,DET,CLE,DET05,4,2,6
DET200806070,2008,80607,DET,CLE,DET05,4,8,12
DET200806080,2008,80608,DET,CLE,DET05,2,5,7
DET200806090,2008,80609,DET,CLE,DET05,8,2,10
DET200806100,2008,80610,DET,CHA,DET05,4,6,10
DET200806110,2008,80611,DET,CHA,DET05,1,5,6
DET200806120,2008,80612,DET,CHA,DET05,1,2,3
DET200806130,2008,80613,DET,LAN,DET05,0,5,5
DET200806140,2008,80614,DET,LAN,DET05,7,12,19
DET200806150,2008,80615,DET,LAN,DET05,4,5,9
DET200806240,2008,80624,DET,SLN,DET05,8,4,12
DET200806250,2008,80625,DET,SLN,DET05,7,8,15
DET200806260,2008,80626,DET,SLN,DET05,2,3,5
DET200806270,2008,80627,DET,COL,DET05,1,7,8
DET200806280,2008,80628,DET,COL,DET05,6,7,13
DET200806290,2008,80629,DET,COL,DET05,3,4,7
DET200807080,2008,80708,DET,CLE,DET05,2,9,11
DET200807090,2008,80709,DET,CLE,DET05,6,8,14
DET200807100,2008,80710,DET,MIN,DET05,7,6,13
DET200807110,2008,80711,DET,MIN,DET05,3,2,5
DET200807120,2008,80712,DET,MIN,DET05,6,5,11
DET200807130,2008,80713,DET,MIN,DET05,2,4,6
DET200807250,2008,80725,DET,CHA,DET05,6,5,11
DET200807260,2008,80726,DET,CHA,DET05,7,6,13
DET200807270,2008,80727,DET,CHA,DET05,4,6,10
DET200808080,2008,80808,DET,OAK,DET05,4,2,6
DET200808090,2008,80809,DET,OAK,DET05,2,10,12
DET200808100,2008,80810,DET,OAK,DET05,1,6,7
DET200808110,2008,80811,DET,TOR,DET05,7,2,9
DET200808120,2008,80812,DET,TOR,DET05,6,4,10
DET200808130,2008,80813,DET,TOR,DET05,4,3,7
DET200808140,2008,80814,DET,TOR,DET05,1,5,6
DET200808150,2008,80815,DET,BAL,DET05,11,2,13
DET200808160,2008,80816,DET,BAL,DET05,3,5,8
DET200808170,2008,80817,DET,BAL,DET05,16,8,24
DET200808250,2008,80825,DET,CLE,DET05,4,3,7
DET200808260,2008,80826,DET,CLE,DET05,10,4,14
DET200808270,2008,80827,DET,CLE,DET05,9,7,16
DET200808290,2008,80829,DET,KCA,DET05,3,6,9
DET200808300,2008,80830,DET,KCA,DET05,13,3,16
DET200808310,2008,80831,DET,KCA,DET05,2,4,6
DET200809010,2008,80901,DET,NYA,DET05,13,9,22
DET200809020,2008,80902,DET,ANA,DET05,5,4,9
DET200809030,2008,80903,DET,ANA,DET05,6,9,15
DET200809040,2008,80904,DET,ANA,DET05,7,1,8
DET200809080,2008,80908,DET,OAK,DET05,8,14,22
DET200809090,2008,80909,DET,OAK,DET05,3,2,5
DET200809100,2008,80910,DET,OAK,DET05,5,2,7
DET200809220,2008,80922,DET,KCA,DET05,6,2,8
DET200809230,2008,80923,DET,KCA,DET05,5,0,5
DET200809240,2008,80924,DET,KCA,DET05,10,4,14
DET200809250,2008,80925,DET,TBA,DET05,5,7,12
DET200809260,2008,80926,DET,TBA,DET05,4,6,10
DET200809270,2008,80927,DET,TBA,DET05,3,4,7
DET200809280,2008,80928,DET,TBA,DET05,8,7,15
DET200904100,2009,90410,DET,TEX,DET05,2,15,17
DET200904110,2009,90411,DET,TEX,DET05,3,4,7
DET200904120,2009,90412,DET,TEX,DET05,4,6,10
DET200904130,2009,90413,DET,CHA,DET05,10,6,16
DET200904150,2009,90415,DET,CHA,DET05,0,9,9
DET200904270,2009,90427,DET,NYA,DET05,2,4,6
DET200904280,2009,90428,DET,NYA,DET05,11,0,11
DET200904290,2009,90429,DET,NYA,DET05,8,6,14
DET200905010,2009,90501,DET,CLE,DET05,6,5,11
DET200905020,2009,90502,DET,CLE,DET05,7,9,16
DET200905030,2009,90503,DET,CLE,DET05,1,3,4
DET200905040,2009,90504,DET,MIN,DET05,7,2,9
DET200905050,2009,90505,DET,MIN,DET05,0,9,9
DET200905150,2009,90515,DET,OAK,DET05,1,14,15
DET200905160,2009,90516,DET,OAK,DET05,1,9,10
DET200905170,2009,90517,DET,OAK,DET05,7,11,18
DET200905190,2009,90519,DET,TEX,DET05,0,4,4
DET200905200,2009,90520,DET,TEX,DET05,3,5,8
DET200905210,2009,90521,DET,TEX,DET05,3,4,7
DET200905220,2009,90522,DET,COL,DET05,3,4,7
DET200905230,2009,90523,DET,COL,DET05,4,3,7
DET200905240,2009,90524,DET,COL,DET05,3,1,4
DET200906020,2009,90602,DET,BOS,DET05,5,1,6
DET200906030,2009,90603,DET,BOS,DET05,10,5,15
DET200906040,2009,90604,DET,BOS,DET05,6,3,9
DET200906050,2009,90605,DET,ANA,DET05,2,1,3
DET200906060,2009,90606,DET,ANA,DET05,1,2,3
DET200906070,2009,90607,DET,ANA,DET05,6,9,15
DET200906190,2009,90619,DET,MIL,DET05,4,10,14
DET200906200,2009,90620,DET,MIL,DET05,5,9,14
DET200906210,2009,90621,DET,MIL,DET05,2,3,5
DET200906230,2009,90623,DET,CHN,DET05,4,5,9
DET200906240,2009,90624,DET,CHN,DET05,3,5,8
DET200906250,2009,90625,DET,CHN,DET05,5,6,11
DET200907060,2009,90706,DET,KCA,DET05,4,3,7
DET200907070,2009,90707,DET,KCA,DET05,5,8,13
DET200907080,2009,90708,DET,KCA,DET05,1,3,4
DET200907100,2009,90710,DET,CLE,DET05,1,5,6
DET200907110,2009,90711,DET,CLE,DET05,5,4,9
DET200907120,2009,90712,DET,CLE,DET05,1,10,11
DET200907210,2009,90721,DET,SEA,DET05,7,9,16
DET200907220,2009,90722,DET,SEA,DET05,2,1,3
DET200907230,2009,90723,DET,SEA,DET05,2,1,3
DET200907241,2009,90724,DET,CHA,DET05,1,5,6
DET200907242,2009,90724,DET,CHA,DET05,3,4,7
DET200907250,2009,90725,DET,CHA,DET05,3,4,7
DET200907260,2009,90726,DET,CHA,DET05,5,1,6
DET200908030,2009,90803,DET,BAL,DET05,5,6,11
DET200908040,2009,90804,DET,BAL,DET05,8,2,10
DET200908050,2009,90805,DET,BAL,DET05,2,4,6
DET200908060,2009,90806,DET,BAL,DET05,3,7,10
DET200908070,2009,90807,DET,MIN,DET05,8,10,18
DET200908080,2009,90808,DET,MIN,DET05,11,0,11
DET200908090,2009,90809,DET,MIN,DET05,7,8,15
DET200908140,2009,90814,DET,KCA,DET05,0,1,1
DET200908150,2009,90815,DET,KCA,DET05,3,10,13
DET200908160,2009,90816,DET,KCA,DET05,3,2,5
DET200908180,2009,90818,DET,SEA,DET05,3,5,8
DET200908190,2009,90819,DET,SEA,DET05,3,1,4
DET200908200,2009,90820,DET,SEA,DET05,6,7,13
DET200908280,2009,90828,DET,TBA,DET05,2,6,8
DET200908290,2009,90829,DET,TBA,DET05,3,1,4
DET200908300,2009,90830,DET,TBA,DET05,3,4,7
DET200908310,2009,90831,DET,TBA,DET05,11,7,18
DET200909010,2009,90901,DET,CLE,DET05,5,8,13
DET200909020,2009,90902,DET,CLE,DET05,2,4,6
DET200909030,2009,90903,DET,CLE,DET05,3,4,7
DET200909110,2009,90911,DET,TOR,DET05,6,4,10
DET200909120,2009,90912,DET,TOR,DET05,8,6,14
DET200909130,2009,90913,DET,TOR,DET05,2,7,9
DET200909140,2009,90914,DET,TOR,DET05,5,6,11
DET200909150,2009,90915,DET,KCA,DET05,11,1,12
DET200909160,2009,90916,DET,KCA,DET05,3,4,7
DET200909170,2009,90917,DET,KCA,DET05,9,2,11
DET200909291,2009,90929,DET,MIN,DET05,3,2,5
DET200909292,2009,90929,DET,MIN,DET05,5,6,11
DET200909300,2009,90930,DET,MIN,DET05,2,7,9
DET200910010,2009,91001,DET,MIN,DET05,8,3,11
DET200910020,2009,91002,DET,CHA,DET05,8,0,8
DET200910030,2009,91003,DET,CHA,DET05,5,1,6
DET200910040,2009,91004,DET,CHA,DET05,3,5,8
FLO200004030,2000,403,FLO,SFN,MIA01,4,6,10
FLO200004040,2000,404,FLO,SFN,MIA01,3,0,3
FLO200004050,2000,405,FLO,SFN,MIA01,11,9,20
FLO200004060,2000,406,FLO,SFN,MIA01,4,5,9
FLO200004070,2000,407,FLO,COL,MIA01,3,4,7
FLO200004080,2000,408,FLO,COL,MIA01,4,2,6
FLO200004090,2000,409,FLO,COL,MIA01,6,7,13
FLO200004180,2000,418,FLO,PIT,MIA01,5,12,17
FLO200004190,2000,419,FLO,PIT,MIA01,5,1,6
FLO200004200,2000,420,FLO,PIT,MIA01,2,3,5
FLO200004210,2000,421,FLO,PHI,MIA01,4,3,7
FLO200004220,2000,422,FLO,PHI,MIA01,2,4,6
FLO200004230,2000,423,FLO,PHI,MIA01,2,5,7
FLO200004240,2000,424,FLO,PHI,MIA01,1,3,4
FLO200004250,2000,425,FLO,SFN,MIA01,6,4,10
FLO200004260,2000,426,FLO,SFN,MIA01,8,7,15
FLO200005050,2000,505,FLO,NYN,MIA01,4,1,5
FLO200005060,2000,506,FLO,NYN,MIA01,1,9,10
FLO200005070,2000,507,FLO,NYN,MIA01,0,3,3
FLO200005080,2000,508,FLO,ATL,MIA01,2,3,5
FLO200005090,2000,509,FLO,ATL,MIA01,10,5,15
FLO200005100,2000,510,FLO,ATL,MIA01,3,5,8
FLO200005110,2000,511,FLO,ATL,MIA01,4,5,9
FLO200005160,2000,516,FLO,SDN,MIA01,7,3,10
FLO200005170,2000,517,FLO,SDN,MIA01,2,4,6
FLO200005180,2000,518,FLO,SDN,MIA01,6,2,8
FLO200005190,2000,519,FLO,LAN,MIA01,5,3,8
FLO200005200,2000,520,FLO,LAN,MIA01,12,6,18
FLO200005210,2000,521,FLO,LAN,MIA01,12,3,15
FLO200006020,2000,602,FLO,TOR,MIA01,10,11,21
FLO200006030,2000,603,FLO,TOR,MIA01,1,2,3
FLO200006040,2000,604,FLO,TOR,MIA01,7,2,9
FLO200006050,2000,605,FLO,BOS,MIA01,3,2,5
FLO200006060,2000,606,FLO,BOS,MIA01,4,3,7
FLO200006070,2000,607,FLO,BOS,MIA01,2,6,8
FLO200006190,2000,619,FLO,MIL,MIA01,2,0,2
FLO200006200,2000,620,FLO,MIL,MIA01,2,8,10
FLO200006210,2000,621,FLO,MIL,MIA01,4,5,9
FLO200006220,2000,622,FLO,MIL,MIA01,6,1,7
FLO200006230,2000,623,FLO,CHN,MIA01,1,6,7
FLO200006240,2000,624,FLO,CHN,MIA01,4,7,11
FLO200006250,2000,625,FLO,CHN,MIA01,7,8,15
FLO200007030,2000,703,FLO,NYN,MIA01,0,2,2
FLO200007040,2000,704,FLO,NYN,MIA01,8,9,17
FLO200007050,2000,705,FLO,NYN,MIA01,11,2,13
FLO200007070,2000,707,FLO,TBA,MIA01,8,3,11
FLO200007080,2000,708,FLO,TBA,MIA01,5,6,11
FLO200007090,2000,709,FLO,TBA,MIA01,9,10,19
FLO200007201,2000,720,FLO,ATL,MIA01,5,3,8
FLO200007202,2000,720,FLO,ATL,MIA01,1,6,7
FLO200007210,2000,721,FLO,MON,MIA01,7,3,10
FLO200007220,2000,722,FLO,MON,MIA01,17,7,24
FLO200007230,2000,723,FLO,MON,MIA01,7,6,13
FLO200007280,2000,728,FLO,ARI,MIA01,4,1,5
FLO200007290,2000,729,FLO,ARI,MIA01,2,4,6
FLO200007300,2000,730,FLO,ARI,MIA01,3,4,7
FLO200007310,2000,731,FLO,HOU,MIA01,4,2,6
FLO200008010,2000,801,FLO,HOU,MIA01,4,3,7
FLO200008020,2000,802,FLO,HOU,MIA01,4,5,9
FLO200008030,2000,803,FLO,HOU,MIA01,3,4,7
FLO200008110,2000,811,FLO,SDN,MIA01,3,0,3
FLO200008120,2000,812,FLO,SDN,MIA01,2,1,3
FLO200008130,2000,813,FLO,SDN,MIA01,7,3,10
FLO200008140,2000,814,FLO,LAN,MIA01,2,11,13
FLO200008150,2000,815,FLO,LAN,MIA01,3,7,10
FLO200008160,2000,816,FLO,LAN,MIA01,10,4,14
FLO200008250,2000,825,FLO,CIN,MIA01,6,0,6
FLO200008260,2000,826,FLO,CIN,MIA01,3,2,5
FLO200008270,2000,827,FLO,CIN,MIA01,6,7,13
FLO200008280,2000,828,FLO,SLN,MIA01,5,2,7
FLO200008290,2000,829,FLO,SLN,MIA01,1,3,4
FLO200008300,2000,830,FLO,SLN,MIA01,4,2,6
FLO200009080,2000,908,FLO,ARI,MIA01,2,1,3
FLO200009090,2000,909,FLO,ARI,MIA01,4,1,5
FLO200009100,2000,910,FLO,ARI,MIA01,3,4,7
FLO200009260,2000,926,FLO,MON,MIA01,4,5,9
FLO200009270,2000,927,FLO,MON,MIA01,3,6,9
FLO200009280,2000,928,FLO,MON,MIA01,4,7,11
FLO200009290,2000,929,FLO,PHI,MIA01,1,7,8
FLO200009300,2000,930,FLO,PHI,MIA01,5,11,16
FLO200010010,2000,1001,FLO,PHI,MIA01,5,7,12
FLO200104020,2001,10402,FLO,PHI,MIA01,6,5,11
FLO200104030,2001,10403,FLO,PHI,MIA01,4,3,7
FLO200104040,2001,10404,FLO,PHI,MIA01,7,3,10
FLO200104060,2001,10406,FLO,ATL,MIA01,7,5,12
FLO200104070,2001,10407,FLO,ATL,MIA01,0,8,8
FLO200104080,2001,10408,FLO,ATL,MIA01,1,6,7
FLO200104190,2001,10419,FLO,MON,MIA01,2,5,7
FLO200104200,2001,10420,FLO,MON,MIA01,1,5,6
FLO200104210,2001,10421,FLO,MON,MIA01,0,5,5
FLO200104220,2001,10422,FLO,MON,MIA01,6,2,8
FLO200105010,2001,10501,FLO,SLN,MIA01,3,4,7
FLO200105020,2001,10502,FLO,SLN,MIA01,4,2,6
FLO200105040,2001,10504,FLO,MIL,MIA01,6,9,15
FLO200105050,2001,10505,FLO,MIL,MIA01,8,2,10
FLO200105060,2001,10506,FLO,MIL,MIA01,1,5,6
FLO200105150,2001,10515,FLO,SFN,MIA01,7,4,11
FLO200105160,2001,10516,FLO,SFN,MIA01,3,4,7
FLO200105170,2001,10517,FLO,SFN,MIA01,3,8,11
FLO200105180,2001,10518,FLO,COL,MIA01,1,2,3
FLO200105190,2001,10519,FLO,COL,MIA01,0,1,1
FLO200105200,2001,10520,FLO,COL,MIA01,7,2,9
FLO200105210,2001,10521,FLO,ATL,MIA01,5,3,8
FLO200105220,2001,10522,FLO,ATL,MIA01,2,3,5
FLO200105310,2001,10531,FLO,NYN,MIA01,3,5,8
FLO200106010,2001,10601,FLO,NYN,MIA01,11,5,16
FLO200106020,2001,10602,FLO,NYN,MIA01,7,1,8
FLO200106030,2001,10603,FLO,NYN,MIA01,0,1,1
FLO200106050,2001,10605,FLO,PIT,MIA01,5,2,7
FLO200106060,2001,10606,FLO,PIT,MIA01,2,7,9
FLO200106070,2001,10607,FLO,PIT,MIA01,3,5,8
FLO200106150,2001,10615,FLO,TBA,MIA01,4,7,11
FLO200106160,2001,10616,FLO,TBA,MIA01,0,11,11
FLO200106170,2001,10617,FLO,TBA,MIA01,4,6,10
FLO200106220,2001,10622,FLO,PHI,MIA01,1,8,9
FLO200106230,2001,10623,FLO,PHI,MIA01,1,12,13
FLO200106240,2001,10624,FLO,PHI,MIA01,9,3,12
FLO200106250,2001,10625,FLO,MON,MIA01,3,1,4
FLO200106260,2001,10626,FLO,MON,MIA01,0,3,3
FLO200106270,2001,10627,FLO,MON,MIA01,1,9,10
FLO200107120,2001,10712,FLO,NYA,MIA01,3,9,12
FLO200107130,2001,10713,FLO,NYA,MIA01,1,11,12
FLO200107140,2001,10714,FLO,NYA,MIA01,5,4,9
FLO200107150,2001,10715,FLO,BAL,MIA01,1,7,8
FLO200107160,2001,10716,FLO,BAL,MIA01,0,4,4
FLO200107170,2001,10717,FLO,BAL,MIA01,3,8,11
FLO200107200,2001,10720,FLO,CIN,MIA01,3,5,8
FLO200107210,2001,10721,FLO,CIN,MIA01,8,4,12
FLO200107220,2001,10722,FLO,CIN,MIA01,7,11,18
FLO200107240,2001,10724,FLO,NYN,MIA01,3,4,7
FLO200107250,2001,10725,FLO,NYN,MIA01,5,2,7
FLO200108070,2001,10807,FLO,ARI,MIA01,4,10,14
FLO200108080,2001,10808,FLO,ARI,MIA01,7,1,8
FLO200108090,2001,10809,FLO,ARI,MIA01,1,3,4
FLO200108100,2001,10810,FLO,HOU,MIA01,7,2,9
FLO200108110,2001,10811,FLO,HOU,MIA01,5,13,18
FLO200108120,2001,10812,FLO,HOU,MIA01,10,5,15
FLO200108210,2001,10821,FLO,LAN,MIA01,5,4,9
FLO200108220,2001,10822,FLO,LAN,MIA01,6,8,14
FLO200108230,2001,10823,FLO,LAN,MIA01,6,2,8
FLO200108240,2001,10824,FLO,SDN,MIA01,3,6,9
FLO200108250,2001,10825,FLO,SDN,MIA01,7,1,8
FLO200108260,2001,10826,FLO,SDN,MIA01,10,0,10
FLO200108270,2001,10827,FLO,SDN,MIA01,8,3,11
FLO200109030,2001,10903,FLO,CHN,MIA01,10,2,12
FLO200109040,2001,10904,FLO,CHN,MIA01,1,8,9
FLO200109050,2001,10905,FLO,CHN,MIA01,6,7,13
FLO200109060,2001,10906,FLO,NYN,MIA01,5,2,7
FLO200109070,2001,10907,FLO,NYN,MIA01,6,1,7
FLO200109080,2001,10908,FLO,NYN,MIA01,9,7,16
FLO200109090,2001,10909,FLO,NYN,MIA01,2,4,6
FLO200109240,2001,10924,FLO,ATL,MIA01,0,1,1
FLO200109250,2001,10925,FLO,ATL,MIA01,5,2,7
FLO200109260,2001,10926,FLO,ATL,MIA01,4,1,5
FLO200109270,2001,10927,FLO,ATL,MIA01,1,7,8
FLO200109280,2001,10928,FLO,PHI,MIA01,5,6,11
FLO200109290,2001,10929,FLO,PHI,MIA01,5,4,9
FLO200109300,2001,10930,FLO,PHI,MIA01,3,8,11
FLO200110020,2001,11002,FLO,MON,MIA01,3,4,7
FLO200110030,2001,11003,FLO,MON,MIA01,2,0,2
FLO200110040,2001,11004,FLO,MON,MIA01,2,6,8
FLO200204080,2002,20408,FLO,MON,MIA01,10,2,12
FLO200204100,2002,20410,FLO,MON,MIA01,9,7,16
FLO200204110,2002,20411,FLO,MON,MIA01,5,7,12
FLO200204120,2002,20412,FLO,ATL,MIA01,2,0,2
FLO200204130,2002,20413,FLO,ATL,MIA01,4,5,9
FLO200204140,2002,20414,FLO,ATL,MIA01,0,7,7
FLO200204160,2002,20416,FLO,PHI,MIA01,6,7,13
FLO200204170,2002,20417,FLO,PHI,MIA01,7,5,12
FLO200204180,2002,20418,FLO,PHI,MIA01,7,8,15
FLO200204230,2002,20423,FLO,HOU,MIA01,3,4,7
FLO200204240,2002,20424,FLO,HOU,MIA01,7,4,11
FLO200204250,2002,20425,FLO,HOU,MIA01,4,5,9
FLO200204260,2002,20426,FLO,ARI,MIA01,5,3,8
FLO200204270,2002,20427,FLO,ARI,MIA01,3,6,9
FLO200204280,2002,20428,FLO,ARI,MIA01,5,4,9
FLO200205070,2002,20507,FLO,SDN,MIA01,4,12,16
FLO200205080,2002,20508,FLO,SDN,MIA01,4,7,11
FLO200205090,2002,20509,FLO,SDN,MIA01,0,1,1
FLO200205100,2002,20510,FLO,LAN,MIA01,3,4,7
FLO200205110,2002,20511,FLO,LAN,MIA01,3,0,3
FLO200205120,2002,20512,FLO,LAN,MIA01,3,11,14
FLO200205280,2002,20528,FLO,CIN,MIA01,6,5,11
FLO200205290,2002,20529,FLO,CIN,MIA01,8,2,10
FLO200205300,2002,20530,FLO,CIN,MIA01,4,1,5
FLO200205310,2002,20531,FLO,NYN,MIA01,6,5,11
FLO200206010,2002,20601,FLO,NYN,MIA01,7,9,16
FLO200206020,2002,20602,FLO,NYN,MIA01,3,7,10
FLO200206140,2002,20614,FLO,TBA,MIA01,4,3,7
FLO200206150,2002,20615,FLO,TBA,MIA01,0,3,3
FLO200206160,2002,20616,FLO,TBA,MIA01,4,1,5
FLO200206180,2002,20618,FLO,CLE,MIA01,0,4,4
FLO200206190,2002,20619,FLO,CLE,MIA01,1,2,3
FLO200206200,2002,20620,FLO,CLE,MIA01,0,3,3
FLO200206210,2002,20621,FLO,DET,MIA01,1,4,5
FLO200206220,2002,20622,FLO,DET,MIA01,4,5,9
FLO200206230,2002,20623,FLO,DET,MIA01,3,2,5
FLO200206240,2002,20624,FLO,PHI,MIA01,15,4,19
FLO200206250,2002,20625,FLO,PHI,MIA01,7,6,13
FLO200206260,2002,20626,FLO,PHI,MIA01,2,6,8
FLO200206270,2002,20627,FLO,PHI,MIA01,7,3,10
FLO200207010,2002,20701,FLO,CHN,MIA01,1,11,12
FLO200207020,2002,20702,FLO,CHN,MIA01,7,9,16
FLO200207030,2002,20703,FLO,CHN,MIA01,6,2,8
FLO200207040,2002,20704,FLO,NYN,MIA01,7,9,16
FLO200207050,2002,20705,FLO,NYN,MIA01,5,3,8
FLO200207060,2002,20706,FLO,NYN,MIA01,2,5,7
FLO200207070,2002,20707,FLO,NYN,MIA01,9,3,12
FLO200207190,2002,20719,FLO,MON,MIA01,2,4,6
FLO200207200,2002,20720,FLO,MON,MIA01,0,3,3
FLO200207210,2002,20721,FLO,MON,MIA01,0,4,4
FLO200207220,2002,20722,FLO,ATL,MIA01,1,2,3
FLO200207230,2002,20723,FLO,ATL,MIA01,5,3,8
FLO200207240,2002,20724,FLO,ATL,MIA01,10,0,10
FLO200207300,2002,20730,FLO,SLN,MIA01,5,0,5
FLO200207310,2002,20731,FLO,SLN,MIA01,5,8,13
FLO200208010,2002,20801,FLO,SLN,MIA01,0,4,4
FLO200208020,2002,20802,FLO,MIL,MIA01,1,0,1
FLO200208030,2002,20803,FLO,MIL,MIA01,7,11,18
FLO200208040,2002,20804,FLO,MIL,MIA01,2,7,9
FLO200208120,2002,20812,FLO,COL,MIA01,1,0,1
FLO200208130,2002,20813,FLO,COL,MIA01,5,4,9
FLO200208140,2002,20814,FLO,COL,MIA01,0,1,1
FLO200208160,2002,20816,FLO,SFN,MIA01,2,4,6
FLO200208170,2002,20817,FLO,SFN,MIA01,3,7,10
FLO200208180,2002,20818,FLO,SFN,MIA01,0,3,3
FLO200208190,2002,20819,FLO,SFN,MIA01,3,0,3
FLO200208270,2002,20827,FLO,NYN,MIA01,10,5,15
FLO200208280,2002,20828,FLO,NYN,MIA01,3,7,10
FLO200208300,2002,20830,FLO,PIT,MIA01,3,4,7
FLO200208310,2002,20831,FLO,PIT,MIA01,2,3,5
FLO200209010,2002,20901,FLO,PIT,MIA01,4,8,12
FLO200209130,2002,20913,FLO,ATL,MIA01,3,13,16
FLO200209140,2002,20914,FLO,ATL,MIA01,10,5,15
FLO200209150,2002,20915,FLO,ATL,MIA01,6,4,10
FLO200209160,2002,20916,FLO,ATL,MIA01,1,5,6
FLO200209170,2002,20917,FLO,MON,MIA01,8,5,13
FLO200209180,2002,20918,FLO,MON,MIA01,4,2,6
FLO200209190,2002,20919,FLO,MON,MIA01,6,5,11
FLO200209270,2002,20927,FLO,PHI,MIA01,2,5,7
FLO200209280,2002,20928,FLO,PHI,MIA01,9,3,12
FLO200209290,2002,20929,FLO,PHI,MIA01,3,4,7
FLO200303310,2003,30331,FLO,PHI,MIA01,8,5,13
FLO200304020,2003,30402,FLO,PHI,MIA01,8,2,10
FLO200304030,2003,30403,FLO,PHI,MIA01,3,8,11
FLO200304080,2003,30408,FLO,NYN,MIA01,4,2,6
FLO200304090,2003,30409,FLO,NYN,MIA01,2,3,5
FLO200304100,2003,30410,FLO,NYN,MIA01,3,4,7
FLO200304110,2003,30411,FLO,ATL,MIA01,4,7,11
FLO200304120,2003,30412,FLO,ATL,MIA01,5,12,17
FLO200304130,2003,30413,FLO,ATL,MIA01,7,1,8
FLO200304220,2003,30422,FLO,MIL,MIA01,2,4,6
FLO200304230,2003,30423,FLO,MIL,MIA01,4,5,9
FLO200304240,2003,30424,FLO,MIL,MIA01,2,4,6
FLO200304250,2003,30425,FLO,SLN,MIA01,9,2,11
FLO200304260,2003,30426,FLO,SLN,MIA01,3,5,8
FLO200304270,2003,30427,FLO,SLN,MIA01,7,6,13
FLO200305060,2003,30506,FLO,SFN,MIA01,4,2,6
FLO200305070,2003,30507,FLO,SFN,MIA01,3,2,5
FLO200305080,2003,30508,FLO,SFN,MIA01,3,2,5
FLO200305090,2003,30509,FLO,COL,MIA01,4,5,9
FLO200305100,2003,30510,FLO,COL,MIA01,5,4,9
FLO200305110,2003,30511,FLO,COL,MIA01,2,7,9
FLO200305260,2003,30526,FLO,MON,MIA01,1,5,6
FLO200305281,2003,30528,FLO,MON,MIA01,3,4,7
FLO200305282,2003,30528,FLO,MON,MIA01,0,6,6
FLO200305290,2003,30529,FLO,MON,MIA01,3,2,5
FLO200305300,2003,30530,FLO,CIN,MIA01,4,3,7
FLO200305310,2003,30531,FLO,CIN,MIA01,2,3,5
FLO200306010,2003,30601,FLO,CIN,MIA01,9,6,15
FLO200306030,2003,30603,FLO,OAK,MIA01,2,13,15
FLO200306040,2003,30604,FLO,OAK,MIA01,6,5,11
FLO200306050,2003,30605,FLO,OAK,MIA01,0,2,2
FLO200306060,2003,30606,FLO,ANA,MIA01,1,4,5
FLO200306070,2003,30607,FLO,ANA,MIA01,9,2,11
FLO200306080,2003,30608,FLO,ANA,MIA01,8,5,13
FLO200306160,2003,30616,FLO,NYN,MIA01,0,1,1
FLO200306170,2003,30617,FLO,NYN,MIA01,5,0,5
FLO200306180,2003,30618,FLO,NYN,MIA01,10,5,15
FLO200306190,2003,30619,FLO,NYN,MIA01,1,5,6
FLO200306200,2003,30620,FLO,TBA,MIA01,1,3,4
FLO200306210,2003,30621,FLO,TBA,MIA01,0,2,2
FLO200306220,2003,30622,FLO,TBA,MIA01,2,3,5
FLO200306300,2003,30630,FLO,ATL,MIA01,1,8,9
FLO200307010,2003,30701,FLO,ATL,MIA01,1,20,21
FLO200307020,2003,30702,FLO,ATL,MIA01,2,1,3
FLO200307180,2003,30718,FLO,CHN,MIA01,0,6,6
FLO200307190,2003,30719,FLO,CHN,MIA01,1,0,1
FLO200307200,2003,30720,FLO,CHN,MIA01,16,2,18
FLO200307210,2003,30721,FLO,MON,MIA01,1,4,5
FLO200307220,2003,30722,FLO,MON,MIA01,1,9,10
FLO200307250,2003,30725,FLO,PHI,MIA01,5,11,16
FLO200307260,2003,30726,FLO,PHI,MIA01,5,10,15
FLO200307270,2003,30727,FLO,PHI,MIA01,6,7,13
FLO200307280,2003,30728,FLO,ARI,MIA01,2,3,5
FLO200307290,2003,30729,FLO,ARI,MIA01,1,2,3
FLO200307300,2003,30730,FLO,ARI,MIA01,1,3,4
FLO200308010,2003,30801,FLO,HOU,MIA01,2,1,3
FLO200308020,2003,30802,FLO,HOU,MIA01,2,5,7
FLO200308030,2003,30803,FLO,HOU,MIA01,3,1,4
FLO200308110,2003,30811,FLO,LAN,MIA01,9,3,12
FLO200308120,2003,30812,FLO,LAN,MIA01,4,5,9
FLO200308130,2003,30813,FLO,LAN,MIA01,1,2,3
FLO200308140,2003,30814,FLO,LAN,MIA01,6,4,10
FLO200308150,2003,30815,FLO,SDN,MIA01,0,10,10
FLO200308160,2003,30816,FLO,SDN,MIA01,3,6,9
FLO200308170,2003,30817,FLO,SDN,MIA01,7,11,18
FLO200308290,2003,30829,FLO,MON,MIA01,2,3,5
FLO200308300,2003,30830,FLO,MON,MIA01,3,4,7
FLO200308310,2003,30831,FLO,MON,MIA01,3,5,8
FLO200309010,2003,30901,FLO,MON,MIA01,2,5,7
FLO200309020,2003,30902,FLO,PIT,MIA01,3,2,5
FLO200309030,2003,30903,FLO,PIT,MIA01,0,3,3
FLO200309040,2003,30904,FLO,PIT,MIA01,1,5,6
FLO200309120,2003,30912,FLO,ATL,MIA01,4,5,9
FLO200309130,2003,30913,FLO,ATL,MIA01,3,8,11
FLO200309140,2003,30914,FLO,ATL,MIA01,8,4,12
FLO200309230,2003,30923,FLO,PHI,MIA01,4,5,9
FLO200309240,2003,30924,FLO,PHI,MIA01,5,6,11
FLO200309250,2003,30925,FLO,PHI,MIA01,4,8,12
FLO200309260,2003,30926,FLO,NYN,MIA01,3,4,7
FLO200309270,2003,30927,FLO,NYN,MIA01,9,3,12
FLO200309280,2003,30928,FLO,NYN,MIA01,0,4,4
FLO200310030,2003,31003,FLO,SFN,MIA01,3,4,7
FLO200310040,2003,31004,FLO,SFN,MIA01,6,7,13
FLO200310100,2003,31010,FLO,CHN,MIA01,5,4,9
FLO200310110,2003,31011,FLO,CHN,MIA01,8,3,11
FLO200310120,2003,31012,FLO,CHN,MIA01,0,4,4
FLO200310210,2003,31021,FLO,NYA,MIA01,6,1,7
FLO200310220,2003,31022,FLO,NYA,MIA01,3,4,7
FLO200310230,2003,31023,FLO,NYA,MIA01,4,6,10
FLO200404060,2004,40406,FLO,MON,MIA01,3,4,7
FLO200404070,2004,40407,FLO,MON,MIA01,3,2,5
FLO200404080,2004,40408,FLO,MON,MIA01,0,3,3
FLO200404090,2004,40409,FLO,PHI,MIA01,3,4,7
FLO200404100,2004,40410,FLO,PHI,MIA01,3,5,8
FLO200404110,2004,40411,FLO,PHI,MIA01,1,3,4
FLO200404230,2004,40423,FLO,ATL,MIA01,6,1,7
FLO200404240,2004,40424,FLO,ATL,MIA01,4,7,11
FLO200404250,2004,40425,FLO,ATL,MIA01,7,2,9
FLO200405040,2004,40504,FLO,LAN,MIA01,4,3,7
FLO200405050,2004,40505,FLO,LAN,MIA01,0,2,2
FLO200405060,2004,40506,FLO,LAN,MIA01,9,4,13
FLO200405070,2004,40507,FLO,SDN,MIA01,1,3,4
FLO200405080,2004,40508,FLO,SDN,MIA01,6,3,9
FLO200405090,2004,40509,FLO,SDN,MIA01,4,7,11
FLO200405180,2004,40518,FLO,HOU,MIA01,9,2,11
FLO200405190,2004,40519,FLO,HOU,MIA01,10,2,12
FLO200405200,2004,40520,FLO,HOU,MIA01,2,6,8
FLO200405210,2004,40521,FLO,ARI,MIA01,5,6,11
FLO200405220,2004,40522,FLO,ARI,MIA01,2,11,13
FLO200405230,2004,40523,FLO,ARI,MIA01,4,3,7
FLO200405240,2004,40524,FLO,ARI,MIA01,5,13,18
FLO200405280,2004,40528,FLO,NYN,MIA01,1,2,3
FLO200405290,2004,40529,FLO,NYN,MIA01,2,3,5
FLO200405300,2004,40530,FLO,NYN,MIA01,6,8,14
FLO200405310,2004,40531,FLO,CIN,MIA01,9,7,16
FLO200406010,2004,40601,FLO,CIN,MIA01,7,6,13
FLO200406020,2004,40602,FLO,CIN,MIA01,3,1,4
FLO200406150,2004,40615,FLO,CHA,MIA01,7,5,12
FLO200406160,2004,40616,FLO,CHA,MIA01,0,4,4
FLO200406170,2004,40617,FLO,CHA,MIA01,1,2,3
FLO200406180,2004,40618,FLO,TEX,MIA01,8,1,9
FLO200406190,2004,40619,FLO,TEX,MIA01,7,6,13
FLO200406200,2004,40620,FLO,TEX,MIA01,4,2,6
FLO200406220,2004,40622,FLO,ATL,MIA01,3,4,7
FLO200406230,2004,40623,FLO,ATL,MIA01,0,6,6
FLO200406240,2004,40624,FLO,ATL,MIA01,9,4,13
FLO200407020,2004,40702,FLO,TBA,MIA01,4,2,6
FLO200407030,2004,40703,FLO,TBA,MIA01,6,1,7
FLO200407040,2004,40704,FLO,TBA,MIA01,3,4,7
FLO200407050,2004,40705,FLO,PIT,MIA01,3,1,4
FLO200407060,2004,40706,FLO,PIT,MIA01,3,6,9
FLO200407070,2004,40707,FLO,PIT,MIA01,4,3,7
FLO200407090,2004,40709,FLO,NYN,MIA01,6,3,9
FLO200407100,2004,40710,FLO,NYN,MIA01,2,5,7
FLO200407110,2004,40711,FLO,NYN,MIA01,2,5,7
FLO200407260,2004,40726,FLO,PHI,MIA01,3,11,14
FLO200407270,2004,40727,FLO,PHI,MIA01,2,5,7
FLO200407280,2004,40728,FLO,PHI,MIA01,3,6,9
FLO200407290,2004,40729,FLO,PHI,MIA01,1,10,11
FLO200407300,2004,40730,FLO,MON,MIA01,9,0,9
FLO200407310,2004,40731,FLO,MON,MIA01,8,5,13
FLO200408060,2004,40806,FLO,MIL,MIA01,6,7,13
FLO200408070,2004,40807,FLO,MIL,MIA01,0,5,5
FLO200408080,2004,40808,FLO,MIL,MIA01,2,0,2
FLO200408100,2004,40810,FLO,SLN,MIA01,2,1,3
FLO200408110,2004,40811,FLO,SLN,MIA01,1,0,1
FLO200408120,2004,40812,FLO,SLN,MIA01,2,8,10
FLO200408240,2004,40824,FLO,SFN,MIA01,1,9,10
FLO200408250,2004,40825,FLO,SFN,MIA01,6,5,11
FLO200408260,2004,40826,FLO,SFN,MIA01,5,0,5
FLO200408270,2004,40827,FLO,COL,MIA01,0,3,3
FLO200408280,2004,40828,FLO,COL,MIA01,3,4,7
FLO200408290,2004,40829,FLO,COL,MIA01,4,8,12
FLO200409070,2004,40907,FLO,NYN,MIA01,3,7,10
FLO200409080,2004,40908,FLO,NYN,MIA01,0,3,3
FLO200409090,2004,40909,FLO,NYN,MIA01,4,0,4
FLO200409130,2004,40913,FLO,MON,CHI12,3,6,9
FLO200409140,2004,40914,FLO,MON,CHI12,6,8,14
FLO200409151,2004,40915,FLO,MON,MIA01,6,2,8
FLO200409152,2004,40915,FLO,MON,MIA01,10,4,14
FLO200409160,2004,40916,FLO,MON,MIA01,3,4,7
FLO200409170,2004,40917,FLO,ATL,MIA01,8,1,9
FLO200409180,2004,40918,FLO,ATL,MIA01,4,2,6
FLO200409190,2004,40919,FLO,ATL,MIA01,0,3,3
FLO200409201,2004,40920,FLO,CHN,MIA01,5,1,6
FLO200409202,2004,40920,FLO,CHN,MIA01,2,5,7
FLO200409210,2004,40921,FLO,PHI,MIA01,4,2,6
FLO200409220,2004,40922,FLO,PHI,MIA01,12,4,16
FLO200409230,2004,40923,FLO,PHI,MIA01,9,8,17
FLO200504050,2005,50405,FLO,ATL,MIA01,0,9,9
FLO200504060,2005,50406,FLO,ATL,MIA01,2,1,3
FLO200504070,2005,50407,FLO,ATL,MIA01,4,2,6
FLO200504080,2005,50408,FLO,WAS,MIA01,0,9,9
FLO200504090,2005,50409,FLO,WAS,MIA01,3,2,5
FLO200504100,2005,50410,FLO,WAS,MIA01,0,8,8
FLO200504110,2005,50411,FLO,PHI,MIA01,4,1,5
FLO200504120,2005,50412,FLO,PHI,MIA01,2,8,10
FLO200504130,2005,50413,FLO,PHI,MIA01,0,4,4
FLO200504200,2005,50420,FLO,NYN,MIA01,2,9,11
FLO200504210,2005,50421,FLO,NYN,MIA01,10,1,11
FLO200504220,2005,50422,FLO,CIN,MIA01,2,4,6
FLO200504230,2005,50423,FLO,CIN,MIA01,2,4,6
FLO200504240,2005,50424,FLO,CIN,MIA01,2,1,3
FLO200505060,2005,50506,FLO,COL,MIA01,0,7,7
FLO200505070,2005,50507,FLO,COL,MIA01,1,4,5
FLO200505080,2005,50508,FLO,COL,MIA01,8,3,11
FLO200505090,2005,50509,FLO,HOU,MIA01,2,1,3
FLO200505100,2005,50510,FLO,HOU,MIA01,2,6,8
FLO200505110,2005,50511,FLO,HOU,MIA01,1,2,3
FLO200505200,2005,50520,FLO,TBA,MIA01,6,7,13
FLO200505210,2005,50521,FLO,TBA,MIA01,3,4,7
FLO200505220,2005,50522,FLO,TBA,MIA01,5,8,13
FLO200505230,2005,50523,FLO,PHI,MIA01,2,5,7
FLO200505240,2005,50524,FLO,PHI,MIA01,3,4,7
FLO200505250,2005,50525,FLO,PHI,MIA01,8,5,13
FLO200505260,2005,50526,FLO,NYN,MIA01,12,4,16
FLO200505270,2005,50527,FLO,NYN,MIA01,1,0,1
FLO200505280,2005,50528,FLO,NYN,MIA01,6,1,7
FLO200505290,2005,50529,FLO,NYN,MIA01,3,6,9
FLO200506070,2005,50607,FLO,SEA,MIA01,4,3,7
FLO200506080,2005,50608,FLO,SEA,MIA01,4,5,9
FLO200506090,2005,50609,FLO,SEA,MIA01,8,0,8
FLO200506100,2005,50610,FLO,TEX,MIA01,5,12,17
FLO200506110,2005,50611,FLO,TEX,MIA01,5,6,11
FLO200506120,2005,50612,FLO,TEX,MIA01,6,2,8
FLO200506270,2005,50627,FLO,ATL,MIA01,7,2,9
FLO200506280,2005,50628,FLO,ATL,MIA01,9,1,10
FLO200506290,2005,50629,FLO,ATL,MIA01,5,6,11
FLO200506300,2005,50630,FLO,ATL,MIA01,2,6,8
FLO200507040,2005,50704,FLO,MIL,MIA01,3,2,5
FLO200507050,2005,50705,FLO,MIL,MIA01,6,4,10
FLO200507060,2005,50706,FLO,MIL,MIA01,4,5,9
FLO200507070,2005,50707,FLO,MIL,MIA01,3,11,14
FLO200507080,2005,50708,FLO,CHN,MIA01,9,6,15
FLO200507090,2005,50709,FLO,CHN,MIA01,8,2,10
FLO200507100,2005,50710,FLO,CHN,MIA01,9,2,11
FLO200507260,2005,50726,FLO,PIT,MIA01,6,3,9
FLO200507270,2005,50727,FLO,PIT,MIA01,1,3,4
FLO200507280,2005,50728,FLO,PIT,MIA01,0,3,3
FLO200507290,2005,50729,FLO,WAS,MIA01,3,4,7
FLO200507300,2005,50730,FLO,WAS,MIA01,0,3,3
FLO200507310,2005,50731,FLO,WAS,MIA01,4,2,6
FLO200508090,2005,50809,FLO,ARI,MIA01,0,5,5
FLO200508100,2005,50810,FLO,ARI,MIA01,5,10,15
FLO200508110,2005,50811,FLO,ARI,MIA01,3,1,4
FLO200508120,2005,50812,FLO,SFN,MIA01,1,0,1
FLO200508130,2005,50813,FLO,SFN,MIA01,1,2,3
FLO200508140,2005,50814,FLO,SFN,MIA01,1,4,5
FLO200508160,2005,50816,FLO,SDN,MIA01,4,2,6
FLO200508170,2005,50817,FLO,SDN,MIA01,0,6,6
FLO200508180,2005,50818,FLO,SDN,MIA01,0,2,2
FLO200508190,2005,50819,FLO,LAN,MIA01,0,3,3
FLO200508200,2005,50820,FLO,LAN,MIA01,11,6,17
FLO200508210,2005,50821,FLO,LAN,MIA01,1,7,8
FLO200508220,2005,50822,FLO,LAN,MIA01,2,5,7
FLO200508290,2005,50829,FLO,SLN,MIA01,6,1,7
FLO200508300,2005,50830,FLO,SLN,MIA01,6,7,13
FLO200508310,2005,50831,FLO,SLN,MIA01,10,5,15
FLO200509020,2005,50902,FLO,NYN,MIA01,2,4,6
FLO200509030,2005,50903,FLO,NYN,MIA01,4,5,9
FLO200509040,2005,50904,FLO,NYN,MIA01,7,1,8
FLO200509160,2005,50916,FLO,PHI,MIA01,13,3,16
FLO200509170,2005,50917,FLO,PHI,MIA01,10,2,12
FLO200509180,2005,50918,FLO,PHI,MIA01,6,14,20
FLO200509260,2005,50926,FLO,WAS,MIA01,4,0,4
FLO200509270,2005,50927,FLO,WAS,MIA01,11,1,12
FLO200509280,2005,50928,FLO,WAS,MIA01,11,7,18
FLO200509300,2005,50930,FLO,ATL,MIA01,2,5,7
FLO200510010,2005,51001,FLO,ATL,MIA01,4,6,10
FLO200510020,2005,51002,FLO,ATL,MIA01,6,7,13
FLO200604110,2006,60411,FLO,SDN,MIA01,9,3,12
FLO200604120,2006,60412,FLO,SDN,MIA01,7,2,9
FLO200604130,2006,60413,FLO,SDN,MIA01,2,9,11
FLO200604140,2006,60414,FLO,WAS,MIA01,3,5,8
FLO200604150,2006,60415,FLO,WAS,MIA01,2,1,3
FLO200604160,2006,60416,FLO,WAS,MIA01,7,5,12
FLO200604280,2006,60428,FLO,COL,MIA01,3,2,5
FLO200604290,2006,60429,FLO,COL,MIA01,8,7,15
FLO200604300,2006,60430,FLO,COL,MIA01,3,1,4
FLO200605010,2006,60501,FLO,PHI,MIA01,8,5,13
FLO200605020,2006,60502,FLO,PHI,MIA01,7,5,12
FLO200605050,2006,60505,FLO,SLN,MIA01,7,2,9
FLO200605060,2006,60506,FLO,SLN,MIA01,7,6,13
FLO200605070,2006,60507,FLO,SLN,MIA01,9,1,10
FLO200605090,2006,60509,FLO,ATL,MIA01,10,2,12
FLO200605100,2006,60510,FLO,ATL,MIA01,3,11,14
FLO200605110,2006,60511,FLO,ATL,MIA01,9,1,10
FLO200605220,2006,60522,FLO,CHN,MIA01,1,9,10
FLO200605230,2006,60523,FLO,CHN,MIA01,4,5,9
FLO200605240,2006,60524,FLO,CHN,MIA01,3,9,12
FLO200605260,2006,60526,FLO,NYN,MIA01,1,5,6
FLO200605270,2006,60527,FLO,NYN,MIA01,7,4,11
FLO200605280,2006,60528,FLO,NYN,MIA01,7,3,10
FLO200605290,2006,60529,FLO,SFN,MIA01,1,5,6
FLO200605300,2006,60530,FLO,SFN,MIA01,3,5,8
FLO200605310,2006,60531,FLO,SFN,MIA01,6,1,7
FLO200606130,2006,60613,FLO,ATL,MIA01,1,4,5
FLO200606140,2006,60614,FLO,ATL,MIA01,5,6,11
FLO200606150,2006,60615,FLO,ATL,MIA01,2,3,5
FLO200606160,2006,60616,FLO,TOR,MIA01,1,3,4
FLO200606170,2006,60617,FLO,TOR,MIA01,2,8,10
FLO200606180,2006,60618,FLO,TOR,MIA01,1,4,5
FLO200606260,2006,60626,FLO,TBA,MIA01,5,8,13
FLO200606270,2006,60627,FLO,TBA,MIA01,4,8,12
FLO200606280,2006,60628,FLO,TBA,MIA01,3,1,4
FLO200606300,2006,60630,FLO,BOS,MIA01,2,5,7
FLO200607010,2006,60701,FLO,BOS,MIA01,11,5,16
FLO200607020,2006,60702,FLO,BOS,MIA01,4,3,7
FLO200607130,2006,60713,FLO,HOU,MIA01,5,1,6
FLO200607140,2006,60714,FLO,HOU,MIA01,1,3,4
FLO200607150,2006,60715,FLO,HOU,MIA01,12,0,12
FLO200607160,2006,60716,FLO,HOU,MIA01,3,9,12
FLO200607170,2006,60717,FLO,WAS,MIA01,2,4,6
FLO200607180,2006,60718,FLO,WAS,MIA01,7,6,13
FLO200607190,2006,60719,FLO,WAS,MIA01,0,1,1
FLO200607200,2006,60720,FLO,PIT,MIA01,5,3,8
FLO200607210,2006,60721,FLO,PIT,MIA01,1,4,5
FLO200607220,2006,60722,FLO,PIT,MIA01,0,5,5
FLO200607230,2006,60723,FLO,PIT,MIA01,4,5,9
FLO200608010,2006,60801,FLO,NYN,MIA01,5,6,11
FLO200608020,2006,60802,FLO,NYN,MIA01,6,5,11
FLO200608030,2006,60803,FLO,NYN,MIA01,1,4,5
FLO200608040,2006,60804,FLO,LAN,MIA01,6,2,8
FLO200608050,2006,60805,FLO,LAN,MIA01,10,2,12
FLO200608060,2006,60806,FLO,LAN,MIA01,7,3,10
FLO200608180,2006,60818,FLO,ATL,MIA01,6,1,7
FLO200608190,2006,60819,FLO,ATL,MIA01,5,3,8
FLO200608200,2006,60820,FLO,ATL,MIA01,3,4,7
FLO200608210,2006,60821,FLO,WAS,MIA01,1,3,4
FLO200608220,2006,60822,FLO,WAS,MIA01,5,7,12
FLO200608230,2006,60823,FLO,WAS,MIA01,7,9,16
FLO200608250,2006,60825,FLO,MIL,MIA01,5,6,11
FLO200608260,2006,60826,FLO,MIL,MIA01,2,7,9
FLO200608270,2006,60827,FLO,MIL,MIA01,3,4,7
FLO200608280,2006,60828,FLO,MIL,MIA01,2,4,6
FLO200609040,2006,60904,FLO,ARI,MIA01,5,8,13
FLO200609050,2006,60905,FLO,ARI,MIA01,4,0,4
FLO200609060,2006,60906,FLO,ARI,MIA01,0,2,2
FLO200609070,2006,60907,FLO,PHI,MIA01,14,8,22
FLO200609080,2006,60908,FLO,PHI,MIA01,3,2,5
FLO200609090,2006,60909,FLO,PHI,MIA01,3,4,7
FLO200609100,2006,60910,FLO,PHI,MIA01,0,3,3
FLO200609110,2006,60911,FLO,NYN,MIA01,5,16,21
FLO200609120,2006,60912,FLO,NYN,MIA01,6,4,10
FLO200609130,2006,60913,FLO,NYN,MIA01,7,4,11
FLO200609260,2006,60926,FLO,CIN,MIA01,5,3,8
FLO200609270,2006,60927,FLO,CIN,MIA01,2,7,9
FLO200609280,2006,60928,FLO,CIN,MIA01,5,1,6
FLO200609290,2006,60929,FLO,PHI,MIA01,14,2,16
FLO200609300,2006,60930,FLO,PHI,MIA01,4,3,7
FLO200610010,2006,61001,FLO,PHI,MIA01,2,3,5
FLO200704060,2007,70406,FLO,PHI,MIA01,8,2,10
FLO200704070,2007,70407,FLO,PHI,MIA01,5,8,13
FLO200704080,2007,70408,FLO,PHI,MIA01,4,6,10
FLO200704090,2007,70409,FLO,MIL,MIA01,3,5,8
FLO200704100,2007,70410,FLO,MIL,MIA01,3,2,5
FLO200704110,2007,70411,FLO,MIL,MIA01,5,2,7
FLO200704180,2007,70418,FLO,NYN,MIA01,9,2,11
FLO200704190,2007,70419,FLO,NYN,MIA01,11,3,14
FLO200704200,2007,70420,FLO,WAS,MIA01,6,5,11
FLO200704210,2007,70421,FLO,WAS,MIA01,3,9,12
FLO200704220,2007,70422,FLO,WAS,MIA01,6,12,18
FLO200704230,2007,70423,FLO,ATL,MIA01,7,8,15
FLO200704240,2007,70424,FLO,ATL,MIA01,11,6,17
FLO200704250,2007,70425,FLO,ATL,MIA01,3,4,7
FLO200705040,2007,70504,FLO,SDN,MIA01,4,5,9
FLO200705050,2007,70505,FLO,SDN,MIA01,7,6,13
FLO200705060,2007,70506,FLO,SDN,MIA01,3,1,4
FLO200705070,2007,70507,FLO,LAN,MIA01,6,1,7
FLO200705080,2007,70508,FLO,LAN,MIA01,5,6,11
FLO200705090,2007,70509,FLO,LAN,MIA01,5,3,8
FLO200705100,2007,70510,FLO,LAN,MIA01,0,3,3
FLO200705220,2007,70522,FLO,PHI,MIA01,3,5,8
FLO200705230,2007,70523,FLO,PHI,MIA01,8,7,15
FLO200705240,2007,70524,FLO,PHI,MIA01,4,5,9
FLO200705250,2007,70525,FLO,NYN,MIA01,6,2,8
FLO200705260,2007,70526,FLO,NYN,MIA01,7,2,9
FLO200705270,2007,70527,FLO,NYN,MIA01,6,4,10
FLO200706080,2007,70608,FLO,TBA,MIA01,8,14,22
FLO200706090,2007,70609,FLO,TBA,MIA01,7,2,9
FLO200706100,2007,70610,FLO,TBA,MIA01,9,4,13
FLO200706120,2007,70612,FLO,CLE,MIA01,0,3,3
FLO200706130,2007,70613,FLO,CLE,MIA01,7,3,10
FLO200706140,2007,70614,FLO,CLE,MIA01,3,2,5
FLO200706220,2007,70622,FLO,MIN,MIA01,4,5,9
FLO200706230,2007,70623,FLO,MIN,MIA01,11,1,12
FLO200706240,2007,70624,FLO,MIN,MIA01,7,4,11
FLO200706260,2007,70626,FLO,PIT,MIA01,3,2,5
FLO200706270,2007,70627,FLO,PIT,MIA01,7,5,12
FLO200706280,2007,70628,FLO,PIT,MIA01,7,9,16
FLO200706290,2007,70629,FLO,ATL,MIA01,12,3,15
FLO200706300,2007,70630,FLO,ATL,MIA01,6,5,11
FLO200707010,2007,70701,FLO,ATL,MIA01,5,6,11
FLO200707130,2007,70713,FLO,WAS,MIA01,14,10,24
FLO200707140,2007,70714,FLO,WAS,MIA01,2,5,7
FLO200707150,2007,70715,FLO,WAS,MIA01,3,5,8
FLO200707160,2007,70716,FLO,SLN,MIA01,5,3,8
FLO200707170,2007,70717,FLO,SLN,MIA01,0,4,4
FLO200707180,2007,70718,FLO,SLN,MIA01,6,0,6
FLO200707190,2007,70719,FLO,CIN,MIA01,7,5,12
FLO200707200,2007,70720,FLO,CIN,MIA01,2,10,12
FLO200707210,2007,70721,FLO,CIN,MIA01,1,11,12
FLO200707220,2007,70722,FLO,CIN,MIA01,3,9,12
FLO200707310,2007,70731,FLO,COL,MIA01,6,3,9
FLO200708010,2007,70801,FLO,COL,MIA01,3,4,7
FLO200708020,2007,70802,FLO,COL,MIA01,4,3,7
FLO200708030,2007,70803,FLO,HOU,MIA01,8,2,10
FLO200708040,2007,70804,FLO,HOU,MIA01,5,6,11
FLO200708050,2007,70805,FLO,HOU,MIA01,5,6,11
FLO200708140,2007,70814,FLO,ARI,MIA01,5,14,19
FLO200708150,2007,70815,FLO,ARI,MIA01,9,6,15
FLO200708160,2007,70816,FLO,ARI,MIA01,5,4,9
FLO200708170,2007,70817,FLO,SFN,MIA01,3,0,3
FLO200708180,2007,70818,FLO,SFN,MIA01,4,3,7
FLO200708190,2007,70819,FLO,SFN,MIA01,6,5,11
FLO200708200,2007,70820,FLO,SFN,MIA01,8,7,15
FLO200708270,2007,70827,FLO,ATL,MIA01,13,2,15
FLO200708280,2007,70828,FLO,ATL,MIA01,3,4,7
FLO200708290,2007,70829,FLO,ATL,MIA01,7,4,11
FLO200708310,2007,70831,FLO,PHI,MIA01,9,2,11
FLO200709010,2007,70901,FLO,PHI,MIA01,6,12,18
FLO200709020,2007,70902,FLO,PHI,MIA01,6,7,13
FLO200709100,2007,70910,FLO,WAS,MIA01,5,4,9
FLO200709110,2007,70911,FLO,WAS,MIA01,8,13,21
FLO200709120,2007,70912,FLO,WAS,MIA01,4,5,9
FLO200709200,2007,70920,FLO,NYN,MIA01,7,8,15
FLO200709210,2007,70921,FLO,NYN,MIA01,9,6,15
FLO200709220,2007,70922,FLO,NYN,MIA01,7,2,9
FLO200709230,2007,70923,FLO,NYN,MIA01,7,6,13
FLO200709250,2007,70925,FLO,CHN,MIA01,2,4,6
FLO200709260,2007,70926,FLO,CHN,MIA01,4,7,11
FLO200709270,2007,70927,FLO,CHN,MIA01,4,6,10
FLO200803310,2008,80331,FLO,NYN,MIA01,7,2,9
FLO200804010,2008,80401,FLO,NYN,MIA01,4,5,9
FLO200804020,2008,80402,FLO,NYN,MIA01,13,0,13
FLO200804040,2008,80404,FLO,PIT,MIA01,4,5,9
FLO200804050,2008,80405,FLO,PIT,MIA01,3,7,10
FLO200804060,2008,80406,FLO,PIT,MIA01,9,2,11
FLO200804150,2008,80415,FLO,ATL,MIA01,0,4,4
FLO200804160,2008,80416,FLO,ATL,MIA01,5,6,11
FLO200804170,2008,80417,FLO,ATL,MIA01,8,0,8
FLO200804180,2008,80418,FLO,WAS,MIA01,6,4,10
FLO200804190,2008,80419,FLO,WAS,MIA01,5,6,11
FLO200804200,2008,80420,FLO,WAS,MIA01,1,6,7
FLO200804290,2008,80429,FLO,LAN,MIA01,7,6,13
FLO200804300,2008,80430,FLO,LAN,MIA01,13,1,14
FLO200805010,2008,80501,FLO,LAN,MIA01,5,3,8
FLO200805020,2008,80502,FLO,SDN,MIA01,4,6,10
FLO200805030,2008,80503,FLO,SDN,MIA01,7,2,9
FLO200805040,2008,80504,FLO,SDN,MIA01,3,10,13
FLO200805060,2008,80506,FLO,MIL,MIA01,0,3,3
FLO200805070,2008,80507,FLO,MIL,MIA01,2,6,8
FLO200805080,2008,80508,FLO,MIL,MIA01,2,7,9
FLO200805160,2008,80516,FLO,KCA,MIA01,7,6,13
FLO200805170,2008,80517,FLO,KCA,MIA01,3,7,10
FLO200805180,2008,80518,FLO,KCA,MIA01,9,3,12
FLO200805200,2008,80520,FLO,ARI,MIA01,2,3,5
FLO200805210,2008,80521,FLO,ARI,MIA01,1,3,4
FLO200805220,2008,80522,FLO,ARI,MIA01,0,4,4
FLO200805230,2008,80523,FLO,SFN,MIA01,8,2,10
FLO200805251,2008,80525,FLO,SFN,MIA01,6,8,14
FLO200805252,2008,80525,FLO,SFN,MIA01,4,5,9
FLO200806060,2008,80606,FLO,CIN,MIA01,11,3,14
FLO200806070,2008,80607,FLO,CIN,MIA01,7,8,15
FLO200806080,2008,80608,FLO,CIN,MIA01,2,9,11
FLO200806090,2008,80609,FLO,CIN,MIA01,9,4,13
FLO200806100,2008,80610,FLO,PHI,MIA01,4,5,9
FLO200806110,2008,80611,FLO,PHI,MIA01,2,6,8
FLO200806120,2008,80612,FLO,PHI,MIA01,3,0,3
FLO200806240,2008,80624,FLO,TBA,MIA01,6,4,10
FLO200806250,2008,80625,FLO,TBA,MIA01,15,3,18
FLO200806260,2008,80626,FLO,TBA,MIA01,6,1,7
FLO200806270,2008,80627,FLO,ARI,MIA01,1,3,4
FLO200806280,2008,80628,FLO,ARI,MIA01,6,2,8
FLO200806290,2008,80629,FLO,ARI,MIA01,3,4,7
FLO200806300,2008,80630,FLO,WAS,MIA01,5,6,11
FLO200807010,2008,80701,FLO,WAS,MIA01,9,6,15
FLO200807020,2008,80702,FLO,WAS,MIA01,2,4,6
FLO200807180,2008,80718,FLO,PHI,MIA01,4,2,6
FLO200807190,2008,80719,FLO,PHI,MIA01,5,9,14
FLO200807200,2008,80720,FLO,PHI,MIA01,2,3,5
FLO200807210,2008,80721,FLO,ATL,MIA01,4,0,4
FLO200807220,2008,80722,FLO,ATL,MIA01,0,4,4
FLO200807230,2008,80723,FLO,ATL,MIA01,9,4,13
FLO200807280,2008,80728,FLO,NYN,MIA01,3,7,10
FLO200807290,2008,80729,FLO,NYN,MIA01,4,1,5
FLO200807300,2008,80730,FLO,NYN,MIA01,5,7,12
FLO200807310,2008,80731,FLO,COL,MIA01,2,12,14
FLO200808010,2008,80801,FLO,COL,MIA01,5,2,7
FLO200808020,2008,80802,FLO,COL,MIA01,3,5,8
FLO200808030,2008,80803,FLO,COL,MIA01,3,2,5
FLO200808110,2008,80811,FLO,SLN,MIA01,4,2,6
FLO200808120,2008,80812,FLO,SLN,MIA01,3,4,7
FLO200808130,2008,80813,FLO,SLN,MIA01,6,4,10
FLO200808140,2008,80814,FLO,SLN,MIA01,3,0,3
FLO200808150,2008,80815,FLO,CHN,MIA01,6,5,11
FLO200808160,2008,80816,FLO,CHN,MIA01,1,2,3
FLO200808170,2008,80817,FLO,CHN,MIA01,9,2,11
FLO200808290,2008,80829,FLO,NYN,MIA01,5,4,9
FLO200808300,2008,80830,FLO,NYN,MIA01,3,4,7
FLO200808310,2008,80831,FLO,NYN,MIA01,6,2,8
FLO200809010,2008,80901,FLO,ATL,MIA01,3,4,7
FLO200809020,2008,80902,FLO,ATL,MIA01,16,14,30
FLO200809030,2008,80903,FLO,ATL,MIA01,3,5,8
FLO200809120,2008,80912,FLO,WAS,MIA01,1,2,3
FLO200809130,2008,80913,FLO,WAS,MIA01,2,4,6
FLO200809140,2008,80914,FLO,WAS,MIA01,7,8,15
FLO200809160,2008,80916,FLO,HOU,MIA01,1,5,6
FLO200809170,2008,80917,FLO,HOU,MIA01,2,14,16
FLO200809180,2008,80918,FLO,HOU,MIA01,1,8,9
FLO200809190,2008,80919,FLO,PHI,MIA01,8,14,22
FLO200809200,2008,80920,FLO,PHI,MIA01,3,2,5
FLO200809210,2008,80921,FLO,PHI,MIA01,5,2,7
FLO200904060,2009,90406,FLO,WAS,MIA01,6,12,18
FLO200904070,2009,90407,FLO,WAS,MIA01,3,8,11
FLO200904080,2009,90408,FLO,WAS,MIA01,4,6,10
FLO200904100,2009,90410,FLO,NYN,MIA01,4,5,9
FLO200904110,2009,90411,FLO,NYN,MIA01,8,4,12
FLO200904120,2009,90412,FLO,NYN,MIA01,1,2,3
FLO200904240,2009,90424,FLO,PHI,MIA01,7,3,10
FLO200904250,2009,90425,FLO,PHI,MIA01,6,4,10
FLO200904260,2009,90426,FLO,PHI,MIA01,13,2,15
FLO200905040,2009,90504,FLO,CIN,MIA01,2,3,5
FLO200905050,2009,90505,FLO,CIN,MIA01,7,0,7
FLO200905060,2009,90506,FLO,ATL,MIA01,8,6,14
FLO200905070,2009,90507,FLO,ATL,MIA01,4,2,6
FLO200905150,2009,90515,FLO,LAN,MIA01,6,4,10
FLO200905160,2009,90516,FLO,LAN,MIA01,3,6,9
FLO200905170,2009,90517,FLO,LAN,MIA01,12,5,17
FLO200905190,2009,90519,FLO,ARI,MIA01,5,3,8
FLO200905201,2009,90520,FLO,ARI,MIA01,6,8,14
FLO200905202,2009,90520,FLO,ARI,MIA01,11,9,20
FLO200905210,2009,90521,FLO,ARI,MIA01,4,3,7
FLO200905220,2009,90522,FLO,TBA,MIA01,15,2,17
FLO200905230,2009,90523,FLO,TBA,MIA01,10,3,13
FLO200905240,2009,90524,FLO,TBA,MIA01,4,5,9
FLO200906010,2009,90601,FLO,MIL,MIA01,4,7,11
FLO200906020,2009,90602,FLO,MIL,MIA01,3,10,13
FLO200906030,2009,90603,FLO,MIL,MIA01,9,6,15
FLO200906040,2009,90604,FLO,MIL,MIA01,3,4,7
FLO200906050,2009,90605,FLO,SFN,MIA01,2,1,3
FLO200906060,2009,90606,FLO,SFN,MIA01,4,5,9
FLO200906070,2009,90607,FLO,SFN,MIA01,3,2,5
FLO200906080,2009,90608,FLO,SFN,MIA01,0,4,4
FLO200906090,2009,90609,FLO,SLN,MIA01,3,4,7
FLO200906100,2009,90610,FLO,SLN,MIA01,13,4,17
FLO200906110,2009,90611,FLO,SLN,MIA01,6,5,11
FLO200906190,2009,90619,FLO,NYA,MIA01,5,1,6
FLO200906200,2009,90620,FLO,NYA,MIA01,1,2,3
FLO200906210,2009,90621,FLO,NYA,MIA01,5,6,11
FLO200906230,2009,90623,FLO,BAL,MIA01,6,7,13
FLO200906240,2009,90624,FLO,BAL,MIA01,2,5,7
FLO200906250,2009,90625,FLO,BAL,MIA01,3,11,14
FLO200906290,2009,90629,FLO,WAS,MIA01,2,4,6
FLO200906300,2009,90630,FLO,WAS,MIA01,5,7,12
FLO200907010,2009,90701,FLO,WAS,MIA01,3,5,8
FLO200907030,2009,90703,FLO,PIT,MIA01,7,4,11
FLO200907040,2009,90704,FLO,PIT,MIA01,3,5,8
FLO200907050,2009,90705,FLO,PIT,MIA01,0,5,5
FLO200907160,2009,90716,FLO,PHI,MIA01,4,0,4
FLO200907170,2009,90717,FLO,PHI,MIA01,6,5,11
FLO200907190,2009,90719,FLO,PHI,MIA01,5,0,5
FLO200907280,2009,90728,FLO,ATL,MIA01,3,4,7
FLO200907290,2009,90729,FLO,ATL,MIA01,3,6,9
FLO200907300,2009,90730,FLO,ATL,MIA01,6,3,9
FLO200907310,2009,90731,FLO,CHN,MIA01,2,5,7
FLO200908010,2009,90801,FLO,CHN,MIA01,9,8,17
FLO200908020,2009,90802,FLO,CHN,MIA01,2,3,5
FLO200908100,2009,90810,FLO,HOU,MIA01,6,8,14
FLO200908110,2009,90811,FLO,HOU,MIA01,8,9,17
FLO200908120,2009,90812,FLO,HOU,MIA01,14,6,20
FLO200908130,2009,90813,FLO,HOU,MIA01,2,9,11
FLO200908140,2009,90814,FLO,COL,MIA01,5,6,11
FLO200908161,2009,90816,FLO,COL,MIA01,3,10,13
FLO200908162,2009,90816,FLO,COL,MIA01,7,3,10
FLO200908250,2009,90825,FLO,NYN,MIA01,1,2,3
FLO200908260,2009,90826,FLO,NYN,MIA01,3,5,8
FLO200908270,2009,90827,FLO,NYN,MIA01,10,3,13
FLO200908280,2009,90828,FLO,SDN,MIA01,9,5,14
FLO200908290,2009,90829,FLO,SDN,MIA01,7,4,11
FLO200908300,2009,90830,FLO,SDN,MIA01,4,6,10
FLO200908310,2009,90831,FLO,ATL,MIA01,5,2,7
FLO200909010,2009,90901,FLO,ATL,MIA01,4,3,7
FLO200909020,2009,90902,FLO,ATL,MIA01,7,8,15
FLO200909030,2009,90903,FLO,ATL,MIA01,3,8,11
FLO200909110,2009,90911,FLO,WAS,MIA01,5,3,8
FLO200909120,2009,90912,FLO,WAS,MIA01,3,11,14
FLO200909130,2009,90913,FLO,WAS,MIA01,7,2,9
FLO200909221,2009,90922,FLO,PHI,MIA01,9,3,12
FLO200909222,2009,90922,FLO,PHI,MIA01,0,3,3
FLO200909230,2009,90923,FLO,PHI,MIA01,6,7,13
FLO200909250,2009,90925,FLO,NYN,MIA01,6,5,11
FLO200909260,2009,90926,FLO,NYN,MIA01,6,9,15
FLO200909270,2009,90927,FLO,NYN,MIA01,4,0,4
HOU200004070,2000,407,HOU,PHI,HOU03,4,1,5
HOU200004080,2000,408,HOU,PHI,HOU03,5,8,13
HOU200004090,2000,409,HOU,PHI,HOU03,3,2,5
HOU200004100,2000,410,HOU,SLN,HOU03,8,7,15
HOU200004110,2000,411,HOU,SLN,HOU03,10,6,16
HOU200004120,2000,412,HOU,SLN,HOU03,5,7,12
HOU200004210,2000,421,HOU,SDN,HOU03,7,2,9
HOU200004220,2000,422,HOU,SDN,HOU03,8,6,14
HOU200004230,2000,423,HOU,SDN,HOU03,11,10,21
HOU200004250,2000,425,HOU,CHN,HOU03,7,11,18
HOU200004260,2000,426,HOU,CHN,HOU03,13,8,21
HOU200004270,2000,427,HOU,CHN,HOU03,12,3,15
HOU200005080,2000,508,HOU,COL,HOU03,3,1,4
HOU200005090,2000,509,HOU,COL,HOU03,8,13,21
HOU200005100,2000,510,HOU,COL,HOU03,1,5,6
HOU200005120,2000,512,HOU,CIN,HOU03,7,3,10
HOU200005130,2000,513,HOU,CIN,HOU03,8,7,15
HOU200005140,2000,514,HOU,CIN,HOU03,3,10,13
HOU200005150,2000,515,HOU,CIN,HOU03,4,3,7
HOU200005230,2000,523,HOU,PHI,HOU03,2,10,12
HOU200005240,2000,524,HOU,PHI,HOU03,9,7,16
HOU200005250,2000,525,HOU,PHI,HOU03,6,10,16
HOU200005260,2000,526,HOU,ATL,HOU03,4,5,9
HOU200005270,2000,527,HOU,ATL,HOU03,6,5,11
HOU200005280,2000,528,HOU,ATL,HOU03,3,4,7
HOU200006020,2000,602,HOU,CHA,HOU03,7,4,11
HOU200006030,2000,603,HOU,CHA,HOU03,1,6,7
HOU200006040,2000,604,HOU,CHA,HOU03,7,3,10
HOU200006050,2000,605,HOU,MIN,HOU03,2,8,10
HOU200006060,2000,606,HOU,MIN,HOU03,3,1,4
HOU200006070,2000,607,HOU,MIN,HOU03,2,0,2
HOU200006200,2000,620,HOU,LAN,HOU03,9,6,15
HOU200006210,2000,621,HOU,LAN,HOU03,7,6,13
HOU200006220,2000,622,HOU,LAN,HOU03,3,6,9
HOU200006230,2000,623,HOU,SFN,HOU03,10,3,13
HOU200006240,2000,624,HOU,SFN,HOU03,13,4,17
HOU200006250,2000,625,HOU,SFN,HOU03,4,2,6
HOU200007040,2000,704,HOU,ARI,HOU03,10,4,14
HOU200007050,2000,705,HOU,ARI,HOU03,12,9,21
HOU200007060,2000,706,HOU,ARI,HOU03,2,1,3
HOU200007070,2000,707,HOU,KCA,HOU03,5,9,14
HOU200007080,2000,708,HOU,KCA,HOU03,5,2,7
HOU200007090,2000,709,HOU,KCA,HOU03,6,9,15
HOU200007190,2000,719,HOU,CIN,HOU03,4,0,4
HOU200007200,2000,720,HOU,CIN,HOU03,2,6,8
HOU200007210,2000,721,HOU,SLN,HOU03,12,1,13
HOU200007220,2000,722,HOU,SLN,HOU03,5,10,15
HOU200007230,2000,723,HOU,SLN,HOU03,7,15,22
HOU200008040,2000,804,HOU,MON,HOU03,6,7,13
HOU200008050,2000,805,HOU,MON,HOU03,10,9,19
HOU200008060,2000,806,HOU,MON,HOU03,1,8,9
HOU200008070,2000,807,HOU,NYN,HOU03,6,5,11
HOU200008080,2000,808,HOU,NYN,HOU03,3,9,12
HOU200008090,2000,809,HOU,NYN,HOU03,12,5,17
HOU200008100,2000,810,HOU,NYN,HOU03,10,3,13
HOU200008140,2000,814,HOU,PIT,HOU03,2,16,18
HOU200008150,2000,815,HOU,PIT,HOU03,4,5,9
HOU200008160,2000,816,HOU,PIT,HOU03,10,11,21
HOU200008180,2000,818,HOU,MIL,HOU03,4,5,9
HOU200008190,2000,819,HOU,MIL,HOU03,8,10,18
HOU200008200,2000,820,HOU,MIL,HOU03,6,5,11
HOU200008210,2000,821,HOU,CHN,HOU03,4,5,9
HOU200008220,2000,822,HOU,CHN,HOU03,7,10,17
HOU200008230,2000,823,HOU,CHN,HOU03,15,5,20
HOU200009010,2000,901,HOU,ATL,HOU03,2,3,5
HOU200009020,2000,902,HOU,ATL,HOU03,8,6,14
HOU200009030,2000,903,HOU,ATL,HOU03,3,9,12
HOU200009040,2000,904,HOU,FLO,HOU03,5,2,7
HOU200009050,2000,905,HOU,FLO,HOU03,5,9,14
HOU200009060,2000,906,HOU,FLO,HOU03,5,13,18
HOU200009070,2000,907,HOU,FLO,HOU03,3,7,10
HOU200009110,2000,911,HOU,SFN,HOU03,8,7,15
HOU200009120,2000,912,HOU,SFN,HOU03,9,5,14
HOU200009130,2000,913,HOU,SFN,HOU03,3,2,5
HOU200009140,2000,914,HOU,PIT,HOU03,7,8,15
HOU200009150,2000,915,HOU,PIT,HOU03,7,16,23
HOU200009160,2000,916,HOU,PIT,HOU03,9,10,19
HOU200009170,2000,917,HOU,PIT,HOU03,3,5,8
HOU200009290,2000,929,HOU,MIL,HOU03,13,3,16
HOU200009300,2000,930,HOU,MIL,HOU03,6,7,13
HOU200010010,2000,1001,HOU,MIL,HOU03,1,6,7
HOU200104030,2001,10403,HOU,MIL,HOU03,3,11,14
HOU200104040,2001,10404,HOU,MIL,HOU03,6,8,14
HOU200104050,2001,10405,HOU,MIL,HOU03,2,8,10
HOU200104060,2001,10406,HOU,PIT,HOU03,1,4,5
HOU200104070,2001,10407,HOU,PIT,HOU03,5,3,8
HOU200104080,2001,10408,HOU,PIT,HOU03,9,3,12
HOU200104200,2001,10420,HOU,SLN,HOU03,1,10,11
HOU200104210,2001,10421,HOU,SLN,HOU03,9,2,11
HOU200104220,2001,10422,HOU,SLN,HOU03,3,4,7
HOU200104230,2001,10423,HOU,ATL,HOU03,9,7,16
HOU200104240,2001,10424,HOU,ATL,HOU03,6,11,17
HOU200104250,2001,10425,HOU,ATL,HOU03,11,3,14
HOU200104270,2001,10427,HOU,FLO,HOU03,9,8,17
HOU200104280,2001,10428,HOU,FLO,HOU03,4,6,10
HOU200104290,2001,10429,HOU,FLO,HOU03,11,5,16
HOU200105070,2001,10507,HOU,PHI,HOU03,5,0,5
HOU200105080,2001,10508,HOU,PHI,HOU03,3,2,5
HOU200105090,2001,10509,HOU,PHI,HOU03,6,7,13
HOU200105180,2001,10518,HOU,CIN,HOU03,7,4,11
HOU200105190,2001,10519,HOU,CIN,HOU03,3,6,9
HOU200105200,2001,10520,HOU,CIN,HOU03,6,5,11
HOU200105210,2001,10521,HOU,SDN,HOU03,7,6,13
HOU200105220,2001,10522,HOU,SDN,HOU03,6,2,8
HOU200105230,2001,10523,HOU,SDN,HOU03,7,6,13
HOU200106010,2001,10601,HOU,LAN,HOU03,9,10,19
HOU200106020,2001,10602,HOU,LAN,HOU03,1,2,3
HOU200106030,2001,10603,HOU,LAN,HOU03,9,8,17
HOU200106150,2001,10615,HOU,TEX,HOU03,12,9,21
HOU200106160,2001,10616,HOU,TEX,HOU03,1,2,3
HOU200106170,2001,10617,HOU,TEX,HOU03,6,2,8
HOU200106180,2001,10618,HOU,COL,HOU03,5,13,18
HOU200106190,2001,10619,HOU,COL,HOU03,4,6,10
HOU200106200,2001,10620,HOU,COL,HOU03,2,7,9
HOU200106210,2001,10621,HOU,CIN,HOU03,8,7,15
HOU200106220,2001,10622,HOU,CIN,HOU03,7,5,12
HOU200106230,2001,10623,HOU,CIN,HOU03,3,9,12
HOU200106240,2001,10624,HOU,CIN,HOU03,5,7,12
HOU200107030,2001,10703,HOU,ARI,HOU03,5,6,11
HOU200107040,2001,10704,HOU,ARI,HOU03,3,2,5
HOU200107050,2001,10705,HOU,ARI,HOU03,1,5,6
HOU200107120,2001,10712,HOU,SDN,HOU03,7,4,11
HOU200107130,2001,10713,HOU,SDN,HOU03,3,11,14
HOU200107140,2001,10714,HOU,SDN,HOU03,8,6,14
HOU200107150,2001,10715,HOU,CLE,HOU03,3,5,8
HOU200107160,2001,10716,HOU,CLE,HOU03,8,10,18
HOU200107170,2001,10717,HOU,CLE,HOU03,10,4,14
HOU200107180,2001,10718,HOU,SLN,HOU03,11,17,28
HOU200107190,2001,10719,HOU,SLN,HOU03,4,1,5
HOU200107200,2001,10720,HOU,CHN,HOU03,2,5,7
HOU200107210,2001,10721,HOU,CHN,HOU03,5,4,9
HOU200107220,2001,10722,HOU,CHN,HOU03,0,3,3
HOU200107230,2001,10723,HOU,CHN,HOU03,6,2,8
HOU200107310,2001,10731,HOU,NYN,HOU03,2,3,5
HOU200108010,2001,10801,HOU,NYN,HOU03,8,2,10
HOU200108020,2001,10802,HOU,NYN,HOU03,3,4,7
HOU200108030,2001,10803,HOU,MON,HOU03,2,6,8
HOU200108040,2001,10804,HOU,MON,HOU03,1,4,5
HOU200108050,2001,10805,HOU,MON,HOU03,1,4,5
HOU200108130,2001,10813,HOU,CHN,HOU03,5,9,14
HOU200108140,2001,10814,HOU,CHN,HOU03,3,1,4
HOU200108150,2001,10815,HOU,CHN,HOU03,5,1,6
HOU200108160,2001,10816,HOU,PIT,HOU03,3,4,7
HOU200108170,2001,10817,HOU,PIT,HOU03,5,6,11
HOU200108180,2001,10818,HOU,PIT,HOU03,0,3,3
HOU200108190,2001,10819,HOU,PIT,HOU03,2,12,14
HOU200108280,2001,10828,HOU,CIN,HOU03,4,6,10
HOU200108290,2001,10829,HOU,CIN,HOU03,2,6,8
HOU200108300,2001,10830,HOU,CIN,HOU03,1,6,7
HOU200109060,2001,10906,HOU,MIL,HOU03,4,3,7
HOU200109070,2001,10907,HOU,MIL,HOU03,3,5,8
HOU200109080,2001,10908,HOU,MIL,HOU03,7,2,9
HOU200109090,2001,10909,HOU,MIL,HOU03,0,8,8
HOU200109210,2001,10921,HOU,CHN,HOU03,12,4,16
HOU200109220,2001,10922,HOU,CHN,HOU03,4,8,12
HOU200109230,2001,10923,HOU,CHN,HOU03,6,7,13
HOU200109240,2001,10924,HOU,SLN,HOU03,3,9,12
HOU200109250,2001,10925,HOU,SLN,HOU03,3,2,5
HOU200109260,2001,10926,HOU,SLN,HOU03,5,1,6
HOU200110020,2001,11002,HOU,SFN,HOU03,4,1,5
HOU200110030,2001,11003,HOU,SFN,HOU03,11,8,19
HOU200110040,2001,11004,HOU,SFN,HOU03,10,2,12
HOU200110090,2001,11009,HOU,ATL,HOU03,7,4,11
HOU200110100,2001,11010,HOU,ATL,HOU03,1,0,1
HOU200204020,2002,20402,HOU,MIL,HOU03,9,3,12
HOU200204030,2002,20403,HOU,MIL,HOU03,2,15,17
HOU200204040,2002,20404,HOU,MIL,HOU03,3,6,9
HOU200204050,2002,20405,HOU,SLN,HOU03,5,1,6
HOU200204060,2002,20406,HOU,SLN,HOU03,8,4,12
HOU200204070,2002,20407,HOU,SLN,HOU03,6,7,13
HOU200204190,2002,20419,HOU,SFN,HOU03,3,2,5
HOU200204200,2002,20420,HOU,SFN,HOU03,13,9,22
HOU200204210,2002,20421,HOU,SFN,HOU03,0,4,4
HOU200204300,2002,20430,HOU,MON,HOU03,5,1,6
HOU200205010,2002,20501,HOU,MON,HOU03,5,4,9
HOU200205020,2002,20502,HOU,MON,HOU03,2,8,10
HOU200205030,2002,20503,HOU,NYN,HOU03,11,3,14
HOU200205040,2002,20504,HOU,NYN,HOU03,1,3,4
HOU200205050,2002,20505,HOU,NYN,HOU03,1,12,13
HOU200205130,2002,20513,HOU,PHI,HOU03,3,17,20
HOU200205140,2002,20514,HOU,PHI,HOU03,1,5,6
HOU200205150,2002,20515,HOU,PHI,HOU03,2,6,8
HOU200205160,2002,20516,HOU,PIT,HOU03,1,3,4
HOU200205170,2002,20517,HOU,PIT,HOU03,4,7,11
HOU200205180,2002,20518,HOU,PIT,HOU03,1,2,3
HOU200205190,2002,20519,HOU,PIT,HOU03,5,3,8
HOU200205240,2002,20524,HOU,CHN,HOU03,5,4,9
HOU200205250,2002,20525,HOU,CHN,HOU03,5,1,6
HOU200205260,2002,20526,HOU,CHN,HOU03,5,7,12
HOU200205270,2002,20527,HOU,SLN,HOU03,4,3,7
HOU200205280,2002,20528,HOU,SLN,HOU03,4,1,5
HOU200205290,2002,20529,HOU,SLN,HOU03,5,10,15
HOU200206100,2002,20610,HOU,CHN,HOU03,2,4,6
HOU200206110,2002,20611,HOU,CHN,HOU03,9,5,14
HOU200206120,2002,20612,HOU,CHN,HOU03,4,5,9
HOU200206140,2002,20614,HOU,TEX,HOU03,9,6,15
HOU200206150,2002,20615,HOU,TEX,HOU03,0,4,4
HOU200206160,2002,20616,HOU,TEX,HOU03,6,7,13
HOU200206210,2002,20621,HOU,SEA,HOU03,8,0,8
HOU200206220,2002,20622,HOU,SEA,HOU03,2,3,5
HOU200206230,2002,20623,HOU,SEA,HOU03,10,5,15
HOU200206250,2002,20625,HOU,ARI,HOU03,3,7,10
HOU200206260,2002,20626,HOU,ARI,HOU03,9,1,10
HOU200206270,2002,20627,HOU,ARI,HOU03,4,7,11
HOU200207110,2002,20711,HOU,CIN,HOU03,3,4,7
HOU200207120,2002,20712,HOU,CIN,HOU03,3,6,9
HOU200207130,2002,20713,HOU,CIN,HOU03,1,2,3
HOU200207140,2002,20714,HOU,CIN,HOU03,8,3,11
HOU200207150,2002,20715,HOU,PIT,HOU03,5,4,9
HOU200207160,2002,20716,HOU,PIT,HOU03,7,3,10
HOU200207220,2002,20722,HOU,MIL,HOU03,1,3,4
HOU200207230,2002,20723,HOU,MIL,HOU03,4,7,11
HOU200207240,2002,20724,HOU,MIL,HOU03,12,8,20
HOU200207250,2002,20725,HOU,PIT,HOU03,0,8,8
HOU200207260,2002,20726,HOU,PIT,HOU03,3,4,7
HOU200207270,2002,20727,HOU,PIT,HOU03,0,3,3
HOU200207280,2002,20728,HOU,PIT,HOU03,0,4,4
HOU200208060,2002,20806,HOU,FLO,HOU03,0,2,2
HOU200208070,2002,20807,HOU,FLO,HOU03,2,7,9
HOU200208080,2002,20808,HOU,FLO,HOU03,4,3,7
HOU200208090,2002,20809,HOU,ATL,HOU03,6,5,11
HOU200208100,2002,20810,HOU,ATL,HOU03,5,8,13
HOU200208110,2002,20811,HOU,ATL,HOU03,13,3,16
HOU200208200,2002,20820,HOU,CHN,HOU03,14,12,26
HOU200208210,2002,20821,HOU,CHN,HOU03,0,4,4
HOU200208220,2002,20822,HOU,CHN,HOU03,1,9,10
HOU200208230,2002,20823,HOU,CIN,HOU03,4,6,10
HOU200208240,2002,20824,HOU,CIN,HOU03,5,3,8
HOU200208250,2002,20825,HOU,CIN,HOU03,0,1,1
HOU200208270,2002,20827,HOU,SDN,HOU03,11,6,17
HOU200208280,2002,20828,HOU,SDN,HOU03,1,2,3
HOU200208290,2002,20829,HOU,SDN,HOU03,0,5,5
HOU200208300,2002,20830,HOU,LAN,HOU03,4,8,12
HOU200208310,2002,20831,HOU,LAN,HOU03,4,0,4
HOU200209010,2002,20901,HOU,LAN,HOU03,2,1,3
HOU200209090,2002,20909,HOU,COL,HOU03,5,6,11
HOU200209100,2002,20910,HOU,COL,HOU03,4,11,15
HOU200209110,2002,20911,HOU,COL,HOU03,8,6,14
HOU200209120,2002,20912,HOU,SLN,HOU03,3,6,9
HOU200209130,2002,20913,HOU,SLN,HOU03,3,2,5
HOU200209140,2002,20914,HOU,SLN,HOU03,2,1,3
HOU200209150,2002,20915,HOU,SLN,HOU03,0,8,8
HOU200209230,2002,20923,HOU,MIL,HOU03,6,8,14
HOU200209240,2002,20924,HOU,MIL,HOU03,3,1,4
HOU200209250,2002,20925,HOU,MIL,HOU03,5,7,12
HOU200304010,2003,30401,HOU,COL,HOU03,4,10,14
HOU200304020,2003,30402,HOU,COL,HOU03,7,8,15
HOU200304030,2003,30403,HOU,COL,HOU03,10,5,15
HOU200304080,2003,30408,HOU,CIN,HOU03,2,1,3
HOU200304090,2003,30409,HOU,CIN,HOU03,3,4,7
HOU200304100,2003,30410,HOU,CIN,HOU03,2,4,6
HOU200304110,2003,30411,HOU,SLN,HOU03,2,3,5
HOU200304120,2003,30412,HOU,SLN,HOU03,3,0,3
HOU200304130,2003,30413,HOU,SLN,HOU03,11,8,19
HOU200304290,2003,30429,HOU,ATL,HOU03,3,1,4
HOU200304300,2003,30430,HOU,ATL,HOU03,11,1,12
HOU200305010,2003,30501,HOU,ATL,HOU03,8,7,15
HOU200305020,2003,30502,HOU,FLO,HOU03,3,4,7
HOU200305030,2003,30503,HOU,FLO,HOU03,2,5,7
HOU200305040,2003,30504,HOU,FLO,HOU03,2,5,7
HOU200305050,2003,30505,HOU,PIT,HOU03,1,8,9
HOU200305060,2003,30506,HOU,PIT,HOU03,9,10,19
HOU200305070,2003,30507,HOU,PIT,HOU03,4,13,17
HOU200305080,2003,30508,HOU,PIT,HOU03,2,6,8
HOU200305160,2003,30516,HOU,PHI,HOU03,2,4,6
HOU200305170,2003,30517,HOU,PHI,HOU03,9,4,13
HOU200305180,2003,30518,HOU,PHI,HOU03,3,1,4
HOU200305200,2003,30520,HOU,SLN,HOU03,2,3,5
HOU200305210,2003,30521,HOU,SLN,HOU03,7,4,11
HOU200305220,2003,30522,HOU,SLN,HOU03,2,5,7
HOU200305230,2003,30523,HOU,CHN,HOU03,5,7,12
HOU200305240,2003,30524,HOU,CHN,HOU03,3,2,5
HOU200305250,2003,30525,HOU,CHN,HOU03,7,3,10
HOU200306030,2003,30603,HOU,BAL,HOU03,6,11,17
HOU200306040,2003,30604,HOU,BAL,HOU03,4,6,10
HOU200306050,2003,30605,HOU,BAL,HOU03,1,11,12
HOU200306060,2003,30606,HOU,TBA,HOU03,8,11,19
HOU200306070,2003,30607,HOU,TBA,HOU03,4,5,9
HOU200306080,2003,30608,HOU,TBA,HOU03,1,2,3
HOU200306170,2003,30617,HOU,ARI,HOU03,3,4,7
HOU200306180,2003,30618,HOU,ARI,HOU03,2,1,3
HOU200306190,2003,30619,HOU,ARI,HOU03,4,2,6
HOU200306270,2003,30627,HOU,TEX,HOU03,10,7,17
HOU200306280,2003,30628,HOU,TEX,HOU03,0,2,2
HOU200306290,2003,30629,HOU,TEX,HOU03,8,5,13
HOU200307010,2003,30701,HOU,MIL,HOU03,5,6,11
HOU200307020,2003,30702,HOU,MIL,HOU03,5,3,8
HOU200307030,2003,30703,HOU,MIL,HOU03,3,7,10
HOU200307070,2003,30707,HOU,CIN,HOU03,1,7,8
HOU200307080,2003,30708,HOU,CIN,HOU03,3,6,9
HOU200307090,2003,30709,HOU,CIN,HOU03,2,12,14
HOU200307100,2003,30710,HOU,CIN,HOU03,2,11,13
HOU200307110,2003,30711,HOU,PIT,HOU03,2,4,6
HOU200307120,2003,30712,HOU,PIT,HOU03,5,2,7
HOU200307130,2003,30713,HOU,PIT,HOU03,2,5,7
HOU200307250,2003,30725,HOU,CHN,HOU03,5,3,8
HOU200307260,2003,30726,HOU,CHN,HOU03,1,3,4
HOU200307270,2003,30727,HOU,CHN,HOU03,5,3,8
HOU200308050,2003,30805,HOU,NYN,HOU03,10,1,11
HOU200308060,2003,30806,HOU,NYN,HOU03,1,11,12
HOU200308070,2003,30807,HOU,NYN,HOU03,5,4,9
HOU200308080,2003,30808,HOU,MON,HOU03,1,5,6
HOU200308090,2003,30809,HOU,MON,HOU03,3,1,4
HOU200308100,2003,30810,HOU,MON,HOU03,2,8,10
HOU200308190,2003,30819,HOU,CHN,HOU03,8,12,20
HOU200308200,2003,30820,HOU,CHN,HOU03,6,0,6
HOU200308210,2003,30821,HOU,CHN,HOU03,3,9,12
HOU200308220,2003,30822,HOU,CIN,HOU03,4,3,7
HOU200308230,2003,30823,HOU,CIN,HOU03,3,1,4
HOU200308240,2003,30824,HOU,CIN,HOU03,3,6,9
HOU200308260,2003,30826,HOU,LAN,HOU03,4,18,22
HOU200308270,2003,30827,HOU,LAN,HOU03,1,6,7
HOU200308280,2003,30828,HOU,LAN,HOU03,6,3,9
HOU200308290,2003,30829,HOU,SDN,HOU03,7,1,8
HOU200308300,2003,30830,HOU,SDN,HOU03,6,11,17
HOU200308310,2003,30831,HOU,SDN,HOU03,3,1,4
HOU200309120,2003,30912,HOU,SLN,HOU03,5,14,19
HOU200309130,2003,30913,HOU,SLN,HOU03,0,2,2
HOU200309140,2003,30914,HOU,SLN,HOU03,1,4,5
HOU200309220,2003,30922,HOU,SFN,HOU03,6,3,9
HOU200309230,2003,30923,HOU,SFN,HOU03,10,3,13
HOU200309240,2003,30924,HOU,SFN,HOU03,1,2,3
HOU200309250,2003,30925,HOU,MIL,HOU03,1,6,7
HOU200309260,2003,30926,HOU,MIL,HOU03,12,5,17
HOU200309270,2003,30927,HOU,MIL,HOU03,5,2,7
HOU200309280,2003,30928,HOU,MIL,HOU03,5,8,13
HOU200404050,2004,40405,HOU,SFN,HOU03,5,4,9
HOU200404060,2004,40406,HOU,SFN,HOU03,7,5,12
HOU200404070,2004,40407,HOU,SFN,HOU03,1,10,11
HOU200404150,2004,40415,HOU,MIL,HOU03,6,2,8
HOU200404160,2004,40416,HOU,MIL,HOU03,0,2,2
HOU200404170,2004,40417,HOU,MIL,HOU03,5,14,19
HOU200404180,2004,40418,HOU,MIL,HOU03,1,6,7
HOU200404200,2004,40420,HOU,SLN,HOU03,5,3,8
HOU200404210,2004,40421,HOU,SLN,HOU03,12,6,18
HOU200404220,2004,40422,HOU,SLN,HOU03,2,1,3
HOU200404300,2004,40430,HOU,CIN,HOU03,1,6,7
HOU200405010,2004,40501,HOU,CIN,HOU03,4,10,14
HOU200405020,2004,40502,HOU,CIN,HOU03,5,6,11
HOU200405030,2004,40503,HOU,CIN,HOU03,7,5,12
HOU200405040,2004,40504,HOU,PIT,HOU03,3,4,7
HOU200405050,2004,40505,HOU,PIT,HOU03,2,6,8
HOU200405060,2004,40506,HOU,PIT,HOU03,2,5,7
HOU200405110,2004,40511,HOU,FLO,HOU03,1,6,7
HOU200405120,2004,40512,HOU,FLO,HOU03,5,2,7
HOU200405130,2004,40513,HOU,FLO,HOU03,3,2,5
HOU200405140,2004,40514,HOU,NYN,HOU03,8,3,11
HOU200405150,2004,40515,HOU,NYN,HOU03,4,7,11
HOU200405160,2004,40516,HOU,NYN,HOU03,3,2,5
HOU200405250,2004,40525,HOU,CHN,HOU03,0,5,5
HOU200405260,2004,40526,HOU,CHN,HOU03,3,7,10
HOU200405280,2004,40528,HOU,SLN,HOU03,2,1,3
HOU200405290,2004,40529,HOU,SLN,HOU03,10,3,13
HOU200405300,2004,40530,HOU,SLN,HOU03,1,7,8
HOU200406140,2004,40614,HOU,CHN,HOU03,7,2,9
HOU200406150,2004,40615,HOU,CHN,HOU03,4,2,6
HOU200406160,2004,40616,HOU,CHN,HOU03,4,1,5
HOU200406170,2004,40617,HOU,CHN,HOU03,5,4,9
HOU200406180,2004,40618,HOU,ANA,HOU03,0,5,5
HOU200406190,2004,40619,HOU,ANA,HOU03,6,4,10
HOU200406200,2004,40620,HOU,ANA,HOU03,1,3,4
HOU200406210,2004,40621,HOU,PIT,HOU03,5,7,12
HOU200406220,2004,40622,HOU,PIT,HOU03,4,5,9
HOU200406230,2004,40623,HOU,PIT,HOU03,7,2,9
HOU200406240,2004,40624,HOU,PIT,HOU03,2,3,5
HOU200407020,2004,40702,HOU,TEX,HOU03,5,7,12
HOU200407030,2004,40703,HOU,TEX,HOU03,8,10,18
HOU200407040,2004,40704,HOU,TEX,HOU03,18,3,21
HOU200407160,2004,40716,HOU,SDN,HOU03,5,1,6
HOU200407170,2004,40717,HOU,SDN,HOU03,7,4,11
HOU200407180,2004,40718,HOU,SDN,HOU03,3,5,8
HOU200407190,2004,40719,HOU,LAN,HOU03,7,6,13
HOU200407200,2004,40720,HOU,LAN,HOU03,7,5,12
HOU200407230,2004,40723,HOU,MIL,HOU03,7,6,13
HOU200407240,2004,40724,HOU,MIL,HOU03,3,6,9
HOU200407250,2004,40725,HOU,MIL,HOU03,1,9,10
HOU200407260,2004,40726,HOU,ARI,HOU03,4,1,5
HOU200407270,2004,40727,HOU,ARI,HOU03,3,10,13
HOU200407280,2004,40728,HOU,ARI,HOU03,1,6,7
HOU200407290,2004,40729,HOU,ARI,HOU03,6,4,10
HOU200408030,2004,40803,HOU,ATL,HOU03,2,3,5
HOU200408040,2004,40804,HOU,ATL,HOU03,5,4,9
HOU200408050,2004,40805,HOU,ATL,HOU03,6,5,11
HOU200408060,2004,40806,HOU,MON,HOU03,0,4,4
HOU200408070,2004,40807,HOU,MON,HOU03,8,3,11
HOU200408080,2004,40808,HOU,MON,HOU03,5,2,7
HOU200408200,2004,40820,HOU,CHN,HOU03,9,2,11
HOU200408210,2004,40821,HOU,CHN,HOU03,3,4,7
HOU200408220,2004,40822,HOU,CHN,HOU03,11,6,17
HOU200408230,2004,40823,HOU,PHI,HOU03,4,8,12
HOU200408240,2004,40824,HOU,PHI,HOU03,2,4,6
HOU200408250,2004,40825,HOU,PHI,HOU03,4,7,11
HOU200409030,2004,40903,HOU,PIT,HOU03,6,8,14
HOU200409040,2004,40904,HOU,PIT,HOU03,5,6,11
HOU200409050,2004,40905,HOU,PIT,HOU03,5,10,15
HOU200409060,2004,40906,HOU,CIN,HOU03,5,11,16
HOU200409070,2004,40907,HOU,CIN,HOU03,7,9,16
HOU200409080,2004,40908,HOU,CIN,HOU03,2,5,7
HOU200409170,2004,40917,HOU,MIL,HOU03,1,2,3
HOU200409180,2004,40918,HOU,MIL,HOU03,3,4,7
HOU200409190,2004,40919,HOU,MIL,HOU03,0,1,1
HOU200409270,2004,40927,HOU,SLN,HOU03,3,10,13
HOU200409280,2004,40928,HOU,SLN,HOU03,1,2,3
HOU200409290,2004,40929,HOU,SLN,HOU03,4,6,10
HOU200410010,2004,41001,HOU,COL,HOU03,2,4,6
HOU200410020,2004,41002,HOU,COL,HOU03,3,9,12
HOU200410030,2004,41003,HOU,COL,HOU03,3,5,8
HOU200410090,2004,41009,HOU,ATL,HOU03,5,8,13
HOU200410100,2004,41010,HOU,ATL,HOU03,6,5,11
HOU200410160,2004,41016,HOU,SLN,HOU03,2,5,7
HOU200410170,2004,41017,HOU,SLN,HOU03,5,6,11
HOU200410180,2004,41018,HOU,SLN,HOU03,0,3,3
HOU200504050,2005,50405,HOU,SLN,HOU03,7,3,10
HOU200504060,2005,50406,HOU,SLN,HOU03,1,4,5
HOU200504080,2005,50408,HOU,CIN,HOU03,2,3,5
HOU200504090,2005,50409,HOU,CIN,HOU03,3,4,7
HOU200504100,2005,50410,HOU,CIN,HOU03,2,5,7
HOU200504180,2005,50418,HOU,ATL,HOU03,1,0,1
HOU200504190,2005,50419,HOU,ATL,HOU03,3,5,8
HOU200504200,2005,50420,HOU,MIL,HOU03,1,6,7
HOU200504210,2005,50421,HOU,MIL,HOU03,7,8,15
HOU200504290,2005,50429,HOU,CHN,HOU03,3,2,5
HOU200504300,2005,50430,HOU,CHN,HOU03,5,7,12
HOU200505010,2005,50501,HOU,CHN,HOU03,3,9,12
HOU200505020,2005,50502,HOU,PIT,HOU03,4,11,15
HOU200505030,2005,50503,HOU,PIT,HOU03,7,4,11
HOU200505040,2005,50504,HOU,PIT,HOU03,6,4,10
HOU200505120,2005,50512,HOU,SFN,HOU03,6,3,9
HOU200505130,2005,50513,HOU,SFN,HOU03,4,2,6
HOU200505140,2005,50514,HOU,SFN,HOU03,1,4,5
HOU200505150,2005,50515,HOU,SFN,HOU03,0,9,9
HOU200505170,2005,50517,HOU,ARI,HOU03,0,3,3
HOU200505180,2005,50518,HOU,ARI,HOU03,7,6,13
HOU200505190,2005,50519,HOU,ARI,HOU03,6,1,7
HOU200505300,2005,50530,HOU,CIN,HOU03,9,0,9
HOU200505310,2005,50531,HOU,CIN,HOU03,3,4,7
HOU200506010,2005,50601,HOU,CIN,HOU03,1,4,5
HOU200506030,2005,50603,HOU,SLN,HOU03,2,0,2
HOU200506040,2005,50604,HOU,SLN,HOU03,11,9,20
HOU200506050,2005,50605,HOU,SLN,HOU03,4,6,10
HOU200506100,2005,50610,HOU,TOR,HOU03,2,4,6
HOU200506110,2005,50611,HOU,TOR,HOU03,3,6,9
HOU200506120,2005,50612,HOU,TOR,HOU03,0,3,3
HOU200506200,2005,50620,HOU,COL,HOU03,0,7,7
HOU200506210,2005,50621,HOU,COL,HOU03,5,6,11
HOU200506220,2005,50622,HOU,COL,HOU03,2,6,8
HOU200506240,2005,50624,HOU,TEX,HOU03,2,5,7
HOU200506250,2005,50625,HOU,TEX,HOU03,6,5,11
HOU200506260,2005,50626,HOU,TEX,HOU03,2,3,5
HOU200507040,2005,50704,HOU,SDN,HOU03,1,4,5
HOU200507050,2005,50705,HOU,SDN,HOU03,2,6,8
HOU200507060,2005,50706,HOU,SDN,HOU03,4,5,9
HOU200507070,2005,50707,HOU,SDN,HOU03,7,5,12
HOU200507080,2005,50708,HOU,LAN,HOU03,2,3,5
HOU200507090,2005,50709,HOU,LAN,HOU03,2,4,6
HOU200507100,2005,50710,HOU,LAN,HOU03,5,6,11
HOU200507250,2005,50725,HOU,PHI,HOU03,1,7,8
HOU200507260,2005,50726,HOU,PHI,HOU03,1,2,3
HOU200507270,2005,50727,HOU,PHI,HOU03,2,3,5
HOU200507280,2005,50728,HOU,NYN,HOU03,2,3,5
HOU200507290,2005,50729,HOU,NYN,HOU03,2,5,7
HOU200507300,2005,50730,HOU,NYN,HOU03,0,2,2
HOU200507310,2005,50731,HOU,NYN,HOU03,9,4,13
HOU200508090,2005,50809,HOU,WAS,HOU03,6,5,11
HOU200508100,2005,50810,HOU,WAS,HOU03,6,7,13
HOU200508110,2005,50811,HOU,WAS,HOU03,3,6,9
HOU200508120,2005,50812,HOU,PIT,HOU03,5,6,11
HOU200508130,2005,50813,HOU,PIT,HOU03,1,0,1
HOU200508140,2005,50814,HOU,PIT,HOU03,8,0,8
HOU200508150,2005,50815,HOU,CHN,HOU03,4,12,16
HOU200508160,2005,50816,HOU,CHN,HOU03,4,1,5
HOU200508170,2005,50817,HOU,CHN,HOU03,4,2,6
HOU200508180,2005,50818,HOU,MIL,HOU03,5,2,7
HOU200508190,2005,50819,HOU,MIL,HOU03,3,5,8
HOU200508200,2005,50820,HOU,MIL,HOU03,3,2,5
HOU200508210,2005,50821,HOU,MIL,HOU03,3,8,11
HOU200508300,2005,50830,HOU,CIN,HOU03,2,5,7
HOU200508310,2005,50831,HOU,CIN,HOU03,0,10,10
HOU200509010,2005,50901,HOU,CIN,HOU03,1,3,4
HOU200509020,2005,50902,HOU,SLN,HOU03,5,6,11
HOU200509030,2005,50903,HOU,SLN,HOU03,4,2,6
HOU200509040,2005,50904,HOU,SLN,HOU03,4,1,5
HOU200509120,2005,50912,HOU,FLO,HOU03,8,2,10
HOU200509130,2005,50913,HOU,FLO,HOU03,4,2,6
HOU200509140,2005,50914,HOU,FLO,HOU03,2,10,12
HOU200509150,2005,50915,HOU,FLO,HOU03,1,4,5
HOU200509160,2005,50916,HOU,MIL,HOU03,1,2,3
HOU200509170,2005,50917,HOU,MIL,HOU03,0,7,7
HOU200509180,2005,50918,HOU,MIL,HOU03,1,6,7
HOU200509290,2005,50929,HOU,CHN,HOU03,3,2,5
HOU200509300,2005,50930,HOU,CHN,HOU03,4,3,7
HOU200510010,2005,51001,HOU,CHN,HOU03,1,3,4
HOU200510020,2005,51002,HOU,CHN,HOU03,4,6,10
HOU200510080,2005,51008,HOU,ATL,HOU03,3,7,10
HOU200510090,2005,51009,HOU,ATL,HOU03,6,7,13
HOU200510150,2005,51015,HOU,SLN,HOU03,3,4,7
HOU200510160,2005,51016,HOU,SLN,HOU03,1,2,3
HOU200510170,2005,51017,HOU,SLN,HOU03,5,4,9
HOU200510250,2005,51025,HOU,CHA,HOU03,7,5,12
HOU200510260,2005,51026,HOU,CHA,HOU03,1,0,1
HOU200604030,2006,60403,HOU,FLO,HOU03,0,1,1
HOU200604040,2006,60404,HOU,FLO,HOU03,11,2,13
HOU200604050,2006,60405,HOU,FLO,HOU03,5,6,11
HOU200604070,2006,60407,HOU,WAS,HOU03,1,6,7
HOU200604080,2006,60408,HOU,WAS,HOU03,12,8,20
HOU200604090,2006,60409,HOU,WAS,HOU03,3,7,10
HOU200604100,2006,60410,HOU,WAS,HOU03,4,5,9
HOU200604170,2006,60417,HOU,MIL,HOU03,7,8,15
HOU200604180,2006,60418,HOU,MIL,HOU03,12,13,25
HOU200604190,2006,60419,HOU,MIL,HOU03,7,2,9
HOU200604210,2006,60421,HOU,PIT,HOU03,2,3,5
HOU200604220,2006,60422,HOU,PIT,HOU03,0,3,3
HOU200604230,2006,60423,HOU,PIT,HOU03,2,7,9
HOU200604240,2006,60424,HOU,LAN,HOU03,6,2,8
HOU200604250,2006,60425,HOU,LAN,HOU03,3,4,7
HOU200604260,2006,60426,HOU,LAN,HOU03,5,8,13
HOU200605030,2006,60503,HOU,SLN,HOU03,4,5,9
HOU200605040,2006,60504,HOU,SLN,HOU03,3,4,7
HOU200605120,2006,60512,HOU,COL,HOU03,2,12,14
HOU200605130,2006,60513,HOU,COL,HOU03,2,1,3
HOU200605140,2006,60514,HOU,COL,HOU03,0,3,3
HOU200605150,2006,60515,HOU,SFN,HOU03,10,1,11
HOU200605160,2006,60516,HOU,SFN,HOU03,14,3,17
HOU200605170,2006,60517,HOU,SFN,HOU03,10,1,11
HOU200605190,2006,60519,HOU,TEX,HOU03,3,5,8
HOU200605200,2006,60520,HOU,TEX,HOU03,6,0,6
HOU200605210,2006,60521,HOU,TEX,HOU03,0,5,5
HOU200606020,2006,60602,HOU,CIN,HOU03,14,3,17
HOU200606030,2006,60603,HOU,CIN,HOU03,7,5,12
HOU200606040,2006,60604,HOU,CIN,HOU03,6,4,10
HOU200606050,2006,60605,HOU,CHN,HOU03,8,0,8
HOU200606060,2006,60606,HOU,CHN,HOU03,1,4,5
HOU200606070,2006,60607,HOU,CHN,HOU03,0,1,1
HOU200606080,2006,60608,HOU,ATL,HOU03,4,7,11
HOU200606090,2006,60609,HOU,ATL,HOU03,2,7,9
HOU200606100,2006,60610,HOU,ATL,HOU03,4,2,6
HOU200606110,2006,60611,HOU,ATL,HOU03,4,14,18
HOU200606160,2006,60616,HOU,KCA,HOU03,7,2,9
HOU200606170,2006,60617,HOU,KCA,HOU03,2,7,9
HOU200606180,2006,60618,HOU,KCA,HOU03,7,4,11
HOU200606200,2006,60620,HOU,MIN,HOU03,6,5,11
HOU200606210,2006,60621,HOU,MIN,HOU03,3,5,8
HOU200606220,2006,60622,HOU,MIN,HOU03,4,2,6
HOU200607030,2006,60703,HOU,CHN,HOU03,2,7,9
HOU200607040,2006,60704,HOU,CHN,HOU03,2,7,9
HOU200607050,2006,60705,HOU,CHN,HOU03,1,0,1
HOU200607060,2006,60706,HOU,SLN,HOU03,2,4,6
HOU200607070,2006,60707,HOU,SLN,HOU03,8,2,10
HOU200607080,2006,60708,HOU,SLN,HOU03,7,6,13
HOU200607090,2006,60709,HOU,SLN,HOU03,7,5,12
HOU200607250,2006,60725,HOU,CIN,HOU03,2,0,2
HOU200607260,2006,60726,HOU,CIN,HOU03,5,8,13
HOU200607270,2006,60727,HOU,CIN,HOU03,8,4,12
HOU200607280,2006,60728,HOU,ARI,HOU03,8,7,15
HOU200607290,2006,60729,HOU,ARI,HOU03,1,4,5
HOU200607300,2006,60730,HOU,ARI,HOU03,7,6,13
HOU200608080,2006,60808,HOU,PIT,HOU03,1,3,4
HOU200608090,2006,60809,HOU,PIT,HOU03,1,14,15
HOU200608100,2006,60810,HOU,PIT,HOU03,2,5,7
HOU200608110,2006,60811,HOU,SDN,HOU03,2,4,6
HOU200608120,2006,60812,HOU,SDN,HOU03,6,3,9
HOU200608130,2006,60813,HOU,SDN,HOU03,7,2,9
HOU200608140,2006,60814,HOU,CHN,HOU03,3,0,3
HOU200608150,2006,60815,HOU,CHN,HOU03,8,6,14
HOU200608160,2006,60816,HOU,CHN,HOU03,1,0,1
HOU200608290,2006,60829,HOU,MIL,HOU03,3,10,13
HOU200608300,2006,60830,HOU,MIL,HOU03,0,1,1
HOU200608310,2006,60831,HOU,MIL,HOU03,3,5,8
HOU200609010,2006,60901,HOU,NYN,HOU03,8,7,15
HOU200609020,2006,60902,HOU,NYN,HOU03,4,2,6
HOU200609030,2006,60903,HOU,NYN,HOU03,1,2,3
HOU200609150,2006,60915,HOU,PHI,HOU03,4,3,7
HOU200609160,2006,60916,HOU,PHI,HOU03,7,2,9
HOU200609170,2006,60917,HOU,PHI,HOU03,6,4,10
HOU200609180,2006,60918,HOU,CIN,HOU03,3,5,8
HOU200609190,2006,60919,HOU,CIN,HOU03,5,4,9
HOU200609200,2006,60920,HOU,CIN,HOU03,2,7,9
HOU200609210,2006,60921,HOU,SLN,HOU03,5,6,11
HOU200609220,2006,60922,HOU,SLN,HOU03,5,6,11
HOU200609230,2006,60923,HOU,SLN,HOU03,4,7,11
HOU200609240,2006,60924,HOU,SLN,HOU03,3,7,10
HOU200704020,2007,70402,HOU,PIT,HOU03,4,2,6
HOU200704030,2007,70403,HOU,PIT,HOU03,3,2,5
HOU200704040,2007,70404,HOU,PIT,HOU03,5,4,9
HOU200704060,2007,70406,HOU,SLN,HOU03,4,2,6
HOU200704070,2007,70407,HOU,SLN,HOU03,1,5,6
HOU200704080,2007,70408,HOU,SLN,HOU03,10,1,11
HOU200704160,2007,70416,HOU,FLO,HOU03,3,4,7
HOU200704170,2007,70417,HOU,FLO,HOU03,1,6,7
HOU200704270,2007,70427,HOU,MIL,HOU03,4,1,5
HOU200704280,2007,70428,HOU,MIL,HOU03,1,10,11
HOU200704290,2007,70429,HOU,MIL,HOU03,3,1,4
HOU200705010,2007,70501,HOU,CIN,HOU03,11,2,13
HOU200705020,2007,70502,HOU,CIN,HOU03,1,3,4
HOU200705030,2007,70503,HOU,CIN,HOU03,5,7,12
HOU200705110,2007,70511,HOU,ARI,HOU03,3,1,4
HOU200705120,2007,70512,HOU,ARI,HOU03,4,10,14
HOU200705130,2007,70513,HOU,ARI,HOU03,2,5,7
HOU200705150,2007,70515,HOU,SFN,HOU03,5,6,11
HOU200705160,2007,70516,HOU,SFN,HOU03,1,2,3
HOU200705170,2007,70517,HOU,SFN,HOU03,2,1,3
HOU200705180,2007,70518,HOU,TEX,HOU03,7,4,11
HOU200705190,2007,70519,HOU,TEX,HOU03,1,6,7
HOU200705200,2007,70520,HOU,TEX,HOU03,14,1,15
HOU200705290,2007,70529,HOU,CIN,HOU03,2,1,3
HOU200705300,2007,70530,HOU,CIN,HOU03,4,3,7
HOU200705310,2007,70531,HOU,CIN,HOU03,2,10,12
HOU200706010,2007,70601,HOU,SLN,HOU03,8,1,9
HOU200706020,2007,70602,HOU,SLN,HOU03,3,8,11
HOU200706030,2007,70603,HOU,SLN,HOU03,8,6,14
HOU200706120,2007,70612,HOU,OAK,HOU03,4,5,9
HOU200706130,2007,70613,HOU,OAK,HOU03,7,3,10
HOU200706140,2007,70614,HOU,OAK,HOU03,6,5,11
HOU200706150,2007,70615,HOU,SEA,HOU03,1,5,6
HOU200706160,2007,70616,HOU,SEA,HOU03,4,9,13
HOU200706170,2007,70617,HOU,SEA,HOU03,3,10,13
HOU200706280,2007,70628,HOU,COL,HOU03,5,8,13
HOU200706290,2007,70629,HOU,COL,HOU03,8,9,17
HOU200706300,2007,70630,HOU,COL,HOU03,5,0,5
HOU200707010,2007,70701,HOU,COL,HOU03,0,12,12
HOU200707020,2007,70702,HOU,PHI,HOU03,5,7,12
HOU200707030,2007,70703,HOU,PHI,HOU03,4,5,9
HOU200707040,2007,70704,HOU,PHI,HOU03,8,3,11
HOU200707050,2007,70705,HOU,NYN,HOU03,6,2,8
HOU200707060,2007,70706,HOU,NYN,HOU03,0,4,4
HOU200707070,2007,70707,HOU,NYN,HOU03,5,3,8
HOU200707080,2007,70708,HOU,NYN,HOU03,3,8,11
HOU200707230,2007,70723,HOU,LAN,HOU03,10,2,12
HOU200707240,2007,70724,HOU,LAN,HOU03,4,7,11
HOU200707250,2007,70725,HOU,LAN,HOU03,1,2,3
HOU200707260,2007,70726,HOU,SDN,HOU03,1,7,8
HOU200707270,2007,70727,HOU,SDN,HOU03,9,4,13
HOU200707280,2007,70728,HOU,SDN,HOU03,1,3,4
HOU200707290,2007,70729,HOU,SDN,HOU03,18,11,29
HOU200708060,2007,70806,HOU,CHN,HOU03,1,2,3
HOU200708070,2007,70807,HOU,CHN,HOU03,2,5,7
HOU200708080,2007,70808,HOU,CHN,HOU03,2,8,10
HOU200708100,2007,70810,HOU,MIL,HOU03,5,4,9
HOU200708110,2007,70811,HOU,MIL,HOU03,7,4,11
HOU200708120,2007,70812,HOU,MIL,HOU03,4,6,10
HOU200708200,2007,70820,HOU,WAS,HOU03,7,0,7
HOU200708210,2007,70821,HOU,WAS,HOU03,11,6,17
HOU200708220,2007,70822,HOU,WAS,HOU03,2,3,5
HOU200708230,2007,70823,HOU,WAS,HOU03,7,6,13
HOU200708240,2007,70824,HOU,PIT,HOU03,8,3,11
HOU200708250,2007,70825,HOU,PIT,HOU03,4,1,5
HOU200708260,2007,70826,HOU,PIT,HOU03,4,5,9
HOU200708280,2007,70828,HOU,SLN,HOU03,7,0,7
HOU200708290,2007,70829,HOU,SLN,HOU03,0,7,7
HOU200708300,2007,70830,HOU,SLN,HOU03,1,2,3
HOU200709110,2007,70911,HOU,CHN,HOU03,4,5,9
HOU200709120,2007,70912,HOU,CHN,HOU03,3,2,5
HOU200709130,2007,70913,HOU,CHN,HOU03,6,2,8
HOU200709140,2007,70914,HOU,PIT,HOU03,4,3,7
HOU200709150,2007,70915,HOU,PIT,HOU03,7,9,16
HOU200709160,2007,70916,HOU,PIT,HOU03,3,15,18
HOU200709170,2007,70917,HOU,MIL,HOU03,6,0,6
HOU200709180,2007,70918,HOU,MIL,HOU03,9,1,10
HOU200709190,2007,70919,HOU,MIL,HOU03,4,5,9
HOU200709280,2007,70928,HOU,ATL,HOU03,7,2,9
HOU200709290,2007,70929,HOU,ATL,HOU03,2,3,5
HOU200709300,2007,70930,HOU,ATL,HOU03,0,3,3
HOU200804070,2008,80407,HOU,SLN,HOU03,3,5,8
HOU200804080,2008,80408,HOU,SLN,HOU03,5,3,8
HOU200804090,2008,80409,HOU,SLN,HOU03,6,4,10
HOU200804110,2008,80411,HOU,FLO,HOU03,10,6,16
HOU200804120,2008,80412,HOU,FLO,HOU03,0,5,5
HOU200804130,2008,80413,HOU,FLO,HOU03,1,5,6
HOU200804180,2008,80418,HOU,COL,HOU03,11,5,16
HOU200804190,2008,80419,HOU,COL,HOU03,3,2,5
HOU200804200,2008,80420,HOU,COL,HOU03,4,6,10
HOU200804210,2008,80421,HOU,SDN,HOU03,3,10,13
HOU200804220,2008,80422,HOU,SDN,HOU03,7,11,18
HOU200805020,2008,80502,HOU,MIL,HOU03,4,7,11
HOU200805030,2008,80503,HOU,MIL,HOU03,2,6,8
HOU200805040,2008,80504,HOU,MIL,HOU03,6,8,14
HOU200805060,2008,80506,HOU,WAS,HOU03,5,6,11
HOU200805070,2008,80507,HOU,WAS,HOU03,3,4,7
HOU200805080,2008,80508,HOU,WAS,HOU03,8,3,11
HOU200805190,2008,80519,HOU,CHN,HOU03,7,2,9
HOU200805200,2008,80520,HOU,CHN,HOU03,2,4,6
HOU200805210,2008,80521,HOU,CHN,HOU03,3,5,8
HOU200805220,2008,80522,HOU,PHI,HOU03,7,5,12
HOU200805230,2008,80523,HOU,PHI,HOU03,3,4,7
HOU200805240,2008,80524,HOU,PHI,HOU03,3,4,7
HOU200805250,2008,80525,HOU,PHI,HOU03,15,6,21
HOU200806060,2008,80606,HOU,SLN,HOU03,1,6,7
HOU200806070,2008,80607,HOU,SLN,HOU03,8,4,12
HOU200806080,2008,80608,HOU,SLN,HOU03,5,4,9
HOU200806100,2008,80610,HOU,MIL,HOU03,1,6,7
HOU200806110,2008,80611,HOU,MIL,HOU03,10,6,16
HOU200806120,2008,80612,HOU,MIL,HOU03,9,6,15
HOU200806130,2008,80613,HOU,NYA,HOU03,2,1,3
HOU200806140,2008,80614,HOU,NYA,HOU03,8,4,12
HOU200806150,2008,80615,HOU,NYA,HOU03,13,0,13
HOU200806240,2008,80624,HOU,TEX,HOU03,3,4,7
HOU200806250,2008,80625,HOU,TEX,HOU03,3,2,5
HOU200806260,2008,80626,HOU,TEX,HOU03,2,7,9
HOU200806270,2008,80627,HOU,BOS,HOU03,6,1,7
HOU200806280,2008,80628,HOU,BOS,HOU03,10,11,21
HOU200806290,2008,80629,HOU,BOS,HOU03,2,3,5
HOU200806300,2008,80630,HOU,LAN,HOU03,1,4,5
HOU200807010,2008,80701,HOU,LAN,HOU03,7,6,13
HOU200807020,2008,80702,HOU,LAN,HOU03,4,1,5
HOU200807030,2008,80703,HOU,LAN,HOU03,5,2,7
HOU200807180,2008,80718,HOU,CHN,HOU03,1,2,3
HOU200807190,2008,80719,HOU,CHN,HOU03,1,4,5
HOU200807200,2008,80720,HOU,CHN,HOU03,9,0,9
HOU200807210,2008,80721,HOU,PIT,HOU03,9,3,12
HOU200807220,2008,80722,HOU,PIT,HOU03,8,2,10
HOU200807230,2008,80723,HOU,PIT,HOU03,8,7,15
HOU200807280,2008,80728,HOU,CIN,HOU03,4,5,9
HOU200807290,2008,80729,HOU,CIN,HOU03,2,6,8
HOU200807300,2008,80730,HOU,CIN,HOU03,9,5,14
HOU200808010,2008,80801,HOU,NYN,HOU03,3,7,10
HOU200808020,2008,80802,HOU,NYN,HOU03,4,5,9
HOU200808030,2008,80803,HOU,NYN,HOU03,0,4,4
HOU200808110,2008,80811,HOU,SFN,HOU03,1,3,4
HOU200808120,2008,80812,HOU,SFN,HOU03,4,12,16
HOU200808130,2008,80813,HOU,SFN,HOU03,2,6,8
HOU200808140,2008,80814,HOU,SFN,HOU03,4,7,11
HOU200808150,2008,80815,HOU,ARI,HOU03,12,2,14
HOU200808160,2008,80816,HOU,ARI,HOU03,11,5,16
HOU200808170,2008,80817,HOU,ARI,HOU03,0,3,3
HOU200808260,2008,80826,HOU,CIN,HOU03,2,1,3
HOU200808270,2008,80827,HOU,CIN,HOU03,1,4,5
HOU200808280,2008,80828,HOU,CIN,HOU03,2,3,5
HOU200808290,2008,80829,HOU,SLN,HOU03,2,3,5
HOU200808300,2008,80830,HOU,SLN,HOU03,5,8,13
HOU200808310,2008,80831,HOU,SLN,HOU03,0,3,3
HOU200809080,2008,80908,HOU,PIT,HOU03,2,3,5
HOU200809090,2008,80909,HOU,PIT,HOU03,3,9,12
HOU200809100,2008,80910,HOU,PIT,HOU03,4,7,11
HOU200809110,2008,80911,HOU,PIT,HOU03,0,6,6
HOU200809140,2008,80914,HOU,CHN,MIL06,5,0,5
HOU200809150,2008,80915,HOU,CHN,MIL06,6,1,7
HOU200809230,2008,80923,HOU,CIN,HOU03,2,1,3
HOU200809240,2008,80924,HOU,CIN,HOU03,0,5,5
HOU200809250,2008,80925,HOU,CIN,HOU03,6,8,14
HOU200809260,2008,80926,HOU,ATL,HOU03,4,5,9
HOU200809270,2008,80927,HOU,ATL,HOU03,11,5,16
HOU200809280,2008,80928,HOU,ATL,HOU03,1,3,4
HOU200904060,2009,90406,HOU,CHN,HOU03,4,2,6
HOU200904070,2009,90407,HOU,CHN,HOU03,2,3,5
HOU200904080,2009,90408,HOU,CHN,HOU03,11,6,17
HOU200904170,2009,90417,HOU,CIN,HOU03,2,1,3
HOU200904180,2009,90418,HOU,CIN,HOU03,0,7,7
HOU200904190,2009,90419,HOU,CIN,HOU03,4,2,6
HOU200904200,2009,90420,HOU,CIN,HOU03,4,3,7
HOU200904210,2009,90421,HOU,LAN,HOU03,5,8,13
HOU200904220,2009,90422,HOU,LAN,HOU03,5,6,11
HOU200904230,2009,90423,HOU,LAN,HOU03,2,0,2
HOU200904240,2009,90424,HOU,MIL,HOU03,5,2,7
HOU200904250,2009,90425,HOU,MIL,HOU03,9,8,17
HOU200904260,2009,90426,HOU,MIL,HOU03,2,3,5
HOU200905060,2009,90506,HOU,CHN,HOU03,6,3,9
HOU200905070,2009,90507,HOU,CHN,HOU03,8,5,13
HOU200905080,2009,90508,HOU,SDN,HOU03,0,2,2
HOU200905090,2009,90509,HOU,SDN,HOU03,4,5,9
HOU200905100,2009,90510,HOU,SDN,HOU03,5,12,17
HOU200905190,2009,90519,HOU,MIL,HOU03,4,2,6
HOU200905200,2009,90520,HOU,MIL,HOU03,4,6,10
HOU200905210,2009,90521,HOU,MIL,HOU03,4,3,7
HOU200905220,2009,90522,HOU,TEX,HOU03,6,5,11
HOU200905230,2009,90523,HOU,TEX,HOU03,6,3,9
HOU200905240,2009,90524,HOU,TEX,HOU03,5,0,5
HOU200906010,2009,90601,HOU,COL,HOU03,1,4,5
HOU200906020,2009,90602,HOU,COL,HOU03,2,3,5
HOU200906030,2009,90603,HOU,COL,HOU03,4,6,10
HOU200906040,2009,90604,HOU,COL,HOU03,10,3,13
HOU200906050,2009,90605,HOU,PIT,HOU03,1,9,10
HOU200906060,2009,90606,HOU,PIT,HOU03,6,4,10
HOU200906070,2009,90607,HOU,PIT,HOU03,4,6,10
HOU200906090,2009,90609,HOU,CHN,HOU03,7,1,8
HOU200906100,2009,90610,HOU,CHN,HOU03,1,2,3
HOU200906110,2009,90611,HOU,CHN,HOU03,1,2,3
HOU200906230,2009,90623,HOU,KCA,HOU03,2,1,3
HOU200906240,2009,90624,HOU,KCA,HOU03,4,3,7
HOU200906250,2009,90625,HOU,KCA,HOU03,4,5,9
HOU200906260,2009,90626,HOU,DET,HOU03,4,5,9
HOU200906270,2009,90627,HOU,DET,HOU03,1,8,9
HOU200906280,2009,90628,HOU,DET,HOU03,4,3,7
HOU200907060,2009,90706,HOU,PIT,HOU03,1,4,5
HOU200907070,2009,90707,HOU,PIT,HOU03,6,3,9
HOU200907080,2009,90708,HOU,PIT,HOU03,0,5,5
HOU200907090,2009,90709,HOU,WAS,HOU03,4,9,13
HOU200907100,2009,90710,HOU,WAS,HOU03,5,6,11
HOU200907110,2009,90711,HOU,WAS,HOU03,13,2,15
HOU200907120,2009,90712,HOU,WAS,HOU03,0,5,5
HOU200907200,2009,90720,HOU,SLN,HOU03,2,3,5
HOU200907210,2009,90721,HOU,SLN,HOU03,6,11,17
HOU200907220,2009,90722,HOU,SLN,HOU03,3,4,7
HOU200907240,2009,90724,HOU,NYN,HOU03,4,5,9
HOU200907250,2009,90725,HOU,NYN,HOU03,10,3,13
HOU200907260,2009,90726,HOU,NYN,HOU03,8,3,11
HOU200908030,2009,90803,HOU,SFN,HOU03,3,4,7
HOU200908040,2009,90804,HOU,SFN,HOU03,8,1,9
HOU200908050,2009,90805,HOU,SFN,HOU03,10,6,16
HOU200908070,2009,90807,HOU,MIL,HOU03,3,6,9
HOU200908080,2009,90808,HOU,MIL,HOU03,12,5,17
HOU200908090,2009,90809,HOU,MIL,HOU03,0,2,2
HOU200908180,2009,90818,HOU,FLO,HOU03,6,2,8
HOU200908190,2009,90819,HOU,FLO,HOU03,3,6,9
HOU200908200,2009,90820,HOU,FLO,HOU03,1,4,5
HOU200908210,2009,90821,HOU,ARI,HOU03,0,1,1
HOU200908220,2009,90822,HOU,ARI,HOU03,2,4,6
HOU200908230,2009,90823,HOU,ARI,HOU03,7,5,12
HOU200909040,2009,90904,HOU,PHI,HOU03,0,7,7
HOU200909050,2009,90905,HOU,PHI,HOU03,4,5,9
HOU200909060,2009,90906,HOU,PHI,HOU03,3,4,7
HOU200909070,2009,90907,HOU,PHI,HOU03,3,4,7
HOU200909080,2009,90908,HOU,ATL,HOU03,2,1,3
HOU200909090,2009,90909,HOU,ATL,HOU03,1,2,3
HOU200909100,2009,90910,HOU,ATL,HOU03,9,7,16
HOU200909110,2009,90911,HOU,PIT,HOU03,1,9,10
HOU200909120,2009,90912,HOU,PIT,HOU03,2,4,6
HOU200909130,2009,90913,HOU,PIT,HOU03,2,1,3
HOU200909210,2009,90921,HOU,SLN,HOU03,7,3,10
HOU200909220,2009,90922,HOU,SLN,HOU03,11,2,13
HOU200909230,2009,90923,HOU,SLN,HOU03,0,3,3
HOU200909250,2009,90925,HOU,CIN,HOU03,10,4,14
HOU200909260,2009,90926,HOU,CIN,HOU03,10,4,14
HOU200909270,2009,90927,HOU,CIN,HOU03,2,3,5
KCA200004070,2000,407,KCA,MIN,KAN06,6,10,16
KCA200004080,2000,408,KCA,MIN,KAN06,2,5,7
KCA200004090,2000,409,KCA,MIN,KAN06,13,7,20
KCA200004100,2000,410,KCA,MIN,KAN06,5,6,11
KCA200004110,2000,411,KCA,BAL,KAN06,5,7,12
KCA200004120,2000,412,KCA,BAL,KAN06,6,7,13
KCA200004130,2000,413,KCA,BAL,KAN06,5,6,11
KCA200004250,2000,425,KCA,TBA,KAN06,6,7,13
KCA200004260,2000,426,KCA,TBA,KAN06,6,7,13
KCA200004280,2000,428,KCA,SEA,KAN06,5,8,13
KCA200004290,2000,429,KCA,SEA,KAN06,11,3,14
KCA200004300,2000,430,KCA,SEA,KAN06,3,6,9
KCA200005010,2000,501,KCA,OAK,KAN06,7,5,12
KCA200005020,2000,502,KCA,OAK,KAN06,7,8,15
KCA200005030,2000,503,KCA,OAK,KAN06,14,5,19
KCA200005050,2000,505,KCA,CHA,KAN06,1,5,6
KCA200005060,2000,506,KCA,CHA,KAN06,5,11,16
KCA200005070,2000,507,KCA,CHA,KAN06,8,12,20
KCA200005230,2000,523,KCA,TEX,KAN06,4,3,7
KCA200005240,2000,524,KCA,TEX,KAN06,0,3,3
KCA200005250,2000,525,KCA,TEX,KAN06,5,3,8
KCA200005260,2000,526,KCA,ANA,KAN06,4,9,13
KCA200005270,2000,527,KCA,ANA,KAN06,5,6,11
KCA200005280,2000,528,KCA,ANA,KAN06,8,4,12
KCA200006090,2000,609,KCA,PIT,KAN06,5,6,11
KCA200006100,2000,610,KCA,PIT,KAN06,1,2,3
KCA200006110,2000,611,KCA,PIT,KAN06,10,6,16
KCA200006120,2000,612,KCA,SEA,KAN06,5,3,8
KCA200006130,2000,613,KCA,SEA,KAN06,7,0,7
KCA200006140,2000,614,KCA,SEA,KAN06,4,5,9
KCA200006160,2000,616,KCA,OAK,KAN06,8,3,11
KCA200006170,2000,617,KCA,OAK,KAN06,10,4,14
KCA200006180,2000,618,KCA,OAK,KAN06,21,3,24
KCA200006270,2000,627,KCA,CLE,KAN06,12,1,13
KCA200006280,2000,628,KCA,CLE,KAN06,1,8,9
KCA200006290,2000,629,KCA,CLE,KAN06,1,6,7
KCA200006300,2000,630,KCA,DET,KAN06,3,1,4
KCA200007010,2000,701,KCA,DET,KAN06,8,7,15
KCA200007020,2000,702,KCA,DET,KAN06,2,0,2
KCA200007030,2000,703,KCA,CHA,KAN06,14,10,24
KCA200007040,2000,704,KCA,CHA,KAN06,7,10,17
KCA200007050,2000,705,KCA,CHA,KAN06,6,3,9
KCA200007130,2000,713,KCA,MIL,KAN06,5,2,7
KCA200007140,2000,714,KCA,MIL,KAN06,4,0,4
KCA200007150,2000,715,KCA,MIL,KAN06,4,7,11
KCA200007160,2000,716,KCA,CHN,KAN06,10,7,17
KCA200007170,2000,717,KCA,CHN,KAN06,3,1,4
KCA200007180,2000,718,KCA,CHN,KAN06,4,12,16
KCA200007270,2000,727,KCA,TBA,KAN06,8,5,13
KCA200007280,2000,728,KCA,TBA,KAN06,10,3,13
KCA200007290,2000,729,KCA,TBA,KAN06,2,1,3
KCA200007300,2000,730,KCA,TBA,KAN06,7,6,13
KCA200008070,2000,807,KCA,TOR,KAN06,7,8,15
KCA200008080,2000,808,KCA,TOR,KAN06,6,1,7
KCA200008090,2000,809,KCA,TOR,KAN06,3,5,8
KCA200008100,2000,810,KCA,TOR,KAN06,15,7,22
KCA200008110,2000,811,KCA,BAL,KAN06,6,7,13
KCA200008120,2000,812,KCA,BAL,KAN06,12,11,23
KCA200008130,2000,813,KCA,BAL,KAN06,5,10,15
KCA200008240,2000,824,KCA,BOS,KAN06,9,7,16
KCA200008250,2000,825,KCA,BOS,KAN06,2,6,8
KCA200008260,2000,826,KCA,BOS,KAN06,5,3,8
KCA200008270,2000,827,KCA,BOS,KAN06,7,11,18
KCA200008290,2000,829,KCA,MIN,KAN06,3,7,10
KCA200008300,2000,830,KCA,MIN,KAN06,7,8,15
KCA200009040,2000,904,KCA,NYA,KAN06,4,3,7
KCA200009050,2000,905,KCA,NYA,KAN06,10,5,15
KCA200009060,2000,906,KCA,NYA,KAN06,2,3,5
KCA200009070,2000,907,KCA,NYA,KAN06,7,3,10
KCA200009080,2000,908,KCA,TEX,KAN06,6,5,11
KCA200009090,2000,909,KCA,TEX,KAN06,6,5,11
KCA200009100,2000,910,KCA,TEX,KAN06,8,13,21
KCA200009190,2000,919,KCA,ANA,KAN06,1,5,6
KCA200009200,2000,920,KCA,ANA,KAN06,7,4,11
KCA200009210,2000,921,KCA,ANA,KAN06,3,8,11
KCA200009220,2000,922,KCA,CLE,KAN06,2,3,5
KCA200009230,2000,923,KCA,CLE,KAN06,11,1,12
KCA200009240,2000,924,KCA,CLE,KAN06,0,9,9
KCA200009260,2000,926,KCA,DET,KAN06,6,7,13
KCA200009270,2000,927,KCA,DET,KAN06,0,3,3
KCA200009280,2000,928,KCA,DET,KAN06,5,8,13
KCA200104060,2001,10406,KCA,MIN,KAN06,6,2,8
KCA200104070,2001,10407,KCA,MIN,KAN06,3,5,8
KCA200104080,2001,10408,KCA,MIN,KAN06,4,15,19
KCA200104090,2001,10409,KCA,NYA,KAN06,13,4,17
KCA200104100,2001,10410,KCA,NYA,KAN06,9,5,14
KCA200104110,2001,10411,KCA,NYA,KAN06,8,5,13
KCA200104200,2001,10420,KCA,TOR,KAN06,12,4,16
KCA200104210,2001,10421,KCA,TOR,KAN06,4,5,9
KCA200104220,2001,10422,KCA,TOR,KAN06,1,5,6
KCA200105010,2001,10501,KCA,CLE,KAN06,13,2,15
KCA200105020,2001,10502,KCA,CLE,KAN06,8,4,12
KCA200105030,2001,10503,KCA,CLE,KAN06,9,4,13
KCA200105040,2001,10504,KCA,MIN,KAN06,6,2,8
KCA200105050,2001,10505,KCA,MIN,KAN06,10,12,22
KCA200105060,2001,10506,KCA,MIN,KAN06,4,2,6
KCA200105150,2001,10515,KCA,TBA,KAN06,2,6,8
KCA200105160,2001,10516,KCA,TBA,KAN06,5,9,14
KCA200105170,2001,10517,KCA,TBA,KAN06,2,4,6
KCA200105180,2001,10518,KCA,BOS,KAN06,6,3,9
KCA200105190,2001,10519,KCA,BOS,KAN06,2,6,8
KCA200105200,2001,10520,KCA,BOS,KAN06,10,3,13
KCA200105220,2001,10522,KCA,OAK,KAN06,4,1,5
KCA200105230,2001,10523,KCA,OAK,KAN06,1,4,5
KCA200105250,2001,10525,KCA,SEA,KAN06,9,6,15
KCA200105260,2001,10526,KCA,SEA,KAN06,7,2,9
KCA200105270,2001,10527,KCA,SEA,KAN06,5,4,9
KCA200105280,2001,10528,KCA,SEA,KAN06,13,3,16
KCA200106050,2001,10605,KCA,CHA,KAN06,6,2,8
KCA200106060,2001,10606,KCA,CHA,KAN06,6,12,18
KCA200106070,2001,10607,KCA,CHA,KAN06,5,1,6
KCA200106080,2001,10608,KCA,ARI,KAN06,11,4,15
KCA200106090,2001,10609,KCA,ARI,KAN06,2,3,5
KCA200106100,2001,10610,KCA,ARI,KAN06,12,5,17
KCA200106120,2001,10612,KCA,SLN,KAN06,4,7,11
KCA200106130,2001,10613,KCA,SLN,KAN06,1,4,5
KCA200106140,2001,10614,KCA,SLN,KAN06,2,3,5
KCA200106220,2001,10622,KCA,CLE,KAN06,6,5,11
KCA200106230,2001,10623,KCA,CLE,KAN06,2,3,5
KCA200106240,2001,10624,KCA,CLE,KAN06,4,2,6
KCA200106260,2001,10626,KCA,DET,KAN06,5,12,17
KCA200106270,2001,10627,KCA,DET,KAN06,4,5,9
KCA200106280,2001,10628,KCA,DET,KAN06,2,9,11
KCA200107060,2001,10706,KCA,HOU,KAN06,8,3,11
KCA200107070,2001,10707,KCA,HOU,KAN06,10,8,18
KCA200107080,2001,10708,KCA,HOU,KAN06,14,5,19
KCA200107180,2001,10718,KCA,SEA,KAN06,2,0,2
KCA200107190,2001,10719,KCA,SEA,KAN06,3,6,9
KCA200107200,2001,10720,KCA,OAK,KAN06,14,3,17
KCA200107210,2001,10721,KCA,OAK,KAN06,10,1,11
KCA200107220,2001,10722,KCA,OAK,KAN06,4,5,9
KCA200107230,2001,10723,KCA,OAK,KAN06,7,2,9
KCA200108060,2001,10806,KCA,BAL,KAN06,9,6,15
KCA200108070,2001,10807,KCA,BAL,KAN06,7,3,10
KCA200108080,2001,10808,KCA,BAL,KAN06,4,1,5
KCA200108090,2001,10809,KCA,BAL,KAN06,4,6,10
KCA200108100,2001,10810,KCA,DET,KAN06,3,7,10
KCA200108110,2001,10811,KCA,DET,KAN06,1,4,5
KCA200108120,2001,10812,KCA,DET,KAN06,4,6,10
KCA200108200,2001,10820,KCA,CHA,KAN06,1,10,11
KCA200108210,2001,10821,KCA,CHA,KAN06,6,1,7
KCA200108220,2001,10822,KCA,CHA,KAN06,13,12,25
KCA200108230,2001,10823,KCA,CHA,KAN06,7,6,13
KCA200108240,2001,10824,KCA,MIN,KAN06,9,3,12
KCA200108250,2001,10825,KCA,MIN,KAN06,7,1,8
KCA200108260,2001,10826,KCA,MIN,KAN06,7,2,9
KCA200108280,2001,10828,KCA,ANA,KAN06,4,10,14
KCA200108290,2001,10829,KCA,ANA,KAN06,3,6,9
KCA200108300,2001,10830,KCA,ANA,KAN06,1,2,3
KCA200108310,2001,10831,KCA,TEX,KAN06,7,2,9
KCA200109010,2001,10901,KCA,TEX,KAN06,7,8,15
KCA200109020,2001,10902,KCA,TEX,KAN06,12,6,18
KCA200109240,2001,10924,KCA,DET,KAN06,4,2,6
KCA200109250,2001,10925,KCA,DET,KAN06,6,4,10
KCA200109260,2001,10926,KCA,DET,KAN06,6,8,14
KCA200109270,2001,10927,KCA,DET,KAN06,7,8,15
KCA200109280,2001,10928,KCA,CHA,KAN06,2,3,5
KCA200109290,2001,10929,KCA,CHA,KAN06,10,2,12
KCA200109300,2001,10930,KCA,CHA,KAN06,5,2,7
KCA200110020,2001,11002,KCA,CLE,KAN06,1,5,6
KCA200110030,2001,11003,KCA,CLE,KAN06,4,1,5
KCA200110040,2001,11004,KCA,CLE,KAN06,4,8,12
KCA200204010,2002,20401,KCA,MIN,KAN06,8,6,14
KCA200204030,2002,20403,KCA,MIN,KAN06,1,0,1
KCA200204050,2002,20405,KCA,CHA,KAN06,2,5,7
KCA200204060,2002,20406,KCA,CHA,KAN06,14,0,14
KCA200204070,2002,20407,KCA,CHA,KAN06,2,9,11
KCA200204190,2002,20419,KCA,BOS,KAN06,4,0,4
KCA200204211,2002,20421,KCA,BOS,KAN06,12,2,14
KCA200204212,2002,20421,KCA,BOS,KAN06,8,7,15
KCA200204220,2002,20422,KCA,DET,KAN06,0,6,6
KCA200204230,2002,20423,KCA,DET,KAN06,3,0,3
KCA200204240,2002,20424,KCA,DET,KAN06,2,8,10
KCA200204260,2002,20426,KCA,BAL,KAN06,10,5,15
KCA200204270,2002,20427,KCA,BAL,KAN06,9,4,13
KCA200204280,2002,20428,KCA,BAL,KAN06,13,0,13
KCA200205090,2002,20509,KCA,CLE,KAN06,3,5,8
KCA200205100,2002,20510,KCA,CLE,KAN06,0,9,9
KCA200205120,2002,20512,KCA,CLE,KAN06,1,4,5
KCA200205130,2002,20513,KCA,MIN,KAN06,3,2,5
KCA200205140,2002,20514,KCA,MIN,KAN06,1,8,9
KCA200205150,2002,20515,KCA,MIN,KAN06,8,6,14
KCA200205160,2002,20516,KCA,MIN,KAN06,14,5,19
KCA200205250,2002,20525,KCA,TEX,KAN06,3,6,9
KCA200205261,2002,20526,KCA,TEX,KAN06,5,7,12
KCA200205262,2002,20526,KCA,TEX,KAN06,8,9,17
KCA200205280,2002,20528,KCA,ANA,KAN06,4,7,11
KCA200205290,2002,20529,KCA,ANA,KAN06,12,2,14
KCA200206070,2002,20607,KCA,SLN,KAN06,12,6,18
KCA200206080,2002,20608,KCA,SLN,KAN06,11,3,14
KCA200206090,2002,20609,KCA,SLN,KAN06,2,3,5
KCA200206100,2002,20610,KCA,FLO,KAN06,15,8,23
KCA200206110,2002,20611,KCA,FLO,KAN06,0,6,6
KCA200206120,2002,20612,KCA,FLO,KAN06,13,5,18
KCA200206250,2002,20625,KCA,DET,KAN06,6,8,14
KCA200206260,2002,20626,KCA,DET,KAN06,5,6,11
KCA200206270,2002,20627,KCA,DET,KAN06,2,5,7
KCA200206280,2002,20628,KCA,SDN,KAN06,10,14,24
KCA200206290,2002,20629,KCA,SDN,KAN06,8,4,12
KCA200206300,2002,20630,KCA,SDN,KAN06,1,13,14
KCA200207110,2002,20711,KCA,ANA,KAN06,1,0,1
KCA200207120,2002,20712,KCA,ANA,KAN06,11,3,14
KCA200207130,2002,20713,KCA,ANA,KAN06,0,4,4
KCA200207140,2002,20714,KCA,ANA,KAN06,3,12,15
KCA200207151,2002,20715,KCA,TEX,KAN06,6,8,14
KCA200207152,2002,20715,KCA,TEX,KAN06,4,6,10
KCA200207160,2002,20716,KCA,TEX,KAN06,5,6,11
KCA200207170,2002,20717,KCA,CHA,KAN06,6,8,14
KCA200207180,2002,20718,KCA,CHA,KAN06,3,5,8
KCA200207190,2002,20719,KCA,CLE,KAN06,5,8,13
KCA200207201,2002,20720,KCA,CLE,KAN06,5,7,12
KCA200207202,2002,20720,KCA,CLE,KAN06,5,3,8
KCA200207210,2002,20721,KCA,CLE,KAN06,12,13,25
KCA200207290,2002,20729,KCA,TOR,KAN06,1,4,5
KCA200207300,2002,20730,KCA,TOR,KAN06,13,4,17
KCA200207310,2002,20731,KCA,TOR,KAN06,9,2,11
KCA200208010,2002,20801,KCA,TOR,KAN06,3,2,5
KCA200208090,2002,20809,KCA,TBA,KAN06,4,5,9
KCA200208100,2002,20810,KCA,TBA,KAN06,13,6,19
KCA200208110,2002,20811,KCA,TBA,KAN06,0,10,10
KCA200208130,2002,20813,KCA,NYA,KAN06,10,5,15
KCA200208140,2002,20814,KCA,NYA,KAN06,3,2,5
KCA200208150,2002,20815,KCA,NYA,KAN06,7,5,12
KCA200208220,2002,20822,KCA,MIN,KAN06,8,6,14
KCA200208230,2002,20823,KCA,MIN,KAN06,9,2,11
KCA200208240,2002,20824,KCA,MIN,KAN06,6,5,11
KCA200208250,2002,20825,KCA,MIN,KAN06,2,4,6
KCA200208260,2002,20826,KCA,OAK,KAN06,6,3,9
KCA200208270,2002,20827,KCA,OAK,KAN06,6,4,10
KCA200208280,2002,20828,KCA,OAK,KAN06,7,1,8
KCA200209060,2002,20906,KCA,SEA,KAN06,14,7,21
KCA200209070,2002,20907,KCA,SEA,KAN06,9,2,11
KCA200209080,2002,20908,KCA,SEA,KAN06,16,9,25
KCA200209090,2002,20909,KCA,CHA,KAN06,10,6,16
KCA200209100,2002,20910,KCA,CHA,KAN06,12,4,16
KCA200209110,2002,20911,KCA,CHA,KAN06,6,9,15
KCA200209120,2002,20912,KCA,CHA,KAN06,5,1,6
KCA200209200,2002,20920,KCA,CLE,KAN06,6,2,8
KCA200209210,2002,20921,KCA,CLE,KAN06,2,3,5
KCA200209220,2002,20922,KCA,CLE,KAN06,6,5,11
KCA200209240,2002,20924,KCA,DET,KAN06,2,17,19
KCA200209250,2002,20925,KCA,DET,KAN06,7,6,13
KCA200209260,2002,20926,KCA,DET,KAN06,2,7,9
KCA200303310,2003,30331,KCA,CHA,KAN06,0,3,3
KCA200304020,2003,30402,KCA,CHA,KAN06,4,5,9
KCA200304030,2003,30403,KCA,CHA,KAN06,6,12,18
KCA200304040,2003,30404,KCA,CLE,KAN06,1,5,6
KCA200304050,2003,30405,KCA,CLE,KAN06,1,3,4
KCA200304180,2003,30418,KCA,DET,KAN06,3,4,7
KCA200304190,2003,30419,KCA,DET,KAN06,2,9,11
KCA200304200,2003,30420,KCA,DET,KAN06,3,4,7
KCA200304220,2003,30422,KCA,MIN,KAN06,3,4,7
KCA200304240,2003,30424,KCA,MIN,KAN06,1,2,3
KCA200305050,2003,30505,KCA,BOS,KAN06,6,7,13
KCA200305060,2003,30506,KCA,BOS,KAN06,7,3,10
KCA200305070,2003,30507,KCA,BOS,KAN06,9,6,15
KCA200305091,2003,30509,KCA,BAL,KAN06,15,5,20
KCA200305092,2003,30509,KCA,BAL,KAN06,5,4,9
KCA200305100,2003,30510,KCA,BAL,KAN06,4,8,12
KCA200305110,2003,30511,KCA,BAL,KAN06,5,8,13
KCA200305160,2003,30516,KCA,TOR,KAN06,18,1,19
KCA200305170,2003,30517,KCA,TOR,KAN06,7,4,11
KCA200305180,2003,30518,KCA,TOR,KAN06,4,3,7
KCA200305270,2003,30527,KCA,SEA,KAN06,15,7,22
KCA200305280,2003,30528,KCA,SEA,KAN06,5,2,7
KCA200305290,2003,30529,KCA,OAK,KAN06,6,1,7
KCA200305300,2003,30530,KCA,OAK,KAN06,6,11,17
KCA200305310,2003,30531,KCA,OAK,KAN06,7,6,13
KCA200306010,2003,30601,KCA,OAK,KAN06,6,4,10
KCA200306100,2003,30610,KCA,ARI,KAN06,3,7,10
KCA200306110,2003,30611,KCA,ARI,KAN06,4,3,7
KCA200306130,2003,30613,KCA,SFN,KAN06,1,6,7
KCA200306140,2003,30614,KCA,SFN,KAN06,7,4,11
KCA200306150,2003,30615,KCA,SFN,KAN06,4,5,9
KCA200306160,2003,30616,KCA,MIN,KAN06,8,9,17
KCA200306170,2003,30617,KCA,MIN,KAN06,7,14,21
KCA200306180,2003,30618,KCA,MIN,KAN06,6,8,14
KCA200306190,2003,30619,KCA,MIN,KAN06,16,2,18
KCA200306270,2003,30627,KCA,SLN,KAN06,3,6,9
KCA200306280,2003,30628,KCA,SLN,KAN06,13,9,22
KCA200306290,2003,30629,KCA,SLN,KAN06,13,6,19
KCA200306301,2003,30630,KCA,CLE,KAN06,10,5,15
KCA200306302,2003,30630,KCA,CLE,KAN06,8,5,13
KCA200307010,2003,30701,KCA,CLE,KAN06,3,6,9
KCA200307020,2003,30702,KCA,CLE,KAN06,2,8,10
KCA200307030,2003,30703,KCA,DET,KAN06,2,3,5
KCA200307040,2003,30704,KCA,DET,KAN06,8,9,17
KCA200307050,2003,30705,KCA,DET,KAN06,9,5,14
KCA200307060,2003,30706,KCA,DET,KAN06,3,5,8
KCA200307170,2003,30717,KCA,SEA,KAN06,1,7,8
KCA200307180,2003,30718,KCA,SEA,KAN06,6,3,9
KCA200307190,2003,30719,KCA,SEA,KAN06,1,5,6
KCA200307200,2003,30720,KCA,SEA,KAN06,5,7,12
KCA200307210,2003,30721,KCA,OAK,KAN06,6,1,7
KCA200307220,2003,30722,KCA,OAK,KAN06,10,0,10
KCA200307290,2003,30729,KCA,CHA,KAN06,9,6,15
KCA200307300,2003,30730,KCA,CHA,KAN06,15,4,19
KCA200307310,2003,30731,KCA,CHA,KAN06,8,6,14
KCA200308010,2003,30801,KCA,TBA,KAN06,9,6,15
KCA200308020,2003,30802,KCA,TBA,KAN06,8,10,18
KCA200308030,2003,30803,KCA,TBA,KAN06,0,2,2
KCA200308110,2003,30811,KCA,NYA,KAN06,9,12,21
KCA200308120,2003,30812,KCA,NYA,KAN06,6,0,6
KCA200308130,2003,30813,KCA,NYA,KAN06,0,11,11
KCA200308150,2003,30815,KCA,MIN,KAN06,9,2,11
KCA200308160,2003,30816,KCA,MIN,KAN06,14,5,19
KCA200308170,2003,30817,KCA,MIN,KAN06,4,5,9
KCA200308260,2003,30826,KCA,TEX,KAN06,2,9,11
KCA200308270,2003,30827,KCA,TEX,KAN06,0,9,9
KCA200308280,2003,30828,KCA,TEX,KAN06,5,6,11
KCA200308290,2003,30829,KCA,ANA,KAN06,10,3,13
KCA200308310,2003,30831,KCA,ANA,KAN06,7,4,11
KCA200309040,2003,30904,KCA,ARI,KAN06,6,5,11
KCA200309090,2003,30909,KCA,CLE,KAN06,7,1,8
KCA200309100,2003,30910,KCA,CLE,KAN06,7,9,16
KCA200309110,2003,30911,KCA,CLE,KAN06,6,5,11
KCA200309220,2003,30922,KCA,DET,KAN06,6,12,18
KCA200309230,2003,30923,KCA,DET,KAN06,15,6,21
KCA200309240,2003,30924,KCA,DET,KAN06,4,3,7
KCA200309250,2003,30925,KCA,CHA,KAN06,3,7,10
KCA200309260,2003,30926,KCA,CHA,KAN06,11,2,13
KCA200309270,2003,30927,KCA,CHA,KAN06,19,3,22
KCA200309280,2003,30928,KCA,CHA,KAN06,5,1,6
KCA200404050,2004,40405,KCA,CHA,KAN06,7,9,16
KCA200404070,2004,40407,KCA,CHA,KAN06,4,3,7
KCA200404080,2004,40408,KCA,CLE,KAN06,6,1,7
KCA200404090,2004,40409,KCA,CLE,KAN06,1,3,4
KCA200404100,2004,40410,KCA,CLE,KAN06,6,7,13
KCA200404110,2004,40411,KCA,CLE,KAN06,3,5,8
KCA200404230,2004,40423,KCA,MIN,KAN06,7,5,12
KCA200404240,2004,40424,KCA,MIN,KAN06,1,10,11
KCA200404250,2004,40425,KCA,MIN,KAN06,4,2,6
KCA200404270,2004,40427,KCA,TEX,KAN06,3,2,5
KCA200404280,2004,40428,KCA,TEX,KAN06,3,5,8
KCA200404290,2004,40429,KCA,TEX,KAN06,9,7,16
KCA200405100,2004,40510,KCA,TOR,KAN06,9,3,12
KCA200405110,2004,40511,KCA,TOR,KAN06,1,5,6
KCA200405120,2004,40512,KCA,TOR,KAN06,3,4,7
KCA200405140,2004,40514,KCA,OAK,KAN06,6,2,8
KCA200405150,2004,40515,KCA,OAK,KAN06,3,1,4
KCA200405160,2004,40516,KCA,OAK,KAN06,6,2,8
KCA200405250,2004,40525,KCA,DET,KAN06,3,4,7
KCA200405260,2004,40526,KCA,DET,KAN06,3,7,10
KCA200405270,2004,40527,KCA,DET,KAN06,17,7,24
KCA200405280,2004,40528,KCA,MIN,KAN06,1,2,3
KCA200405290,2004,40529,KCA,MIN,KAN06,2,5,7
KCA200405300,2004,40530,KCA,MIN,KAN06,8,3,11
KCA200406040,2004,40604,KCA,BOS,KAN06,2,5,7
KCA200406050,2004,40605,KCA,BOS,KAN06,8,4,12
KCA200406060,2004,40606,KCA,BOS,KAN06,5,3,8
KCA200406080,2004,40608,KCA,MON,KAN06,2,4,6
KCA200406101,2004,40610,KCA,MON,KAN06,8,0,8
KCA200406102,2004,40610,KCA,MON,KAN06,7,2,9
KCA200406110,2004,40611,KCA,NYN,KAN06,5,7,12
KCA200406120,2004,40612,KCA,NYN,KAN06,3,4,7
KCA200406130,2004,40613,KCA,NYN,KAN06,5,2,7
KCA200406220,2004,40622,KCA,DET,KAN06,1,8,9
KCA200406230,2004,40623,KCA,DET,KAN06,3,7,10
KCA200406240,2004,40624,KCA,DET,KAN06,12,3,15
KCA200406250,2004,40625,KCA,SLN,KAN06,5,2,7
KCA200406260,2004,40626,KCA,SLN,KAN06,3,1,4
KCA200406270,2004,40627,KCA,SLN,KAN06,10,3,13
KCA200406280,2004,40628,KCA,BAL,KAN06,10,1,11
KCA200406290,2004,40629,KCA,BAL,KAN06,3,4,7
KCA200406300,2004,40630,KCA,BAL,KAN06,13,4,17
KCA200407010,2004,40701,KCA,BAL,KAN06,3,2,5
KCA200407150,2004,40715,KCA,MIN,KAN06,1,3,4
KCA200407160,2004,40716,KCA,MIN,KAN06,3,12,15
KCA200407170,2004,40717,KCA,MIN,KAN06,4,1,5
KCA200407180,2004,40718,KCA,MIN,KAN06,3,4,7
KCA200407190,2004,40719,KCA,BAL,KAN06,7,4,11
KCA200407200,2004,40720,KCA,BAL,KAN06,12,3,15
KCA200407300,2004,40730,KCA,CLE,KAN06,7,6,13
KCA200407310,2004,40731,KCA,CLE,KAN06,3,10,13
KCA200408010,2004,40801,KCA,CLE,KAN06,7,8,15
KCA200408030,2004,40803,KCA,CHA,KAN06,12,4,16
KCA200408040,2004,40804,KCA,CHA,KAN06,0,11,11
KCA200408050,2004,40805,KCA,CHA,KAN06,4,6,10
KCA200408060,2004,40806,KCA,ANA,KAN06,3,0,3
KCA200408070,2004,40807,KCA,ANA,KAN06,7,5,12
KCA200408080,2004,40808,KCA,ANA,KAN06,6,4,10
KCA200408090,2004,40809,KCA,ANA,KAN06,5,3,8
KCA200408170,2004,40817,KCA,SEA,KAN06,16,3,19
KCA200408180,2004,40818,KCA,SEA,KAN06,2,3,5
KCA200408200,2004,40820,KCA,TEX,KAN06,5,3,8
KCA200408210,2004,40821,KCA,TEX,KAN06,5,3,8
KCA200408220,2004,40822,KCA,TEX,KAN06,2,10,12
KCA200408300,2004,40830,KCA,DET,KAN06,9,1,10
KCA200408310,2004,40831,KCA,DET,KAN06,8,9,17
KCA200409010,2004,40901,KCA,DET,KAN06,0,1,1
KCA200409100,2004,40910,KCA,TBA,KAN06,5,8,13
KCA200409110,2004,40911,KCA,TBA,KAN06,8,6,14
KCA200409120,2004,40912,KCA,TBA,KAN06,7,2,9
KCA200409130,2004,40913,KCA,NYA,KAN06,8,17,25
KCA200409140,2004,40914,KCA,NYA,KAN06,4,0,4
KCA200409150,2004,40915,KCA,NYA,KAN06,3,0,3
KCA200409270,2004,40927,KCA,CLE,KAN06,6,1,7
KCA200409280,2004,40928,KCA,CLE,KAN06,5,1,6
KCA200409290,2004,40929,KCA,CLE,KAN06,5,2,7
KCA200409300,2004,40930,KCA,CHA,KAN06,9,2,11
KCA200410010,2004,41001,KCA,CHA,KAN06,4,2,6
KCA200410020,2004,41002,KCA,CHA,KAN06,2,10,12
KCA200410030,2004,41003,KCA,CHA,KAN06,5,0,5
KCA200504110,2005,50411,KCA,SEA,KAN06,8,2,10
KCA200504130,2005,50413,KCA,SEA,KAN06,2,1,3
KCA200504140,2005,50414,KCA,SEA,KAN06,10,2,12
KCA200504150,2005,50415,KCA,DET,KAN06,5,6,11
KCA200504160,2005,50416,KCA,DET,KAN06,7,1,8
KCA200504170,2005,50417,KCA,DET,KAN06,6,1,7
KCA200504180,2005,50418,KCA,CLE,KAN06,5,1,6
KCA200504190,2005,50419,KCA,CLE,KAN06,5,6,11
KCA200504220,2005,50422,KCA,CHA,KAN06,8,2,10
KCA200504230,2005,50423,KCA,CHA,KAN06,3,2,5
KCA200504240,2005,50424,KCA,CHA,KAN06,4,3,7
KCA200504260,2005,50426,KCA,MIN,KAN06,2,1,3
KCA200504270,2005,50427,KCA,MIN,KAN06,9,4,13
KCA200504280,2005,50428,KCA,MIN,KAN06,6,5,11
KCA200505120,2005,50512,KCA,TBA,KAN06,5,7,12
KCA200505130,2005,50513,KCA,TBA,KAN06,3,2,5
KCA200505140,2005,50514,KCA,TBA,KAN06,5,6,11
KCA200505150,2005,50515,KCA,TBA,KAN06,3,4,7
KCA200505170,2005,50517,KCA,BAL,KAN06,12,8,20
KCA200505180,2005,50518,KCA,BAL,KAN06,7,4,11
KCA200505190,2005,50519,KCA,BAL,KAN06,4,7,11
KCA200505200,2005,50520,KCA,SLN,KAN06,7,6,13
KCA200505210,2005,50521,KCA,SLN,KAN06,6,5,11
KCA200505220,2005,50522,KCA,SLN,KAN06,2,9,11
KCA200505310,2005,50531,KCA,NYA,KAN06,3,5,8
KCA200506010,2005,50601,KCA,NYA,KAN06,1,3,4
KCA200506020,2005,50602,KCA,NYA,KAN06,2,5,7
KCA200506030,2005,50603,KCA,TEX,KAN06,1,2,3
KCA200506040,2005,50604,KCA,TEX,KAN06,14,9,23
KCA200506050,2005,50605,KCA,TEX,KAN06,8,1,9
KCA200506140,2005,50614,KCA,LAN,KAN06,2,3,5
KCA200506150,2005,50615,KCA,LAN,KAN06,1,3,4
KCA200506160,2005,50616,KCA,LAN,KAN06,6,9,15
KCA200506170,2005,50617,KCA,HOU,KAN06,7,0,7
KCA200506180,2005,50618,KCA,HOU,KAN06,6,2,8
KCA200506190,2005,50619,KCA,HOU,KAN06,1,7,8
KCA200507010,2005,50701,KCA,ANA,KAN06,5,0,5
KCA200507020,2005,50702,KCA,ANA,KAN06,5,3,8
KCA200507030,2005,50703,KCA,ANA,KAN06,5,0,5
KCA200507040,2005,50704,KCA,SEA,KAN06,6,0,6
KCA200507050,2005,50705,KCA,SEA,KAN06,6,8,14
KCA200507060,2005,50706,KCA,SEA,KAN06,1,5,6
KCA200507070,2005,50707,KCA,MIN,KAN06,5,8,13
KCA200507080,2005,50708,KCA,MIN,KAN06,5,4,9
KCA200507090,2005,50709,KCA,MIN,KAN06,8,12,20
KCA200507100,2005,50710,KCA,MIN,KAN06,3,2,5
KCA200507220,2005,50722,KCA,TOR,KAN06,3,5,8
KCA200507230,2005,50723,KCA,TOR,KAN06,9,4,13
KCA200507240,2005,50724,KCA,TOR,KAN06,5,6,11
KCA200507250,2005,50725,KCA,CHA,KAN06,14,6,20
KCA200507260,2005,50726,KCA,CHA,KAN06,1,7,8
KCA200507270,2005,50727,KCA,CHA,KAN06,5,6,11
KCA200508050,2005,50805,KCA,OAK,KAN06,5,4,9
KCA200508060,2005,50806,KCA,OAK,KAN06,16,1,17
KCA200508070,2005,50807,KCA,OAK,KAN06,11,0,11
KCA200508090,2005,50809,KCA,CLE,KAN06,13,7,20
KCA200508100,2005,50810,KCA,CLE,KAN06,6,1,7
KCA200508110,2005,50811,KCA,CLE,KAN06,4,2,6
KCA200508141,2005,50814,KCA,DET,KAN06,8,7,15
KCA200508142,2005,50814,KCA,DET,KAN06,1,0,1
KCA200508230,2005,50823,KCA,BOS,KAN06,5,2,7
KCA200508240,2005,50824,KCA,BOS,KAN06,3,4,7
KCA200508250,2005,50825,KCA,BOS,KAN06,4,7,11
KCA200508290,2005,50829,KCA,MIN,KAN06,3,1,4
KCA200508300,2005,50830,KCA,MIN,KAN06,7,4,11
KCA200508310,2005,50831,KCA,MIN,KAN06,0,1,1
KCA200509010,2005,50901,KCA,TEX,KAN06,5,4,9
KCA200509020,2005,50902,KCA,TEX,KAN06,8,7,15
KCA200509030,2005,50903,KCA,TEX,KAN06,5,3,8
KCA200509040,2005,50904,KCA,TEX,KAN06,8,17,25
KCA200509130,2005,50913,KCA,CHA,KAN06,6,4,10
KCA200509140,2005,50914,KCA,CHA,KAN06,9,10,19
KCA200509150,2005,50915,KCA,CHA,KAN06,5,7,12
KCA200509190,2005,50919,KCA,DET,KAN06,4,10,14
KCA200509201,2005,50920,KCA,DET,KAN06,4,5,9
KCA200509202,2005,50920,KCA,DET,KAN06,2,4,6
KCA200509210,2005,50921,KCA,DET,KAN06,3,4,7
KCA200509220,2005,50922,KCA,CLE,KAN06,11,6,17
KCA200509230,2005,50923,KCA,CLE,KAN06,7,6,13
KCA200509240,2005,50924,KCA,CLE,KAN06,11,4,15
KCA200509250,2005,50925,KCA,CLE,KAN06,4,5,9
KCA200604030,2006,60403,KCA,DET,KAN06,3,1,4
KCA200604050,2006,60405,KCA,DET,KAN06,14,3,17
KCA200604070,2006,60407,KCA,CHA,KAN06,7,11,18
KCA200604080,2006,60408,KCA,CHA,KAN06,3,4,7
KCA200604090,2006,60409,KCA,CHA,KAN06,3,1,4
KCA200604210,2006,60421,KCA,CLE,KAN06,6,5,11
KCA200604220,2006,60422,KCA,CLE,KAN06,5,11,16
KCA200604230,2006,60423,KCA,CLE,KAN06,1,5,6
KCA200604250,2006,60425,KCA,MIN,KAN06,2,1,3
KCA200604260,2006,60426,KCA,MIN,KAN06,1,3,4
KCA200604270,2006,60427,KCA,MIN,KAN06,7,3,10
KCA200604280,2006,60428,KCA,OAK,KAN06,5,3,8
KCA200604300,2006,60430,KCA,OAK,KAN06,13,6,19
KCA200605080,2006,60508,KCA,CLE,KAN06,3,4,7
KCA200605090,2006,60509,KCA,CLE,KAN06,7,10,17
KCA200605100,2006,60510,KCA,CLE,KAN06,8,10,18
KCA200605190,2006,60519,KCA,SLN,KAN06,9,6,15
KCA200605200,2006,60520,KCA,SLN,KAN06,4,2,6
KCA200605210,2006,60521,KCA,SLN,KAN06,10,3,13
KCA200605220,2006,60522,KCA,DET,KAN06,8,0,8
KCA200605230,2006,60523,KCA,DET,KAN06,8,5,13
KCA200605240,2006,60524,KCA,DET,KAN06,6,3,9
KCA200605250,2006,60525,KCA,DET,KAN06,13,8,21
KCA200606060,2006,60606,KCA,TEX,KAN06,6,2,8
KCA200606070,2006,60607,KCA,TEX,KAN06,4,2,6
KCA200606080,2006,60608,KCA,TEX,KAN06,12,16,28
KCA200606090,2006,60609,KCA,TBA,KAN06,2,4,6
KCA200606100,2006,60610,KCA,TBA,KAN06,9,5,14
KCA200606110,2006,60611,KCA,TBA,KAN06,8,2,10
KCA200606200,2006,60620,KCA,PIT,KAN06,6,10,16
KCA200606210,2006,60621,KCA,PIT,KAN06,4,6,10
KCA200606220,2006,60622,KCA,PIT,KAN06,7,15,22
KCA200606230,2006,60623,KCA,MIL,KAN06,7,2,9
KCA200606240,2006,60624,KCA,MIL,KAN06,5,6,11
KCA200606250,2006,60625,KCA,MIL,KAN06,0,6,6
KCA200607030,2006,60703,KCA,MIN,KAN06,6,5,11
KCA200607040,2006,60704,KCA,MIN,KAN06,2,7,9
KCA200607050,2006,60705,KCA,MIN,KAN06,3,6,9
KCA200607060,2006,60706,KCA,TOR,KAN06,2,6,8
KCA200607070,2006,60707,KCA,TOR,KAN06,3,13,16
KCA200607080,2006,60708,KCA,TOR,KAN06,7,5,12
KCA200607090,2006,60709,KCA,TOR,KAN06,11,3,14
KCA200607200,2006,60720,KCA,ANA,KAN06,4,9,13
KCA200607210,2006,60721,KCA,ANA,KAN06,3,8,11
KCA200607220,2006,60722,KCA,ANA,KAN06,4,3,7
KCA200607230,2006,60723,KCA,ANA,KAN06,3,1,4
KCA200607250,2006,60725,KCA,BAL,KAN06,5,7,12
KCA200607260,2006,60726,KCA,BAL,KAN06,4,3,7
KCA200607270,2006,60727,KCA,BAL,KAN06,6,4,10
KCA200607310,2006,60731,KCA,CHA,KAN06,8,4,12
KCA200608010,2006,60801,KCA,CHA,KAN06,7,5,12
KCA200608020,2006,60802,KCA,CHA,KAN06,3,7,10
KCA200608030,2006,60803,KCA,MIN,KAN06,8,2,10
KCA200608040,2006,60804,KCA,MIN,KAN06,8,5,13
KCA200608050,2006,60805,KCA,MIN,KAN06,14,3,17
KCA200608060,2006,60806,KCA,MIN,KAN06,11,5,16
KCA200608080,2006,60808,KCA,BOS,KAN06,4,6,10
KCA200608090,2006,60809,KCA,BOS,KAN06,4,5,9
KCA200608100,2006,60810,KCA,BOS,KAN06,4,5,9
KCA200608181,2006,60818,KCA,OAK,KAN06,1,7,8
KCA200608182,2006,60818,KCA,OAK,KAN06,3,5,8
KCA200608190,2006,60819,KCA,OAK,KAN06,7,2,9
KCA200608200,2006,60820,KCA,OAK,KAN06,6,4,10
KCA200608220,2006,60822,KCA,CLE,KAN06,2,5,7
KCA200608230,2006,60823,KCA,CLE,KAN06,15,13,28
KCA200608240,2006,60824,KCA,CLE,KAN06,8,4,12
KCA200609010,2006,60901,KCA,CHA,KAN06,5,7,12
KCA200609020,2006,60902,KCA,CHA,KAN06,5,3,8
KCA200609030,2006,60903,KCA,CHA,KAN06,3,7,10
KCA200609040,2006,60904,KCA,NYA,KAN06,12,5,17
KCA200609050,2006,60905,KCA,NYA,KAN06,0,5,5
KCA200609060,2006,60906,KCA,NYA,KAN06,8,3,11
KCA200609140,2006,60914,KCA,SEA,KAN06,8,10,18
KCA200609150,2006,60915,KCA,SEA,KAN06,11,8,19
KCA200609160,2006,60916,KCA,SEA,KAN06,4,7,11
KCA200609170,2006,60917,KCA,SEA,KAN06,10,5,15
KCA200609190,2006,60919,KCA,ANA,KAN06,5,2,7
KCA200609200,2006,60920,KCA,ANA,KAN06,3,0,3
KCA200609220,2006,60922,KCA,DET,KAN06,7,3,10
KCA200609230,2006,60923,KCA,DET,KAN06,15,4,19
KCA200609240,2006,60924,KCA,DET,KAN06,11,4,15
KCA200704020,2007,70402,KCA,BOS,KAN06,1,7,8
KCA200704040,2007,70404,KCA,BOS,KAN06,7,1,8
KCA200704050,2007,70405,KCA,BOS,KAN06,4,1,5
KCA200704060,2007,70406,KCA,DET,KAN06,1,3,4
KCA200704070,2007,70407,KCA,DET,KAN06,6,5,11
KCA200704080,2007,70408,KCA,DET,KAN06,3,2,5
KCA200704200,2007,70420,KCA,MIN,KAN06,7,11,18
KCA200704210,2007,70421,KCA,MIN,KAN06,7,5,12
KCA200704220,2007,70422,KCA,MIN,KAN06,1,3,4
KCA200704230,2007,70423,KCA,CHA,KAN06,7,4,11
KCA200704240,2007,70424,KCA,CHA,KAN06,9,7,16
KCA200704300,2007,70430,KCA,ANA,KAN06,3,1,4
KCA200705010,2007,70501,KCA,ANA,KAN06,7,5,12
KCA200705020,2007,70502,KCA,ANA,KAN06,1,3,4
KCA200705030,2007,70503,KCA,ANA,KAN06,2,5,7
KCA200705040,2007,70504,KCA,DET,KAN06,6,3,9
KCA200705050,2007,70505,KCA,DET,KAN06,7,5,12
KCA200705060,2007,70506,KCA,DET,KAN06,13,4,17
KCA200705080,2007,70508,KCA,OAK,KAN06,6,1,7
KCA200705090,2007,70509,KCA,OAK,KAN06,2,3,5
KCA200705100,2007,70510,KCA,OAK,KAN06,17,3,20
KCA200705220,2007,70522,KCA,CLE,KAN06,3,4,7
KCA200705230,2007,70523,KCA,CLE,KAN06,7,11,18
KCA200705240,2007,70524,KCA,CLE,KAN06,10,3,13
KCA200705250,2007,70525,KCA,SEA,KAN06,10,2,12
KCA200705260,2007,70526,KCA,SEA,KAN06,9,1,10
KCA200705270,2007,70527,KCA,SEA,KAN06,7,4,11
KCA200705280,2007,70528,KCA,BAL,KAN06,9,1,10
KCA200705290,2007,70529,KCA,BAL,KAN06,6,2,8
KCA200705300,2007,70530,KCA,BAL,KAN06,3,0,3
KCA200706080,2007,70608,KCA,PHI,KAN06,4,8,12
KCA200706090,2007,70609,KCA,PHI,KAN06,4,0,4
KCA200706100,2007,70610,KCA,PHI,KAN06,5,17,22
KCA200706120,2007,70612,KCA,SLN,KAN06,1,8,9
KCA200706130,2007,70613,KCA,SLN,KAN06,7,3,10
KCA200706140,2007,70614,KCA,SLN,KAN06,8,17,25
KCA200706150,2007,70615,KCA,FLO,KAN06,2,6,8
KCA200706160,2007,70616,KCA,FLO,KAN06,9,8,17
KCA200706170,2007,70617,KCA,FLO,KAN06,4,5,9
KCA200706290,2007,70629,KCA,CHA,KAN06,1,8,9
KCA200706300,2007,70630,KCA,CHA,KAN06,3,1,4
KCA200707010,2007,70701,KCA,CHA,KAN06,3,1,4
KCA200707020,2007,70702,KCA,SEA,KAN06,2,3,5
KCA200707030,2007,70703,KCA,SEA,KAN06,3,17,20
KCA200707040,2007,70704,KCA,SEA,KAN06,4,0,4
KCA200707060,2007,70706,KCA,TBA,KAN06,6,5,11
KCA200707070,2007,70707,KCA,TBA,KAN06,7,8,15
KCA200707080,2007,70708,KCA,TBA,KAN06,4,12,16
KCA200707230,2007,70723,KCA,NYA,KAN06,9,2,11
KCA200707240,2007,70724,KCA,NYA,KAN06,9,4,13
KCA200707250,2007,70725,KCA,NYA,KAN06,7,1,8
KCA200707260,2007,70726,KCA,NYA,KAN06,0,7,7
KCA200707270,2007,70727,KCA,TEX,KAN06,1,6,7
KCA200707280,2007,70728,KCA,TEX,KAN06,5,6,11
KCA200707290,2007,70729,KCA,TEX,KAN06,0,10,10
KCA200708070,2007,70807,KCA,MIN,KAN06,1,5,6
KCA200708080,2007,70808,KCA,MIN,KAN06,11,4,15
KCA200708090,2007,70809,KCA,MIN,KAN06,0,1,1
KCA200708100,2007,70810,KCA,TOR,KAN06,2,1,3
KCA200708110,2007,70811,KCA,TOR,KAN06,1,4,5
KCA200708120,2007,70812,KCA,TOR,KAN06,4,1,5
KCA200708130,2007,70813,KCA,TOR,KAN06,2,6,8
KCA200708240,2007,70824,KCA,CLE,KAN06,1,2,3
KCA200708250,2007,70825,KCA,CLE,KAN06,9,4,13
KCA200708260,2007,70826,KCA,CLE,KAN06,5,3,8
KCA200708280,2007,70828,KCA,DET,KAN06,3,6,9
KCA200708290,2007,70829,KCA,DET,KAN06,0,5,5
KCA200708300,2007,70830,KCA,DET,KAN06,6,1,7
KCA200709070,2007,70907,KCA,NYA,KAN06,3,2,5
KCA200709080,2007,70908,KCA,NYA,KAN06,11,5,16
KCA200709090,2007,70909,KCA,NYA,KAN06,6,3,9
KCA200709100,2007,70910,KCA,MIN,KAN06,4,2,6
KCA200709110,2007,70911,KCA,MIN,KAN06,6,3,9
KCA200709120,2007,70912,KCA,MIN,KAN06,3,6,9
KCA200709170,2007,70917,KCA,CHA,KAN06,11,3,14
KCA200709180,2007,70918,KCA,CHA,KAN06,2,3,5
KCA200709190,2007,70919,KCA,CHA,KAN06,7,0,7
KCA200709200,2007,70920,KCA,CHA,KAN06,0,3,3
KCA200709280,2007,70928,KCA,CLE,KAN06,5,3,8
KCA200709290,2007,70929,KCA,CLE,KAN06,3,4,7
KCA200709300,2007,70930,KCA,CLE,KAN06,4,2,6
KCA200804080,2008,80408,KCA,NYA,KAN06,2,5,7
KCA200804090,2008,80409,KCA,NYA,KAN06,0,4,4
KCA200804100,2008,80410,KCA,NYA,KAN06,6,1,7
KCA200804110,2008,80411,KCA,MIN,KAN06,5,0,5
KCA200804120,2008,80412,KCA,MIN,KAN06,2,0,2
KCA200804130,2008,80413,KCA,MIN,KAN06,1,5,6
KCA200804220,2008,80422,KCA,CLE,KAN06,15,1,16
KCA200804241,2008,80424,KCA,CLE,KAN06,9,6,15
KCA200804242,2008,80424,KCA,CLE,KAN06,2,0,2
KCA200804250,2008,80425,KCA,TOR,KAN06,4,8,12
KCA200804260,2008,80426,KCA,TOR,KAN06,1,2,3
KCA200804270,2008,80427,KCA,TOR,KAN06,5,2,7
KCA200805050,2008,80505,KCA,ANA,KAN06,4,0,4
KCA200805060,2008,80506,KCA,ANA,KAN06,5,3,8
KCA200805070,2008,80507,KCA,ANA,KAN06,4,9,13
KCA200805080,2008,80508,KCA,BAL,KAN06,4,1,5
KCA200805090,2008,80509,KCA,BAL,KAN06,7,4,11
KCA200805100,2008,80510,KCA,BAL,KAN06,6,5,11
KCA200805110,2008,80511,KCA,BAL,KAN06,0,4,4
KCA200805130,2008,80513,KCA,DET,KAN06,2,3,5
KCA200805140,2008,80514,KCA,DET,KAN06,0,2,2
KCA200805150,2008,80515,KCA,DET,KAN06,4,8,12
KCA200805270,2008,80527,KCA,MIN,KAN06,4,3,7
KCA200805280,2008,80528,KCA,MIN,KAN06,9,8,17
KCA200805290,2008,80529,KCA,MIN,KAN06,5,1,6
KCA200805300,2008,80530,KCA,CLE,KAN06,5,4,9
KCA200805310,2008,80531,KCA,CLE,KAN06,2,4,6
KCA200806010,2008,80601,KCA,CLE,KAN06,1,6,7
KCA200806100,2008,80610,KCA,TEX,KAN06,6,5,11
KCA200806110,2008,80611,KCA,TEX,KAN06,11,5,16
KCA200806120,2008,80612,KCA,TEX,KAN06,5,6,11
KCA200806200,2008,80620,KCA,SFN,KAN06,9,4,13
KCA200806210,2008,80621,KCA,SFN,KAN06,3,5,8
KCA200806220,2008,80622,KCA,SFN,KAN06,10,11,21
KCA200806230,2008,80623,KCA,COL,KAN06,4,8,12
KCA200806240,2008,80624,KCA,COL,KAN06,3,7,10
KCA200806250,2008,80625,KCA,COL,KAN06,2,4,6
KCA200806270,2008,80627,KCA,SLN,KAN06,2,7,9
KCA200806280,2008,80628,KCA,SLN,KAN06,5,1,6
KCA200806290,2008,80629,KCA,SLN,KAN06,9,6,15
KCA200807080,2008,80708,KCA,CHA,KAN06,8,7,15
KCA200807090,2008,80709,KCA,CHA,KAN06,7,6,13
KCA200807100,2008,80710,KCA,CHA,KAN06,1,4,5
KCA200807110,2008,80711,KCA,SEA,KAN06,1,3,4
KCA200807120,2008,80712,KCA,SEA,KAN06,4,5,9
KCA200807130,2008,80713,KCA,SEA,KAN06,4,3,7
KCA200807210,2008,80721,KCA,DET,KAN06,19,4,23
KCA200807220,2008,80722,KCA,DET,KAN06,7,1,8
KCA200807230,2008,80723,KCA,DET,KAN06,7,1,8
KCA200807240,2008,80724,KCA,TBA,KAN06,2,4,6
KCA200807250,2008,80725,KCA,TBA,KAN06,5,3,8
KCA200807260,2008,80726,KCA,TBA,KAN06,5,3,8
KCA200807270,2008,80727,KCA,TBA,KAN06,1,6,7
KCA200808010,2008,80801,KCA,CHA,KAN06,4,2,6
KCA200808020,2008,80802,KCA,CHA,KAN06,7,9,16
KCA200808030,2008,80803,KCA,CHA,KAN06,3,14,17
KCA200808040,2008,80804,KCA,BOS,KAN06,3,4,7
KCA200808050,2008,80805,KCA,BOS,KAN06,8,2,10
KCA200808060,2008,80806,KCA,BOS,KAN06,8,2,10
KCA200808080,2008,80808,KCA,MIN,KAN06,4,1,5
KCA200808090,2008,80809,KCA,MIN,KAN06,7,3,10
KCA200808100,2008,80810,KCA,MIN,KAN06,4,5,9
KCA200808220,2008,80822,KCA,DET,KAN06,4,3,7
KCA200808230,2008,80823,KCA,DET,KAN06,4,0,4
KCA200808240,2008,80824,KCA,DET,KAN06,3,7,10
KCA200808250,2008,80825,KCA,TEX,KAN06,9,4,13
KCA200808260,2008,80826,KCA,TEX,KAN06,2,1,3
KCA200808270,2008,80827,KCA,TEX,KAN06,3,2,5
KCA200809020,2008,80902,KCA,OAK,KAN06,2,5,7
KCA200809041,2008,80904,KCA,OAK,KAN06,4,5,9
KCA200809042,2008,80904,KCA,OAK,KAN06,6,9,15
KCA200809050,2008,80905,KCA,CLE,KAN06,9,3,12
KCA200809060,2008,80906,KCA,CLE,KAN06,1,3,4
KCA200809070,2008,80907,KCA,CLE,KAN06,3,1,4
KCA200809150,2008,80915,KCA,SEA,KAN06,0,3,3
KCA200809160,2008,80916,KCA,SEA,KAN06,3,6,9
KCA200809170,2008,80917,KCA,SEA,KAN06,2,5,7
KCA200809180,2008,80918,KCA,SEA,KAN06,0,12,12
KCA200809190,2008,80919,KCA,CHA,KAN06,9,4,13
KCA200809200,2008,80920,KCA,CHA,KAN06,2,5,7
KCA200809210,2008,80921,KCA,CHA,KAN06,3,0,3
KCA200904100,2009,90410,KCA,NYA,KAN06,4,1,5
KCA200904110,2009,90411,KCA,NYA,KAN06,6,1,7
KCA200904120,2009,90412,KCA,NYA,KAN06,4,6,10
KCA200904130,2009,90413,KCA,CLE,KAN06,2,4,6
KCA200904140,2009,90414,KCA,CLE,KAN06,3,9,12
KCA200904150,2009,90415,KCA,CLE,KAN06,5,4,9
KCA200904240,2009,90424,KCA,DET,KAN06,1,6,7
KCA200904250,2009,90425,KCA,DET,KAN06,9,1,10
KCA200904260,2009,90426,KCA,DET,KAN06,3,2,5
KCA200904270,2009,90427,KCA,TOR,KAN06,1,7,8
KCA200904280,2009,90428,KCA,TOR,KAN06,8,1,9
KCA200904290,2009,90429,KCA,TOR,KAN06,3,11,14
KCA200904300,2009,90430,KCA,TOR,KAN06,6,8,14
KCA200905040,2009,90504,KCA,CHA,KAN06,0,3,3
KCA200905050,2009,90505,KCA,CHA,KAN06,7,8,15
KCA200905060,2009,90506,KCA,SEA,KAN06,1,9,10
KCA200905070,2009,90507,KCA,SEA,KAN06,1,3,4
KCA200905140,2009,90514,KCA,BAL,KAN06,9,5,14
KCA200905150,2009,90515,KCA,BAL,KAN06,1,8,9
KCA200905160,2009,90516,KCA,BAL,KAN06,3,2,5
KCA200905170,2009,90517,KCA,BAL,KAN06,4,7,11
KCA200905190,2009,90519,KCA,CLE,KAN06,5,6,11
KCA200905200,2009,90520,KCA,CLE,KAN06,6,5,11
KCA200905210,2009,90521,KCA,CLE,KAN06,8,3,11
KCA200905250,2009,90525,KCA,DET,KAN06,13,1,14
KCA200905260,2009,90526,KCA,DET,KAN06,1,6,7
KCA200905270,2009,90527,KCA,DET,KAN06,8,3,11
KCA200905290,2009,90529,KCA,CHA,KAN06,11,2,13
KCA200905300,2009,90530,KCA,CHA,KAN06,5,3,8
KCA200905310,2009,90531,KCA,CHA,KAN06,7,4,11
KCA200906120,2009,90612,KCA,CIN,KAN06,1,4,5
KCA200906130,2009,90613,KCA,CIN,KAN06,4,7,11
KCA200906140,2009,90614,KCA,CIN,KAN06,1,7,8
KCA200906160,2009,90616,KCA,ARI,KAN06,0,5,5
KCA200906170,2009,90617,KCA,ARI,KAN06,12,5,17
KCA200906180,2009,90618,KCA,ARI,KAN06,12,5,17
KCA200906190,2009,90619,KCA,SLN,KAN06,10,5,15
KCA200906200,2009,90620,KCA,SLN,KAN06,7,1,8
KCA200906210,2009,90621,KCA,SLN,KAN06,12,5,17
KCA200906290,2009,90629,KCA,MIN,KAN06,2,4,6
KCA200906300,2009,90630,KCA,MIN,KAN06,2,1,3
KCA200907010,2009,90701,KCA,MIN,KAN06,5,1,6
KCA200907020,2009,90702,KCA,CHA,KAN06,4,1,5
KCA200907030,2009,90703,KCA,CHA,KAN06,5,0,5
KCA200907040,2009,90704,KCA,CHA,KAN06,4,6,10
KCA200907050,2009,90705,KCA,CHA,KAN06,3,6,9
KCA200907170,2009,90717,KCA,TBA,KAN06,8,7,15
KCA200907180,2009,90718,KCA,TBA,KAN06,4,2,6
KCA200907190,2009,90719,KCA,TBA,KAN06,4,3,7
KCA200907211,2009,90721,KCA,ANA,KAN06,8,5,13
KCA200907212,2009,90721,KCA,ANA,KAN06,10,2,12
KCA200907220,2009,90722,KCA,ANA,KAN06,9,6,15
KCA200907240,2009,90724,KCA,TEX,KAN06,2,0,2
KCA200907250,2009,90725,KCA,TEX,KAN06,3,6,9
KCA200907260,2009,90726,KCA,TEX,KAN06,7,2,9
KCA200908040,2009,90804,KCA,SEA,KAN06,7,6,13
KCA200908050,2009,90805,KCA,SEA,KAN06,11,6,17
KCA200908060,2009,90806,KCA,SEA,KAN06,2,8,10
KCA200908070,2009,90807,KCA,OAK,KAN06,9,4,13
KCA200908080,2009,90808,KCA,OAK,KAN06,6,12,18
KCA200908090,2009,90809,KCA,OAK,KAN06,6,3,9
KCA200908210,2009,90821,KCA,MIN,KAN06,5,4,9
KCA200908220,2009,90822,KCA,MIN,KAN06,8,7,15
KCA200908230,2009,90823,KCA,MIN,KAN06,10,3,13
KCA200908240,2009,90824,KCA,CLE,KAN06,10,6,16
KCA200908250,2009,90825,KCA,CLE,KAN06,2,6,8
KCA200908260,2009,90826,KCA,CLE,KAN06,4,2,6
KCA200909040,2009,90904,KCA,ANA,KAN06,2,1,3
KCA200909050,2009,90905,KCA,ANA,KAN06,2,1,3
KCA200909060,2009,90906,KCA,ANA,KAN06,7,2,9
KCA200909070,2009,90907,KCA,ANA,KAN06,3,6,9
KCA200909080,2009,90908,KCA,DET,KAN06,5,7,12
KCA200909090,2009,90909,KCA,DET,KAN06,1,5,6
KCA200909100,2009,90910,KCA,DET,KAN06,4,7,11
KCA200909210,2009,90921,KCA,BOS,KAN06,9,12,21
KCA200909220,2009,90922,KCA,BOS,KAN06,1,5,6
KCA200909230,2009,90923,KCA,BOS,KAN06,9,2,11
KCA200909240,2009,90924,KCA,BOS,KAN06,10,3,13
KCA200909250,2009,90925,KCA,MIN,KAN06,9,4,13
KCA200909260,2009,90926,KCA,MIN,KAN06,11,6,17
KCA200909270,2009,90927,KCA,MIN,KAN06,1,4,5
LAN200004140,2000,414,LAN,CIN,LOS03,1,8,9
LAN200004150,2000,415,LAN,CIN,LOS03,5,4,9
LAN200004160,2000,416,LAN,CIN,LOS03,5,3,8
LAN200004180,2000,418,LAN,HOU,LOS03,3,5,8
LAN200004190,2000,419,LAN,HOU,LOS03,10,3,13
LAN200004280,2000,428,LAN,FLO,LOS03,3,5,8
LAN200004290,2000,429,LAN,FLO,LOS03,12,13,25
LAN200004300,2000,430,LAN,FLO,LOS03,1,7,8
LAN200005010,2000,501,LAN,ATL,LOS03,2,1,3
LAN200005020,2000,502,LAN,ATL,LOS03,5,3,8
LAN200005030,2000,503,LAN,ATL,LOS03,4,6,10
LAN200005050,2000,505,LAN,HOU,LOS03,2,3,5
LAN200005060,2000,506,LAN,HOU,LOS03,6,9,15
LAN200005070,2000,507,LAN,HOU,LOS03,14,8,22
LAN200005220,2000,522,LAN,CIN,LOS03,3,4,7
LAN200005230,2000,523,LAN,CIN,LOS03,3,1,4
LAN200005240,2000,524,LAN,CIN,LOS03,10,3,13
LAN200005260,2000,526,LAN,PHI,LOS03,4,11,15
LAN200005270,2000,527,LAN,PHI,LOS03,7,6,13
LAN200005280,2000,528,LAN,PHI,LOS03,4,2,6
LAN200005290,2000,529,LAN,NYN,LOS03,1,4,5
LAN200005300,2000,530,LAN,NYN,LOS03,10,5,15
LAN200005310,2000,531,LAN,NYN,LOS03,3,4,7
LAN200006080,2000,608,LAN,HOU,LOS03,2,5,7
LAN200006090,2000,609,LAN,OAK,LOS03,3,1,4
LAN200006100,2000,610,LAN,OAK,LOS03,2,7,9
LAN200006110,2000,611,LAN,OAK,LOS03,6,0,6
LAN200006120,2000,612,LAN,ARI,LOS03,4,2,6
LAN200006130,2000,613,LAN,ARI,LOS03,1,6,7
LAN200006140,2000,614,LAN,ARI,LOS03,5,1,6
LAN200006150,2000,615,LAN,ARI,LOS03,0,4,4
LAN200006160,2000,616,LAN,SLN,LOS03,6,3,9
LAN200006170,2000,617,LAN,SLN,LOS03,4,3,7
LAN200006180,2000,618,LAN,SLN,LOS03,3,6,9
LAN200006260,2000,626,LAN,SDN,LOS03,9,5,14
LAN200006270,2000,627,LAN,SDN,LOS03,4,5,9
LAN200006280,2000,628,LAN,SDN,LOS03,4,5,9
LAN200006290,2000,629,LAN,SDN,LOS03,5,4,9
LAN200007130,2000,713,LAN,ANA,LOS03,3,4,7
LAN200007140,2000,714,LAN,ANA,LOS03,5,3,8
LAN200007150,2000,715,LAN,ANA,LOS03,6,2,8
LAN200007160,2000,716,LAN,PIT,LOS03,3,7,10
LAN200007170,2000,717,LAN,PIT,LOS03,6,9,15
LAN200007180,2000,718,LAN,PIT,LOS03,8,6,14
LAN200007190,2000,719,LAN,COL,LOS03,1,9,10
LAN200007200,2000,720,LAN,COL,LOS03,3,6,9
LAN200007210,2000,721,LAN,SFN,LOS03,5,6,11
LAN200007220,2000,722,LAN,SFN,LOS03,5,2,7
LAN200007230,2000,723,LAN,SFN,LOS03,0,5,5
LAN200008040,2000,804,LAN,MIL,LOS03,1,2,3
LAN200008050,2000,805,LAN,MIL,LOS03,4,2,6
LAN200008060,2000,806,LAN,MIL,LOS03,9,6,15
LAN200008070,2000,807,LAN,CHN,LOS03,7,3,10
LAN200008080,2000,808,LAN,CHN,LOS03,5,7,12
LAN200008090,2000,809,LAN,CHN,LOS03,5,4,9
LAN200008180,2000,818,LAN,NYN,LOS03,5,3,8
LAN200008190,2000,819,LAN,NYN,LOS03,1,4,5
LAN200008200,2000,820,LAN,NYN,LOS03,9,6,15
LAN200008210,2000,821,LAN,MON,LOS03,4,1,5
LAN200008220,2000,822,LAN,MON,LOS03,6,14,20
LAN200008230,2000,823,LAN,MON,LOS03,1,5,6
LAN200008240,2000,824,LAN,MON,LOS03,0,7,7
LAN200009010,2000,901,LAN,PHI,LOS03,1,2,3
LAN200009020,2000,902,LAN,PHI,LOS03,0,1,1
LAN200009030,2000,903,LAN,PHI,LOS03,1,6,7
LAN200009040,2000,904,LAN,PIT,LOS03,12,1,13
LAN200009050,2000,905,LAN,PIT,LOS03,8,0,8
LAN200009060,2000,906,LAN,PIT,LOS03,8,3,11
LAN200009140,2000,914,LAN,COL,LOS03,5,4,9
LAN200009150,2000,915,LAN,COL,LOS03,3,4,7
LAN200009160,2000,916,LAN,COL,LOS03,4,5,9
LAN200009170,2000,917,LAN,COL,LOS03,6,12,18
LAN200009180,2000,918,LAN,ARI,LOS03,1,2,3
LAN200009190,2000,919,LAN,ARI,LOS03,0,1,1
LAN200009200,2000,920,LAN,ARI,LOS03,0,1,1
LAN200009220,2000,922,LAN,SDN,LOS03,3,2,5
LAN200009230,2000,923,LAN,SDN,LOS03,1,2,3
LAN200009240,2000,924,LAN,SDN,LOS03,0,1,1
LAN200009260,2000,926,LAN,SFN,LOS03,0,9,9
LAN200009270,2000,927,LAN,SFN,LOS03,4,0,4
LAN200009280,2000,928,LAN,SFN,LOS03,5,3,8
LAN200104020,2001,10402,LAN,MIL,LOS03,0,1,1
LAN200104030,2001,10403,LAN,ARI,LOS03,3,2,5
LAN200104040,2001,10404,LAN,ARI,LOS03,7,2,9
LAN200104050,2001,10405,LAN,ARI,LOS03,5,7,12
LAN200104060,2001,10406,LAN,SFN,LOS03,1,10,11
LAN200104070,2001,10407,LAN,SFN,LOS03,4,10,14
LAN200104080,2001,10408,LAN,SFN,LOS03,8,3,11
LAN200104200,2001,10420,LAN,SDN,LOS03,1,3,4
LAN200104210,2001,10421,LAN,SDN,LOS03,2,4,6
LAN200104220,2001,10422,LAN,SDN,LOS03,7,6,13
LAN200104240,2001,10424,LAN,PIT,LOS03,5,1,6
LAN200104250,2001,10425,LAN,PIT,LOS03,5,6,11
LAN200104260,2001,10426,LAN,PIT,LOS03,3,6,9
LAN200104270,2001,10427,LAN,PHI,LOS03,3,4,7
LAN200104280,2001,10428,LAN,PHI,LOS03,6,7,13
LAN200104290,2001,10429,LAN,PHI,LOS03,1,4,5
LAN200105070,2001,10507,LAN,FLO,LOS03,0,1,1
LAN200105080,2001,10508,LAN,FLO,LOS03,7,6,13
LAN200105090,2001,10509,LAN,FLO,LOS03,2,3,5
LAN200105100,2001,10510,LAN,FLO,LOS03,3,4,7
LAN200105110,2001,10511,LAN,ATL,LOS03,5,1,6
LAN200105120,2001,10512,LAN,ATL,LOS03,0,1,1
LAN200105130,2001,10513,LAN,ATL,LOS03,1,3,4
LAN200105250,2001,10525,LAN,HOU,LOS03,1,4,5
LAN200105260,2001,10526,LAN,HOU,LOS03,2,7,9
LAN200105270,2001,10527,LAN,HOU,LOS03,4,5,9
LAN200105280,2001,10528,LAN,COL,LOS03,10,11,21
LAN200105290,2001,10529,LAN,COL,LOS03,7,2,9
LAN200105300,2001,10530,LAN,COL,LOS03,1,4,5
LAN200106080,2001,10608,LAN,ANA,LOS03,1,0,1
LAN200106090,2001,10609,LAN,ANA,LOS03,1,2,3
LAN200106100,2001,10610,LAN,ANA,LOS03,6,5,11
LAN200106110,2001,10611,LAN,TEX,LOS03,12,7,19
LAN200106120,2001,10612,LAN,TEX,LOS03,4,8,12
LAN200106130,2001,10613,LAN,TEX,LOS03,3,5,8
LAN200106190,2001,10619,LAN,ARI,LOS03,9,2,11
LAN200106200,2001,10620,LAN,ARI,LOS03,3,4,7
LAN200106220,2001,10622,LAN,SDN,LOS03,9,6,15
LAN200106230,2001,10623,LAN,SDN,LOS03,6,2,8
LAN200106240,2001,10624,LAN,SDN,LOS03,6,1,7
LAN200107020,2001,10702,LAN,SFN,LOS03,6,8,14
LAN200107030,2001,10703,LAN,SFN,LOS03,3,4,7
LAN200107040,2001,10704,LAN,SFN,LOS03,3,4,7
LAN200107050,2001,10705,LAN,SFN,LOS03,3,2,5
LAN200107060,2001,10706,LAN,SEA,LOS03,13,0,13
LAN200107070,2001,10707,LAN,SEA,LOS03,1,2,3
LAN200107080,2001,10708,LAN,SEA,LOS03,9,2,11
LAN200107180,2001,10718,LAN,MIL,LOS03,0,5,5
LAN200107190,2001,10719,LAN,MIL,LOS03,6,8,14
LAN200107260,2001,10726,LAN,COL,LOS03,1,3,4
LAN200107270,2001,10727,LAN,COL,LOS03,2,4,6
LAN200107280,2001,10728,LAN,COL,LOS03,6,10,16
LAN200107290,2001,10729,LAN,COL,LOS03,3,2,5
LAN200107310,2001,10731,LAN,CIN,LOS03,3,1,4
LAN200108010,2001,10801,LAN,CIN,LOS03,10,5,15
LAN200108020,2001,10802,LAN,CIN,LOS03,7,4,11
LAN200108030,2001,10803,LAN,CHN,LOS03,2,1,3
LAN200108040,2001,10804,LAN,CHN,LOS03,1,3,4
LAN200108050,2001,10805,LAN,CHN,LOS03,2,3,5
LAN200108140,2001,10814,LAN,MON,LOS03,4,1,5
LAN200108150,2001,10815,LAN,MON,LOS03,1,13,14
LAN200108160,2001,10816,LAN,MON,LOS03,7,3,10
LAN200108170,2001,10817,LAN,NYN,LOS03,3,8,11
LAN200108180,2001,10818,LAN,NYN,LOS03,5,4,9
LAN200108190,2001,10819,LAN,NYN,LOS03,6,5,11
LAN200108280,2001,10828,LAN,COL,LOS03,4,3,7
LAN200108290,2001,10829,LAN,COL,LOS03,5,3,8
LAN200108300,2001,10830,LAN,COL,LOS03,4,5,9
LAN200108310,2001,10831,LAN,SLN,LOS03,5,1,6
LAN200109010,2001,10901,LAN,SLN,LOS03,1,3,4
LAN200109020,2001,10902,LAN,SLN,LOS03,3,7,10
LAN200109170,2001,10917,LAN,SDN,LOS03,6,4,10
LAN200109180,2001,10918,LAN,SDN,LOS03,3,2,5
LAN200109190,2001,10919,LAN,SDN,LOS03,4,3,7
LAN200109200,2001,10920,LAN,ARI,LOS03,2,3,5
LAN200109210,2001,10921,LAN,ARI,LOS03,10,0,10
LAN200109220,2001,10922,LAN,ARI,LOS03,5,6,11
LAN200109230,2001,10923,LAN,ARI,LOS03,6,1,7
LAN200109240,2001,10924,LAN,SFN,LOS03,2,1,3
LAN200109250,2001,10925,LAN,SFN,LOS03,5,9,14
LAN200109260,2001,10926,LAN,SFN,LOS03,6,4,10
LAN200204020,2002,20402,LAN,SFN,LOS03,9,2,11
LAN200204030,2002,20403,LAN,SFN,LOS03,12,0,12
LAN200204040,2002,20404,LAN,SFN,LOS03,3,0,3
LAN200204050,2002,20405,LAN,COL,LOS03,0,9,9
LAN200204060,2002,20406,LAN,COL,LOS03,2,9,11
LAN200204070,2002,20407,LAN,COL,LOS03,4,6,10
LAN200204180,2002,20418,LAN,SDN,LOS03,2,5,7
LAN200204190,2002,20419,LAN,SDN,LOS03,2,5,7
LAN200204200,2002,20420,LAN,SDN,LOS03,1,4,5
LAN200204210,2002,20421,LAN,SDN,LOS03,5,0,5
LAN200204300,2002,20430,LAN,CIN,LOS03,3,1,4
LAN200205010,2002,20501,LAN,CIN,LOS03,4,0,4
LAN200205020,2002,20502,LAN,CIN,LOS03,2,3,5
LAN200205030,2002,20503,LAN,CHN,LOS03,8,3,11
LAN200205040,2002,20504,LAN,CHN,LOS03,2,3,5
LAN200205050,2002,20505,LAN,CHN,LOS03,3,0,3
LAN200205130,2002,20513,LAN,NYN,LOS03,2,3,5
LAN200205140,2002,20514,LAN,NYN,LOS03,3,0,3
LAN200205150,2002,20515,LAN,NYN,LOS03,2,0,2
LAN200205160,2002,20516,LAN,MON,LOS03,3,4,7
LAN200205170,2002,20517,LAN,MON,LOS03,5,8,13
LAN200205180,2002,20518,LAN,MON,LOS03,3,1,4
LAN200205190,2002,20519,LAN,MON,LOS03,1,10,11
LAN200205270,2002,20527,LAN,MIL,LOS03,3,5,8
LAN200205280,2002,20528,LAN,MIL,LOS03,4,8,12
LAN200205290,2002,20529,LAN,MIL,LOS03,3,4,7
LAN200205310,2002,20531,LAN,ARI,LOS03,6,3,9
LAN200206010,2002,20601,LAN,ARI,LOS03,0,2,2
LAN200206020,2002,20602,LAN,ARI,LOS03,3,6,9
LAN200206140,2002,20614,LAN,ANA,LOS03,8,4,12
LAN200206150,2002,20615,LAN,ANA,LOS03,5,10,15
LAN200206160,2002,20616,LAN,ANA,LOS03,4,5,9
LAN200206180,2002,20618,LAN,TOR,LOS03,2,1,3
LAN200206190,2002,20619,LAN,TOR,LOS03,2,5,7
LAN200206200,2002,20620,LAN,TOR,LOS03,1,2,3
LAN200206210,2002,20621,LAN,BOS,LOS03,2,3,5
LAN200206220,2002,20622,LAN,BOS,LOS03,4,5,9
LAN200206230,2002,20623,LAN,BOS,LOS03,6,9,15
LAN200206240,2002,20624,LAN,COL,LOS03,4,1,5
LAN200206250,2002,20625,LAN,COL,LOS03,0,4,4
LAN200206260,2002,20626,LAN,COL,LOS03,3,5,8
LAN200206270,2002,20627,LAN,COL,LOS03,1,7,8
LAN200207110,2002,20711,LAN,ARI,LOS03,4,3,7
LAN200207120,2002,20712,LAN,ARI,LOS03,3,2,5
LAN200207130,2002,20713,LAN,ARI,LOS03,7,5,12
LAN200207140,2002,20714,LAN,ARI,LOS03,1,2,3
LAN200207150,2002,20715,LAN,SLN,LOS03,4,2,6
LAN200207160,2002,20716,LAN,SLN,LOS03,9,2,11
LAN200207170,2002,20717,LAN,SDN,LOS03,7,0,7
LAN200207180,2002,20718,LAN,SDN,LOS03,4,1,5
LAN200207190,2002,20719,LAN,SFN,LOS03,3,2,5
LAN200207200,2002,20720,LAN,SFN,LOS03,2,4,6
LAN200207210,2002,20721,LAN,SFN,LOS03,6,4,10
LAN200208060,2002,20806,LAN,PIT,LOS03,3,1,4
LAN200208070,2002,20807,LAN,PIT,LOS03,0,4,4
LAN200208080,2002,20808,LAN,PIT,LOS03,5,10,15
LAN200208090,2002,20809,LAN,PHI,LOS03,6,7,13
LAN200208100,2002,20810,LAN,PHI,LOS03,8,10,18
LAN200208110,2002,20811,LAN,PHI,LOS03,6,3,9
LAN200208200,2002,20820,LAN,FLO,LOS03,6,3,9
LAN200208210,2002,20821,LAN,FLO,LOS03,3,4,7
LAN200208220,2002,20822,LAN,FLO,LOS03,2,6,8
LAN200208230,2002,20823,LAN,ATL,LOS03,3,4,7
LAN200208240,2002,20824,LAN,ATL,LOS03,3,4,7
LAN200208250,2002,20825,LAN,ATL,LOS03,7,5,12
LAN200208260,2002,20826,LAN,ARI,LOS03,6,3,9
LAN200208270,2002,20827,LAN,ARI,LOS03,1,6,7
LAN200208280,2002,20828,LAN,ARI,LOS03,0,1,1
LAN200209060,2002,20906,LAN,HOU,LOS03,2,3,5
LAN200209070,2002,20907,LAN,HOU,LOS03,6,1,7
LAN200209080,2002,20908,LAN,HOU,LOS03,6,2,8
LAN200209160,2002,20916,LAN,SFN,LOS03,6,7,13
LAN200209170,2002,20917,LAN,SFN,LOS03,6,4,10
LAN200209180,2002,20918,LAN,SFN,LOS03,7,4,11
LAN200209190,2002,20919,LAN,SFN,LOS03,3,6,9
LAN200209240,2002,20924,LAN,COL,LOS03,1,0,1
LAN200209250,2002,20925,LAN,COL,LOS03,2,3,5
LAN200209260,2002,20926,LAN,SDN,LOS03,5,6,11
LAN200209270,2002,20927,LAN,SDN,LOS03,0,1,1
LAN200209280,2002,20928,LAN,SDN,LOS03,2,14,16
LAN200209290,2002,20929,LAN,SDN,LOS03,2,0,2
LAN200304070,2003,30407,LAN,ARI,LOS03,6,4,10
LAN200304080,2003,30408,LAN,ARI,LOS03,3,5,8
LAN200304090,2003,30409,LAN,ARI,LOS03,2,5,7
LAN200304150,2003,30415,LAN,SDN,LOS03,3,2,5
LAN200304160,2003,30416,LAN,SDN,LOS03,0,3,3
LAN200304170,2003,30417,LAN,SDN,LOS03,3,4,7
LAN200304180,2003,30418,LAN,SFN,LOS03,5,1,6
LAN200304190,2003,30419,LAN,SFN,LOS03,9,3,12
LAN200304200,2003,30420,LAN,SFN,LOS03,4,16,20
LAN200304280,2003,30428,LAN,PHI,LOS03,3,0,3
LAN200304290,2003,30429,LAN,PHI,LOS03,2,6,8
LAN200304300,2003,30430,LAN,PHI,LOS03,0,4,4
LAN200305010,2003,30501,LAN,PHI,LOS03,4,1,5
LAN200305020,2003,30502,LAN,PIT,LOS03,5,3,8
LAN200305030,2003,30503,LAN,PIT,LOS03,1,4,5
LAN200305040,2003,30504,LAN,PIT,LOS03,2,3,5
LAN200305120,2003,30512,LAN,ATL,LOS03,11,4,15
LAN200305130,2003,30513,LAN,ATL,LOS03,3,1,4
LAN200305140,2003,30514,LAN,ATL,LOS03,1,5,6
LAN200305160,2003,30516,LAN,FLO,LOS03,1,2,3
LAN200305170,2003,30517,LAN,FLO,LOS03,1,4,5
LAN200305180,2003,30518,LAN,FLO,LOS03,1,2,3
LAN200305200,2003,30520,LAN,COL,LOS03,1,3,4
LAN200305210,2003,30521,LAN,COL,LOS03,2,3,5
LAN200305220,2003,30522,LAN,COL,LOS03,3,4,7
LAN200305300,2003,30530,LAN,MIL,LOS03,5,3,8
LAN200305310,2003,30531,LAN,MIL,LOS03,0,3,3
LAN200306010,2003,30601,LAN,MIL,LOS03,4,3,7
LAN200306030,2003,30603,LAN,KCA,LOS03,3,4,7
LAN200306040,2003,30604,LAN,KCA,LOS03,2,1,3
LAN200306050,2003,30605,LAN,KCA,LOS03,2,5,7
LAN200306060,2003,30606,LAN,CHA,LOS03,1,2,3
LAN200306070,2003,30607,LAN,CHA,LOS03,4,1,5
LAN200306080,2003,30608,LAN,CHA,LOS03,10,3,13
LAN200306170,2003,30617,LAN,SFN,LOS03,1,4,5
LAN200306180,2003,30618,LAN,SFN,LOS03,2,8,10
LAN200306190,2003,30619,LAN,SFN,LOS03,2,0,2
LAN200306200,2003,30620,LAN,ANA,LOS03,2,5,7
LAN200306210,2003,30621,LAN,ANA,LOS03,2,4,6
LAN200306220,2003,30622,LAN,ANA,LOS03,6,3,9
LAN200307010,2003,30701,LAN,SDN,LOS03,7,1,8
LAN200307020,2003,30702,LAN,SDN,LOS03,4,3,7
LAN200307030,2003,30703,LAN,SDN,LOS03,7,4,11
LAN200307040,2003,30704,LAN,ARI,LOS03,3,1,4
LAN200307050,2003,30705,LAN,ARI,LOS03,0,2,2
LAN200307060,2003,30706,LAN,ARI,LOS03,2,1,3
LAN200307170,2003,30717,LAN,SLN,LOS03,3,6,9
LAN200307180,2003,30718,LAN,SLN,LOS03,5,8,13
LAN200307190,2003,30719,LAN,SLN,LOS03,3,1,4
LAN200307200,2003,30720,LAN,SLN,LOS03,10,7,17
LAN200307210,2003,30721,LAN,COL,LOS03,4,1,5
LAN200307220,2003,30722,LAN,COL,LOS03,2,5,7
LAN200307230,2003,30723,LAN,COL,LOS03,8,3,11
LAN200307240,2003,30724,LAN,COL,LOS03,0,1,1
LAN200308050,2003,30805,LAN,CIN,LOS03,2,5,7
LAN200308060,2003,30806,LAN,CIN,LOS03,1,2,3
LAN200308070,2003,30807,LAN,CIN,LOS03,3,4,7
LAN200308080,2003,30808,LAN,CHN,LOS03,1,3,4
LAN200308090,2003,30809,LAN,CHN,LOS03,1,6,7
LAN200308100,2003,30810,LAN,CHN,LOS03,3,1,4
LAN200308190,2003,30819,LAN,MON,LOS03,7,5,12
LAN200308200,2003,30820,LAN,MON,LOS03,1,4,5
LAN200308210,2003,30821,LAN,MON,LOS03,1,2,3
LAN200308220,2003,30822,LAN,NYN,LOS03,1,2,3
LAN200308230,2003,30823,LAN,NYN,LOS03,4,0,4
LAN200308240,2003,30824,LAN,NYN,LOS03,2,1,3
LAN200308290,2003,30829,LAN,COL,LOS03,4,6,10
LAN200308300,2003,30830,LAN,COL,LOS03,0,5,5
LAN200308310,2003,30831,LAN,COL,LOS03,0,3,3
LAN200309010,2003,30901,LAN,HOU,LOS03,10,1,11
LAN200309020,2003,30902,LAN,HOU,LOS03,1,4,5
LAN200309030,2003,30903,LAN,HOU,LOS03,8,2,10
LAN200309120,2003,30912,LAN,SDN,LOS03,0,6,6
LAN200309130,2003,30913,LAN,SDN,LOS03,0,4,4
LAN200309140,2003,30914,LAN,SDN,LOS03,2,5,7
LAN200309160,2003,30916,LAN,ARI,LOS03,3,2,5
LAN200309170,2003,30917,LAN,ARI,LOS03,2,0,2
LAN200309180,2003,30918,LAN,ARI,LOS03,0,2,2
LAN200309190,2003,30919,LAN,SFN,LOS03,6,4,10
LAN200309200,2003,30920,LAN,SFN,LOS03,6,0,6
LAN200309210,2003,30921,LAN,SFN,LOS03,5,7,12
LAN200404050,2004,40405,LAN,SDN,LOS03,8,2,10
LAN200404060,2004,40406,LAN,SDN,LOS03,4,5,9
LAN200404070,2004,40407,LAN,SDN,LOS03,1,2,3
LAN200404090,2004,40409,LAN,COL,LOS03,1,5,6
LAN200404100,2004,40410,LAN,COL,LOS03,4,7,11
LAN200404110,2004,40411,LAN,COL,LOS03,4,2,6
LAN200404230,2004,40423,LAN,SFN,LOS03,4,5,9
LAN200404240,2004,40424,LAN,SFN,LOS03,5,3,8
LAN200404250,2004,40425,LAN,SFN,LOS03,0,9,9
LAN200404270,2004,40427,LAN,NYN,LOS03,9,5,14
LAN200404280,2004,40428,LAN,NYN,LOS03,2,3,5
LAN200404290,2004,40429,LAN,NYN,LOS03,6,1,7
LAN200404300,2004,40430,LAN,MON,LOS03,4,13,17
LAN200405010,2004,40501,LAN,MON,LOS03,4,5,9
LAN200405020,2004,40502,LAN,MON,LOS03,6,4,10
LAN200405110,2004,40511,LAN,CHN,LOS03,3,7,10
LAN200405120,2004,40512,LAN,CHN,LOS03,0,4,4
LAN200405130,2004,40513,LAN,CHN,LOS03,7,3,10
LAN200405140,2004,40514,LAN,CIN,LOS03,2,1,3
LAN200405150,2004,40515,LAN,CIN,LOS03,4,0,4
LAN200405160,2004,40516,LAN,CIN,LOS03,6,3,9
LAN200405280,2004,40528,LAN,ARI,LOS03,6,3,9
LAN200405290,2004,40529,LAN,ARI,LOS03,0,10,10
LAN200405300,2004,40530,LAN,ARI,LOS03,0,3,3
LAN200405310,2004,40531,LAN,MIL,LOS03,2,3,5
LAN200406010,2004,40601,LAN,MIL,LOS03,4,1,5
LAN200406020,2004,40602,LAN,MIL,LOS03,2,5,7
LAN200406150,2004,40615,LAN,BAL,LOS03,1,5,6
LAN200406160,2004,40616,LAN,BAL,LOS03,3,6,9
LAN200406170,2004,40617,LAN,BAL,LOS03,3,4,7
LAN200406180,2004,40618,LAN,NYA,LOS03,3,6,9
LAN200406190,2004,40619,LAN,NYA,LOS03,6,2,8
LAN200406200,2004,40620,LAN,NYA,LOS03,4,5,9
LAN200406250,2004,40625,LAN,ANA,LOS03,13,0,13
LAN200406260,2004,40626,LAN,ANA,LOS03,7,5,12
LAN200406270,2004,40627,LAN,ANA,LOS03,5,10,15
LAN200406290,2004,40629,LAN,SFN,LOS03,1,2,3
LAN200406300,2004,40630,LAN,SFN,LOS03,7,1,8
LAN200407010,2004,40701,LAN,SFN,LOS03,4,5,9
LAN200407050,2004,40705,LAN,ARI,LOS03,5,6,11
LAN200407060,2004,40706,LAN,ARI,LOS03,1,4,5
LAN200407070,2004,40707,LAN,ARI,LOS03,0,11,11
LAN200407080,2004,40708,LAN,HOU,LOS03,2,7,9
LAN200407090,2004,40709,LAN,HOU,LOS03,3,2,5
LAN200407100,2004,40710,LAN,HOU,LOS03,1,3,4
LAN200407110,2004,40711,LAN,HOU,LOS03,4,7,11
LAN200407210,2004,40721,LAN,COL,LOS03,6,5,11
LAN200407220,2004,40722,LAN,COL,LOS03,2,4,6
LAN200407230,2004,40723,LAN,SDN,LOS03,2,3,5
LAN200407240,2004,40724,LAN,SDN,LOS03,2,12,14
LAN200407250,2004,40725,LAN,SDN,LOS03,3,0,3
LAN200408030,2004,40803,LAN,PIT,LOS03,2,3,5
LAN200408040,2004,40804,LAN,PIT,LOS03,1,2,3
LAN200408050,2004,40805,LAN,PIT,LOS03,3,8,11
LAN200408060,2004,40806,LAN,PHI,LOS03,9,5,14
LAN200408070,2004,40807,LAN,PHI,LOS03,3,6,9
LAN200408080,2004,40808,LAN,PHI,LOS03,4,1,5
LAN200408160,2004,40816,LAN,FLO,LOS03,4,2,6
LAN200408170,2004,40817,LAN,FLO,LOS03,1,6,7
LAN200408180,2004,40818,LAN,FLO,LOS03,6,4,10
LAN200408190,2004,40819,LAN,ATL,LOS03,6,5,11
LAN200408200,2004,40820,LAN,ATL,LOS03,2,3,5
LAN200408210,2004,40821,LAN,ATL,LOS03,4,7,11
LAN200408220,2004,40822,LAN,ATL,LOS03,10,1,11
LAN200409070,2004,40907,LAN,ARI,LOS03,2,8,10
LAN200409080,2004,40908,LAN,ARI,LOS03,5,6,11
LAN200409090,2004,40909,LAN,ARI,LOS03,3,5,8
LAN200409100,2004,40910,LAN,SLN,LOS03,6,7,13
LAN200409110,2004,40911,LAN,SLN,LOS03,5,6,11
LAN200409120,2004,40912,LAN,SLN,LOS03,7,6,13
LAN200409130,2004,40913,LAN,SDN,LOS03,9,7,16
LAN200409140,2004,40914,LAN,SDN,LOS03,3,6,9
LAN200409150,2004,40915,LAN,SDN,LOS03,7,3,10
LAN200409160,2004,40916,LAN,SDN,LOS03,3,0,3
LAN200409270,2004,40927,LAN,COL,LOS03,7,8,15
LAN200409280,2004,40928,LAN,COL,LOS03,4,5,9
LAN200409290,2004,40929,LAN,COL,LOS03,4,1,5
LAN200409300,2004,40930,LAN,COL,LOS03,2,4,6
LAN200410010,2004,41001,LAN,SFN,LOS03,4,2,6
LAN200410020,2004,41002,LAN,SFN,LOS03,3,7,10
LAN200410030,2004,41003,LAN,SFN,LOS03,10,0,10
LAN200410090,2004,41009,LAN,SLN,LOS03,0,4,4
LAN200410100,2004,41010,LAN,SLN,LOS03,6,2,8
LAN200504120,2005,50412,LAN,SFN,LOS03,8,9,17
LAN200504130,2005,50413,LAN,SFN,LOS03,1,4,5
LAN200504150,2005,50415,LAN,SDN,LOS03,0,4,4
LAN200504160,2005,50416,LAN,SDN,LOS03,3,8,11
LAN200504170,2005,50417,LAN,SDN,LOS03,0,6,6
LAN200504250,2005,50425,LAN,ARI,LOS03,4,2,6
LAN200504260,2005,50426,LAN,ARI,LOS03,3,2,5
LAN200504270,2005,50427,LAN,ARI,LOS03,6,3,9
LAN200504290,2005,50429,LAN,COL,LOS03,3,6,9
LAN200504300,2005,50430,LAN,COL,LOS03,2,6,8
LAN200505010,2005,50501,LAN,COL,LOS03,1,2,3
LAN200505020,2005,50502,LAN,WAS,LOS03,6,2,8
LAN200505030,2005,50503,LAN,WAS,LOS03,2,4,6
LAN200505040,2005,50504,LAN,WAS,LOS03,5,2,7
LAN200505130,2005,50513,LAN,ATL,LOS03,4,7,11
LAN200505140,2005,50514,LAN,ATL,LOS03,5,1,6
LAN200505150,2005,50515,LAN,ATL,LOS03,5,2,7
LAN200505160,2005,50516,LAN,FLO,LOS03,6,2,8
LAN200505170,2005,50517,LAN,FLO,LOS03,5,14,19
LAN200505180,2005,50518,LAN,FLO,LOS03,8,3,11
LAN200505200,2005,50520,LAN,ANA,LOS03,9,0,9
LAN200505210,2005,50521,LAN,ANA,LOS03,3,1,4
LAN200505220,2005,50522,LAN,ANA,LOS03,2,6,8
LAN200505300,2005,50530,LAN,CHN,LOS03,5,3,8
LAN200505310,2005,50531,LAN,CHN,LOS03,2,1,3
LAN200506010,2005,50601,LAN,CHN,LOS03,9,5,14
LAN200506020,2005,50602,LAN,MIL,LOS03,4,6,10
LAN200506030,2005,50603,LAN,MIL,LOS03,7,5,12
LAN200506040,2005,50604,LAN,MIL,LOS03,1,2,3
LAN200506050,2005,50605,LAN,MIL,LOS03,6,10,16
LAN200506060,2005,50606,LAN,DET,LOS03,3,5,8
LAN200506070,2005,50607,LAN,DET,LOS03,8,4,12
LAN200506080,2005,50608,LAN,DET,LOS03,1,3,4
LAN200506100,2005,50610,LAN,MIN,LOS03,5,6,11
LAN200506110,2005,50611,LAN,MIN,LOS03,5,3,8
LAN200506120,2005,50612,LAN,MIN,LOS03,3,4,7
LAN200506270,2005,50627,LAN,SDN,LOS03,4,5,9
LAN200506280,2005,50628,LAN,SDN,LOS03,8,3,11
LAN200506290,2005,50629,LAN,SDN,LOS03,2,4,6
LAN200507010,2005,50701,LAN,ARI,LOS03,0,7,7
LAN200507020,2005,50702,LAN,ARI,LOS03,7,5,12
LAN200507030,2005,50703,LAN,ARI,LOS03,10,3,13
LAN200507140,2005,50714,LAN,SFN,LOS03,4,3,7
LAN200507150,2005,50715,LAN,SFN,LOS03,6,0,6
LAN200507160,2005,50716,LAN,SFN,LOS03,4,5,9
LAN200507170,2005,50717,LAN,SFN,LOS03,4,1,5
LAN200507250,2005,50725,LAN,CIN,LOS03,0,4,4
LAN200507260,2005,50726,LAN,CIN,LOS03,4,7,11
LAN200507270,2005,50727,LAN,CIN,LOS03,7,6,13
LAN200507280,2005,50728,LAN,CIN,LOS03,6,1,7
LAN200507290,2005,50729,LAN,SLN,LOS03,5,7,12
LAN200507300,2005,50730,LAN,SLN,LOS03,9,4,13
LAN200507310,2005,50731,LAN,SLN,LOS03,7,5,12
LAN200508090,2005,50809,LAN,PHI,LOS03,8,4,12
LAN200508100,2005,50810,LAN,PHI,LOS03,9,5,14
LAN200508110,2005,50811,LAN,PHI,LOS03,1,5,6
LAN200508120,2005,50812,LAN,NYN,LOS03,6,7,13
LAN200508130,2005,50813,LAN,NYN,LOS03,5,1,6
LAN200508140,2005,50814,LAN,NYN,LOS03,1,2,3
LAN200508230,2005,50823,LAN,COL,LOS03,3,8,11
LAN200508240,2005,50824,LAN,COL,LOS03,2,1,3
LAN200508250,2005,50825,LAN,COL,LOS03,5,4,9
LAN200508260,2005,50826,LAN,HOU,LOS03,2,1,3
LAN200508270,2005,50827,LAN,HOU,LOS03,3,8,11
LAN200508280,2005,50828,LAN,HOU,LOS03,0,1,1
LAN200509050,2005,50905,LAN,SFN,LOS03,3,1,4
LAN200509060,2005,50906,LAN,SFN,LOS03,2,4,6
LAN200509070,2005,50907,LAN,SFN,LOS03,8,9,17
LAN200509090,2005,50909,LAN,SDN,LOS03,3,1,4
LAN200509100,2005,50910,LAN,SDN,LOS03,1,3,4
LAN200509110,2005,50911,LAN,SDN,LOS03,3,7,10
LAN200509120,2005,50912,LAN,COL,LOS03,0,7,7
LAN200509130,2005,50913,LAN,COL,LOS03,6,4,10
LAN200509140,2005,50914,LAN,COL,LOS03,8,7,15
LAN200509230,2005,50923,LAN,PIT,LOS03,3,4,7
LAN200509240,2005,50924,LAN,PIT,LOS03,8,3,11
LAN200509250,2005,50925,LAN,PIT,LOS03,2,9,11
LAN200509260,2005,50926,LAN,PIT,LOS03,4,9,13
LAN200509270,2005,50927,LAN,ARI,LOS03,2,0,2
LAN200509280,2005,50928,LAN,ARI,LOS03,4,3,7
LAN200509290,2005,50929,LAN,ARI,LOS03,3,2,5
LAN200604030,2006,60403,LAN,ATL,LOS03,11,10,21
LAN200604040,2006,60404,LAN,ATL,LOS03,4,5,9
LAN200604050,2006,60405,LAN,ATL,LOS03,9,8,17
LAN200604140,2006,60414,LAN,SFN,LOS03,2,1,3
LAN200604150,2006,60415,LAN,SFN,LOS03,1,3,4
LAN200604160,2006,60416,LAN,SFN,LOS03,2,0,2
LAN200604170,2006,60417,LAN,CHN,LOS03,4,1,5
LAN200604180,2006,60418,LAN,CHN,LOS03,1,2,3
LAN200604190,2006,60419,LAN,CHN,LOS03,5,4,9
LAN200604210,2006,60421,LAN,ARI,LOS03,3,6,9
LAN200604220,2006,60422,LAN,ARI,LOS03,5,4,9
LAN200604230,2006,60423,LAN,ARI,LOS03,4,6,10
LAN200605030,2006,60503,LAN,SDN,LOS03,11,5,16
LAN200605040,2006,60504,LAN,SDN,LOS03,3,0,3
LAN200605050,2006,60505,LAN,MIL,LOS03,3,4,7
LAN200605060,2006,60506,LAN,MIL,LOS03,4,5,9
LAN200605070,2006,60507,LAN,MIL,LOS03,2,10,12
LAN200605090,2006,60509,LAN,HOU,LOS03,7,12,19
LAN200605100,2006,60510,LAN,HOU,LOS03,6,9,15
LAN200605110,2006,60511,LAN,HOU,LOS03,4,2,6
LAN200605190,2006,60519,LAN,ANA,LOS03,3,16,19
LAN200605200,2006,60520,LAN,ANA,LOS03,4,8,12
LAN200605210,2006,60521,LAN,ANA,LOS03,0,7,7
LAN200605220,2006,60522,LAN,COL,LOS03,1,6,7
LAN200605230,2006,60523,LAN,COL,LOS03,1,8,9
LAN200605240,2006,60524,LAN,COL,LOS03,1,7,8
LAN200606010,2006,60601,LAN,PHI,LOS03,2,7,9
LAN200606020,2006,60602,LAN,PHI,LOS03,8,6,14
LAN200606030,2006,60603,LAN,PHI,LOS03,2,8,10
LAN200606040,2006,60604,LAN,PHI,LOS03,6,4,10
LAN200606050,2006,60605,LAN,NYN,LOS03,4,1,5
LAN200606060,2006,60606,LAN,NYN,LOS03,5,8,13
LAN200606070,2006,60607,LAN,NYN,LOS03,9,7,16
LAN200606200,2006,60620,LAN,SEA,LOS03,9,4,13
LAN200606210,2006,60621,LAN,SEA,LOS03,8,5,13
LAN200606220,2006,60622,LAN,SEA,LOS03,2,4,6
LAN200606230,2006,60623,LAN,PIT,LOS03,4,10,14
LAN200606240,2006,60624,LAN,PIT,LOS03,0,7,7
LAN200606250,2006,60625,LAN,PIT,LOS03,4,7,11
LAN200607030,2006,60703,LAN,ARI,LOS03,4,10,14
LAN200607040,2006,60704,LAN,ARI,LOS03,3,11,14
LAN200607050,2006,60705,LAN,ARI,LOS03,4,5,9
LAN200607060,2006,60706,LAN,SFN,LOS03,5,4,9
LAN200607070,2006,60707,LAN,SFN,LOS03,7,9,16
LAN200607080,2006,60708,LAN,SFN,LOS03,11,7,18
LAN200607090,2006,60709,LAN,SFN,LOS03,1,3,4
LAN200607210,2006,60721,LAN,SLN,LOS03,2,0,2
LAN200607220,2006,60722,LAN,SLN,LOS03,6,1,7
LAN200607230,2006,60723,LAN,SLN,LOS03,6,1,7
LAN200607240,2006,60724,LAN,SDN,LOS03,7,6,13
LAN200607250,2006,60725,LAN,SDN,LOS03,7,3,10
LAN200607260,2006,60726,LAN,SDN,LOS03,10,3,13
LAN200607280,2006,60728,LAN,WAS,LOS03,1,13,14
LAN200607290,2006,60729,LAN,WAS,LOS03,5,7,12
LAN200607300,2006,60730,LAN,WAS,LOS03,3,4,7
LAN200608070,2006,60807,LAN,COL,LOS03,2,7,9
LAN200608080,2006,60808,LAN,COL,LOS03,2,4,6
LAN200608090,2006,60809,LAN,COL,LOS03,3,1,4
LAN200608100,2006,60810,LAN,COL,LOS03,3,4,7
LAN200608110,2006,60811,LAN,SFN,LOS03,2,3,5
LAN200608120,2006,60812,LAN,SFN,LOS03,5,6,11
LAN200608130,2006,60813,LAN,SFN,LOS03,0,1,1
LAN200608140,2006,60814,LAN,FLO,LOS03,2,4,6
LAN200608150,2006,60815,LAN,FLO,LOS03,0,4,4
LAN200608160,2006,60816,LAN,FLO,LOS03,15,4,19
LAN200608280,2006,60828,LAN,CIN,LOS03,5,6,11
LAN200608290,2006,60829,LAN,CIN,LOS03,5,6,11
LAN200608300,2006,60830,LAN,CIN,LOS03,3,7,10
LAN200609010,2006,60901,LAN,COL,LOS03,3,6,9
LAN200609020,2006,60902,LAN,COL,LOS03,5,14,19
LAN200609030,2006,60903,LAN,COL,LOS03,12,5,17
LAN200609150,2006,60915,LAN,SDN,LOS03,1,3,4
LAN200609160,2006,60916,LAN,SDN,LOS03,11,2,13
LAN200609170,2006,60917,LAN,SDN,LOS03,2,1,3
LAN200609180,2006,60918,LAN,SDN,LOS03,10,11,21
LAN200609190,2006,60919,LAN,PIT,LOS03,10,6,16
LAN200609200,2006,60920,LAN,PIT,LOS03,6,4,10
LAN200609210,2006,60921,LAN,PIT,LOS03,2,5,7
LAN200609220,2006,60922,LAN,ARI,LOS03,0,2,2
LAN200609230,2006,60923,LAN,ARI,LOS03,9,3,12
LAN200609240,2006,60924,LAN,ARI,LOS03,1,5,6
LAN200610070,2006,61007,LAN,NYN,LOS03,9,5,14
LAN200704090,2007,70409,LAN,COL,LOS03,6,3,9
LAN200704100,2007,70410,LAN,COL,LOS03,1,2,3
LAN200704110,2007,70411,LAN,COL,LOS03,0,3,3
LAN200704130,2007,70413,LAN,SDN,LOS03,1,9,10
LAN200704140,2007,70414,LAN,SDN,LOS03,7,2,9
LAN200704150,2007,70415,LAN,SDN,LOS03,3,9,12
LAN200704200,2007,70420,LAN,PIT,LOS03,2,10,12
LAN200704210,2007,70421,LAN,PIT,LOS03,3,7,10
LAN200704220,2007,70422,LAN,PIT,LOS03,7,5,12
LAN200704240,2007,70424,LAN,SFN,LOS03,5,3,8
LAN200704250,2007,70425,LAN,SFN,LOS03,6,4,10
LAN200704260,2007,70426,LAN,SFN,LOS03,5,4,9
LAN200704300,2007,70430,LAN,ARI,LOS03,9,1,10
LAN200705010,2007,70501,LAN,ARI,LOS03,1,2,3
LAN200705020,2007,70502,LAN,ARI,LOS03,1,2,3
LAN200705110,2007,70511,LAN,CIN,LOS03,0,2,2
LAN200705120,2007,70512,LAN,CIN,LOS03,3,7,10
LAN200705130,2007,70513,LAN,CIN,LOS03,5,10,15
LAN200705140,2007,70514,LAN,SLN,LOS03,8,4,12
LAN200705150,2007,70515,LAN,SLN,LOS03,7,9,16
LAN200705160,2007,70516,LAN,SLN,LOS03,4,5,9
LAN200705210,2007,70521,LAN,MIL,LOS03,9,5,14
LAN200705220,2007,70522,LAN,MIL,LOS03,2,3,5
LAN200705230,2007,70523,LAN,MIL,LOS03,1,5,6
LAN200705250,2007,70525,LAN,CHN,LOS03,8,9,17
LAN200705260,2007,70526,LAN,CHN,LOS03,4,2,6
LAN200705270,2007,70527,LAN,CHN,LOS03,1,2,3
LAN200706080,2007,70608,LAN,TOR,LOS03,3,4,7
LAN200706090,2007,70609,LAN,TOR,LOS03,1,0,1
LAN200706100,2007,70610,LAN,TOR,LOS03,11,5,16
LAN200706110,2007,70611,LAN,NYN,LOS03,3,5,8
LAN200706120,2007,70612,LAN,NYN,LOS03,1,4,5
LAN200706130,2007,70613,LAN,NYN,LOS03,1,9,10
LAN200706150,2007,70615,LAN,ANA,LOS03,1,2,3
LAN200706160,2007,70616,LAN,ANA,LOS03,3,0,3
LAN200706170,2007,70617,LAN,ANA,LOS03,10,4,14
LAN200706290,2007,70629,LAN,SDN,LOS03,7,6,13
LAN200706300,2007,70630,LAN,SDN,LOS03,3,1,4
LAN200707010,2007,70701,LAN,SDN,LOS03,0,5,5
LAN200707020,2007,70702,LAN,ATL,LOS03,2,8,10
LAN200707030,2007,70703,LAN,ATL,LOS03,6,7,13
LAN200707040,2007,70704,LAN,ATL,LOS03,5,2,7
LAN200707050,2007,70705,LAN,ATL,LOS03,8,6,14
LAN200707060,2007,70706,LAN,FLO,LOS03,6,5,11
LAN200707070,2007,70707,LAN,FLO,LOS03,7,2,9
LAN200707080,2007,70708,LAN,FLO,LOS03,3,9,12
LAN200707160,2007,70716,LAN,PHI,LOS03,3,10,13
LAN200707170,2007,70717,LAN,PHI,LOS03,15,3,18
LAN200707180,2007,70718,LAN,PHI,LOS03,4,5,9
LAN200707190,2007,70719,LAN,NYN,LOS03,13,9,22
LAN200707200,2007,70720,LAN,NYN,LOS03,4,1,5
LAN200707210,2007,70721,LAN,NYN,LOS03,6,8,14
LAN200707220,2007,70722,LAN,NYN,LOS03,5,4,9
LAN200707310,2007,70731,LAN,SFN,LOS03,3,1,4
LAN200708010,2007,70801,LAN,SFN,LOS03,4,6,10
LAN200708020,2007,70802,LAN,SFN,LOS03,4,2,6
LAN200708030,2007,70803,LAN,ARI,LOS03,1,0,1
LAN200708040,2007,70804,LAN,ARI,LOS03,8,7,15
LAN200708050,2007,70805,LAN,ARI,LOS03,3,0,3
LAN200708130,2007,70813,LAN,HOU,LOS03,4,1,5
LAN200708140,2007,70814,LAN,HOU,LOS03,7,4,11
LAN200708150,2007,70815,LAN,HOU,LOS03,3,6,9
LAN200708160,2007,70816,LAN,HOU,LOS03,2,6,8
LAN200708170,2007,70817,LAN,COL,LOS03,4,6,10
LAN200708180,2007,70818,LAN,COL,LOS03,7,4,11
LAN200708190,2007,70819,LAN,COL,LOS03,3,4,7
LAN200708270,2007,70827,LAN,WAS,LOS03,4,5,9
LAN200708280,2007,70828,LAN,WAS,LOS03,3,4,7
LAN200708290,2007,70829,LAN,WAS,LOS03,9,10,19
LAN200709110,2007,70911,LAN,SDN,LOS03,9,4,13
LAN200709120,2007,70912,LAN,SDN,LOS03,1,6,7
LAN200709130,2007,70913,LAN,SDN,LOS03,3,6,9
LAN200709140,2007,70914,LAN,ARI,LOS03,4,7,11
LAN200709150,2007,70915,LAN,ARI,LOS03,2,6,8
LAN200709160,2007,70916,LAN,ARI,LOS03,6,1,7
LAN200709250,2007,70925,LAN,COL,LOS03,9,7,16
LAN200709260,2007,70926,LAN,COL,LOS03,2,0,2
LAN200709270,2007,70927,LAN,COL,LOS03,10,4,14
LAN200709280,2007,70928,LAN,SFN,LOS03,3,8,11
LAN200709290,2007,70929,LAN,SFN,LOS03,5,6,11
LAN200709300,2007,70930,LAN,SFN,LOS03,11,2,13
LAN200803310,2008,80331,LAN,SFN,LOS03,0,5,5
LAN200804010,2008,80401,LAN,SFN,LOS03,2,3,5
LAN200804020,2008,80402,LAN,SFN,LOS03,2,1,3
LAN200804110,2008,80411,LAN,SDN,LOS03,7,5,12
LAN200804120,2008,80412,LAN,SDN,LOS03,1,11,12
LAN200804130,2008,80413,LAN,SDN,LOS03,1,0,1
LAN200804140,2008,80414,LAN,PIT,LOS03,6,4,10
LAN200804150,2008,80415,LAN,PIT,LOS03,2,11,13
LAN200804160,2008,80416,LAN,PIT,LOS03,1,8,9
LAN200804230,2008,80423,LAN,ARI,LOS03,3,8,11
LAN200804240,2008,80424,LAN,ARI,LOS03,6,4,10
LAN200804250,2008,80425,LAN,COL,LOS03,7,8,15
LAN200804260,2008,80426,LAN,COL,LOS03,3,11,14
LAN200804270,2008,80427,LAN,COL,LOS03,2,3,5
LAN200805050,2008,80505,LAN,NYN,LOS03,1,5,6
LAN200805060,2008,80506,LAN,NYN,LOS03,4,5,9
LAN200805070,2008,80507,LAN,NYN,LOS03,12,1,13
LAN200805090,2008,80509,LAN,HOU,LOS03,7,1,8
LAN200805100,2008,80510,LAN,HOU,LOS03,5,0,5
LAN200805110,2008,80511,LAN,HOU,LOS03,8,5,13
LAN200805190,2008,80519,LAN,CIN,LOS03,5,6,11
LAN200805200,2008,80520,LAN,CIN,LOS03,1,4,5
LAN200805210,2008,80521,LAN,CIN,LOS03,2,5,7
LAN200805230,2008,80523,LAN,SLN,LOS03,2,1,3
LAN200805240,2008,80524,LAN,SLN,LOS03,4,0,4
LAN200805250,2008,80525,LAN,SLN,LOS03,3,4,7
LAN200806020,2008,80602,LAN,COL,LOS03,2,8,10
LAN200806030,2008,80603,LAN,COL,LOS03,3,0,3
LAN200806040,2008,80604,LAN,COL,LOS03,2,1,3
LAN200806050,2008,80605,LAN,CHN,LOS03,5,4,9
LAN200806060,2008,80606,LAN,CHN,LOS03,0,3,3
LAN200806070,2008,80607,LAN,CHN,LOS03,3,7,10
LAN200806080,2008,80608,LAN,CHN,LOS03,3,1,4
LAN200806200,2008,80620,LAN,CLE,LOS03,6,4,10
LAN200806210,2008,80621,LAN,CLE,LOS03,7,2,9
LAN200806220,2008,80622,LAN,CLE,LOS03,3,4,7
LAN200806240,2008,80624,LAN,CHA,LOS03,6,1,7
LAN200806250,2008,80625,LAN,CHA,LOS03,0,5,5
LAN200806260,2008,80626,LAN,CHA,LOS03,2,0,2
LAN200806270,2008,80627,LAN,ANA,LOS03,0,6,6
LAN200806280,2008,80628,LAN,ANA,LOS03,0,1,1
LAN200806290,2008,80629,LAN,ANA,LOS03,1,0,1
LAN200807070,2008,80707,LAN,ATL,LOS03,0,3,3
LAN200807080,2008,80708,LAN,ATL,LOS03,9,3,12
LAN200807090,2008,80709,LAN,ATL,LOS03,1,2,3
LAN200807100,2008,80710,LAN,FLO,LOS03,5,4,9
LAN200807110,2008,80711,LAN,FLO,LOS03,3,1,4
LAN200807120,2008,80712,LAN,FLO,LOS03,5,3,8
LAN200807130,2008,80713,LAN,FLO,LOS03,1,9,10
LAN200807250,2008,80725,LAN,WAS,LOS03,2,3,5
LAN200807260,2008,80726,LAN,WAS,LOS03,0,6,6
LAN200807270,2008,80727,LAN,WAS,LOS03,0,2,2
LAN200807280,2008,80728,LAN,SFN,LOS03,7,6,13
LAN200807290,2008,80729,LAN,SFN,LOS03,0,2,2
LAN200807300,2008,80730,LAN,SFN,LOS03,0,4,4
LAN200807310,2008,80731,LAN,ARI,LOS03,2,1,3
LAN200808010,2008,80801,LAN,ARI,LOS03,2,1,3
LAN200808020,2008,80802,LAN,ARI,LOS03,2,4,6
LAN200808030,2008,80803,LAN,ARI,LOS03,3,9,12
LAN200808110,2008,80811,LAN,PHI,LOS03,6,8,14
LAN200808120,2008,80812,LAN,PHI,LOS03,3,4,7
LAN200808130,2008,80813,LAN,PHI,LOS03,6,7,13
LAN200808140,2008,80814,LAN,PHI,LOS03,1,3,4
LAN200808150,2008,80815,LAN,MIL,LOS03,3,5,8
LAN200808160,2008,80816,LAN,MIL,LOS03,4,3,7
LAN200808170,2008,80817,LAN,MIL,LOS03,5,7,12
LAN200808190,2008,80819,LAN,COL,LOS03,8,3,11
LAN200808200,2008,80820,LAN,COL,LOS03,4,3,7
LAN200808210,2008,80821,LAN,COL,LOS03,1,3,4
LAN200809010,2008,80901,LAN,SDN,LOS03,2,5,7
LAN200809020,2008,80902,LAN,SDN,LOS03,4,8,12
LAN200809030,2008,80903,LAN,SDN,LOS03,4,6,10
LAN200809050,2008,80905,LAN,ARI,LOS03,0,7,7
LAN200809060,2008,80906,LAN,ARI,LOS03,2,7,9
LAN200809070,2008,80907,LAN,ARI,LOS03,3,5,8
LAN200809190,2008,80919,LAN,SFN,LOS03,7,1,8
LAN200809200,2008,80920,LAN,SFN,LOS03,7,10,17
LAN200809210,2008,80921,LAN,SFN,LOS03,1,0,1
LAN200809230,2008,80923,LAN,SDN,LOS03,1,10,11
LAN200809240,2008,80924,LAN,SDN,LOS03,4,12,16
LAN200809250,2008,80925,LAN,SDN,LOS03,7,5,12
LAN200810040,2008,81004,LAN,CHN,LOS03,1,3,4
LAN200810120,2008,81012,LAN,PHI,LOS03,2,7,9
LAN200810130,2008,81013,LAN,PHI,LOS03,7,5,12
LAN200810150,2008,81015,LAN,PHI,LOS03,5,1,6
LAN200904130,2009,90413,LAN,SFN,LOS03,1,11,12
LAN200904150,2009,90415,LAN,SFN,LOS03,4,5,9
LAN200904160,2009,90416,LAN,SFN,LOS03,2,7,9
LAN200904170,2009,90417,LAN,COL,LOS03,3,4,7
LAN200904180,2009,90418,LAN,COL,LOS03,5,9,14
LAN200904190,2009,90419,LAN,COL,LOS03,2,14,16
LAN200904300,2009,90430,LAN,SDN,LOS03,5,8,13
LAN200905010,2009,90501,LAN,SDN,LOS03,0,1,1
LAN200905020,2009,90502,LAN,SDN,LOS03,1,2,3
LAN200905030,2009,90503,LAN,SDN,LOS03,3,7,10
LAN200905040,2009,90504,LAN,ARI,LOS03,2,7,9
LAN200905050,2009,90505,LAN,ARI,LOS03,1,3,4
LAN200905060,2009,90506,LAN,WAS,LOS03,3,10,13
LAN200905070,2009,90507,LAN,WAS,LOS03,11,9,20
LAN200905080,2009,90508,LAN,SFN,LOS03,3,1,4
LAN200905090,2009,90509,LAN,SFN,LOS03,0,8,8
LAN200905100,2009,90510,LAN,SFN,LOS03,7,5,12
LAN200905180,2009,90518,LAN,NYN,LOS03,2,3,5
LAN200905190,2009,90519,LAN,NYN,LOS03,3,5,8
LAN200905200,2009,90520,LAN,NYN,LOS03,1,2,3
LAN200905220,2009,90522,LAN,ANA,LOS03,3,1,4
LAN200905230,2009,90523,LAN,ANA,LOS03,4,5,9
LAN200905240,2009,90524,LAN,ANA,LOS03,10,7,17
LAN200906010,2009,90601,LAN,ARI,LOS03,3,2,5
LAN200906020,2009,90602,LAN,ARI,LOS03,5,6,11
LAN200906030,2009,90603,LAN,ARI,LOS03,0,1,1
LAN200906040,2009,90604,LAN,PHI,LOS03,3,0,3
LAN200906050,2009,90605,LAN,PHI,LOS03,3,4,7
LAN200906060,2009,90606,LAN,PHI,LOS03,2,3,5
LAN200906070,2009,90607,LAN,PHI,LOS03,7,2,9
LAN200906090,2009,90609,LAN,SDN,LOS03,4,6,10
LAN200906100,2009,90610,LAN,SDN,LOS03,3,1,4
LAN200906160,2009,90616,LAN,OAK,LOS03,4,5,9
LAN200906170,2009,90617,LAN,OAK,LOS03,5,4,9
LAN200906180,2009,90618,LAN,OAK,LOS03,2,3,5
LAN200906260,2009,90626,LAN,SEA,LOS03,2,8,10
LAN200906270,2009,90627,LAN,SEA,LOS03,5,1,6
LAN200906280,2009,90628,LAN,SEA,LOS03,4,2,6
LAN200906290,2009,90629,LAN,COL,LOS03,2,4,6
LAN200906300,2009,90630,LAN,COL,LOS03,3,0,3
LAN200907010,2009,90701,LAN,COL,LOS03,0,1,1
LAN200907160,2009,90716,LAN,HOU,LOS03,3,0,3
LAN200907170,2009,90717,LAN,HOU,LOS03,8,1,9
LAN200907180,2009,90718,LAN,HOU,LOS03,2,5,7
LAN200907190,2009,90719,LAN,HOU,LOS03,3,4,7
LAN200907200,2009,90720,LAN,CIN,LOS03,5,7,12
LAN200907210,2009,90721,LAN,CIN,LOS03,3,12,15
LAN200907220,2009,90722,LAN,CIN,LOS03,2,6,8
LAN200907240,2009,90724,LAN,FLO,LOS03,6,3,9
LAN200907250,2009,90725,LAN,FLO,LOS03,3,4,7
LAN200907260,2009,90726,LAN,FLO,LOS03,8,6,14
LAN200908030,2009,90803,LAN,MIL,LOS03,6,5,11
LAN200908040,2009,90804,LAN,MIL,LOS03,4,17,21
LAN200908050,2009,90805,LAN,MIL,LOS03,4,1,5
LAN200908060,2009,90806,LAN,ATL,LOS03,4,5,9
LAN200908070,2009,90807,LAN,ATL,LOS03,9,5,14
LAN200908080,2009,90808,LAN,ATL,LOS03,2,1,3
LAN200908090,2009,90809,LAN,ATL,LOS03,8,2,10
LAN200908170,2009,90817,LAN,SLN,LOS03,3,2,5
LAN200908180,2009,90818,LAN,SLN,LOS03,3,7,10
LAN200908190,2009,90819,LAN,SLN,LOS03,3,2,5
LAN200908200,2009,90820,LAN,CHN,LOS03,2,7,9
LAN200908210,2009,90821,LAN,CHN,LOS03,1,2,3
LAN200908220,2009,90822,LAN,CHN,LOS03,0,2,2
LAN200908230,2009,90823,LAN,CHN,LOS03,3,1,4
LAN200908310,2009,90831,LAN,ARI,LOS03,5,3,8
LAN200909010,2009,90901,LAN,ARI,LOS03,3,4,7
LAN200909020,2009,90902,LAN,ARI,LOS03,4,1,5
LAN200909030,2009,90903,LAN,ARI,LOS03,2,4,6
LAN200909040,2009,90904,LAN,SDN,LOS03,2,0,2
LAN200909050,2009,90905,LAN,SDN,LOS03,4,7,11
LAN200909060,2009,90906,LAN,SDN,LOS03,4,3,7
LAN200909140,2009,90914,LAN,PIT,LOS03,2,6,8
LAN200909150,2009,90915,LAN,PIT,LOS03,4,5,9
LAN200909160,2009,90916,LAN,PIT,LOS03,1,3,4
LAN200909180,2009,90918,LAN,SFN,LOS03,8,4,12
LAN200909190,2009,90919,LAN,SFN,LOS03,1,12,13
LAN200909200,2009,90920,LAN,SFN,LOS03,2,6,8
LAN200910020,2009,91002,LAN,COL,LOS03,4,3,7
LAN200910030,2009,91003,LAN,COL,LOS03,0,5,5
LAN200910040,2009,91004,LAN,COL,LOS03,3,5,8
LAN200910070,2009,91007,LAN,SLN,LOS03,3,5,8
LAN200910080,2009,91008,LAN,SLN,LOS03,2,3,5
LAN200910150,2009,91015,LAN,PHI,LOS03,8,6,14
LAN200910160,2009,91016,LAN,PHI,LOS03,1,2,3
MIL200004100,2000,410,MIL,FLO,MIL05,3,4,7
MIL200004120,2000,412,MIL,FLO,MIL05,11,4,15
MIL200004130,2000,413,MIL,FLO,MIL05,0,4,4
MIL200004140,2000,414,MIL,ATL,MIL05,6,3,9
MIL200004150,2000,415,MIL,ATL,MIL05,3,6,9
MIL200004160,2000,416,MIL,ATL,MIL05,2,1,3
MIL200004280,2000,428,MIL,HOU,MIL05,7,0,7
MIL200004290,2000,429,MIL,HOU,MIL05,10,3,13
MIL200004300,2000,430,MIL,HOU,MIL05,3,4,7
MIL200005010,2000,501,MIL,HOU,MIL05,5,0,5
MIL200005020,2000,502,MIL,ARI,MIL05,5,1,6
MIL200005030,2000,503,MIL,ARI,MIL05,1,4,5
MIL200005040,2000,504,MIL,ARI,MIL05,6,2,8
MIL200005050,2000,505,MIL,MON,MIL05,10,2,12
MIL200005060,2000,506,MIL,MON,MIL05,3,2,5
MIL200005070,2000,507,MIL,MON,MIL05,4,9,13
MIL200005160,2000,516,MIL,HOU,MIL05,5,6,11
MIL200005190,2000,519,MIL,SFN,MIL05,10,11,21
MIL200005200,2000,520,MIL,SFN,MIL05,0,7,7
MIL200005210,2000,521,MIL,SFN,MIL05,16,10,26
MIL200005221,2000,522,MIL,HOU,MIL05,9,10,19
MIL200005222,2000,522,MIL,HOU,MIL05,1,6,7
MIL200005230,2000,523,MIL,ATL,MIL05,6,7,13
MIL200005240,2000,524,MIL,ATL,MIL05,11,2,13
MIL200005250,2000,525,MIL,ATL,MIL05,7,3,10
MIL200006020,2000,602,MIL,COL,MIL05,8,6,14
MIL200006030,2000,603,MIL,COL,MIL05,1,2,3
MIL200006040,2000,604,MIL,COL,MIL05,7,1,8
MIL200006050,2000,605,MIL,CLE,MIL05,8,4,12
MIL200006060,2000,606,MIL,CLE,MIL05,4,2,6
MIL200006070,2000,607,MIL,CLE,MIL05,9,5,14
MIL200006120,2000,612,MIL,MON,MIL05,1,8,9
MIL200006130,2000,613,MIL,MON,MIL05,9,4,13
MIL200006140,2000,614,MIL,MON,MIL05,2,11,13
MIL200006160,2000,616,MIL,NYN,MIL05,7,1,8
MIL200006170,2000,617,MIL,NYN,MIL05,2,3,5
MIL200006180,2000,618,MIL,NYN,MIL05,7,3,10
MIL200006300,2000,630,MIL,CHN,MIL05,7,4,11
MIL200007010,2000,701,MIL,CHN,MIL05,0,4,4
MIL200007020,2000,702,MIL,CHN,MIL05,2,4,6
MIL200007030,2000,703,MIL,PHI,MIL05,5,3,8
MIL200007040,2000,704,MIL,PHI,MIL05,7,4,11
MIL200007050,2000,705,MIL,PHI,MIL05,5,2,7
MIL200007060,2000,706,MIL,PHI,MIL05,2,4,6
MIL200007070,2000,707,MIL,DET,MIL05,3,4,7
MIL200007080,2000,708,MIL,DET,MIL05,4,2,6
MIL200007090,2000,709,MIL,DET,MIL05,3,10,13
MIL200007190,2000,719,MIL,PIT,MIL05,0,6,6
MIL200007200,2000,720,MIL,PIT,MIL05,9,2,11
MIL200007280,2000,728,MIL,COL,MIL05,0,5,5
MIL200007290,2000,729,MIL,COL,MIL05,10,2,12
MIL200007300,2000,730,MIL,COL,MIL05,2,3,5
MIL200007310,2000,731,MIL,SFN,MIL05,4,3,7
MIL200008010,2000,801,MIL,SFN,MIL05,13,8,21
MIL200008020,2000,802,MIL,SFN,MIL05,4,6,10
MIL200008110,2000,811,MIL,SLN,MIL05,2,6,8
MIL200008120,2000,812,MIL,SLN,MIL05,2,1,3
MIL200008130,2000,813,MIL,SLN,MIL05,6,4,10
MIL200008140,2000,814,MIL,CIN,MIL05,3,4,7
MIL200008150,2000,815,MIL,CIN,MIL05,1,2,3
MIL200008160,2000,816,MIL,CIN,MIL05,1,5,6
MIL200008250,2000,825,MIL,SDN,MIL05,4,0,4
MIL200008260,2000,826,MIL,SDN,MIL05,5,6,11
MIL200008270,2000,827,MIL,SDN,MIL05,2,1,3
MIL200008280,2000,828,MIL,LAN,MIL05,5,3,8
MIL200008290,2000,829,MIL,LAN,MIL05,7,2,9
MIL200008300,2000,830,MIL,LAN,MIL05,2,3,5
MIL200008310,2000,831,MIL,LAN,MIL05,2,8,10
MIL200009080,2000,908,MIL,SLN,MIL05,5,6,11
MIL200009090,2000,909,MIL,SLN,MIL05,7,6,13
MIL200009100,2000,910,MIL,SLN,MIL05,3,4,7
MIL200009180,2000,918,MIL,CHN,MIL05,1,2,3
MIL200009190,2000,919,MIL,CHN,MIL05,8,9,17
MIL200009200,2000,920,MIL,CHN,MIL05,2,3,5
MIL200009210,2000,921,MIL,PIT,MIL05,2,12,14
MIL200009231,2000,923,MIL,PIT,MIL05,4,2,6
MIL200009232,2000,923,MIL,PIT,MIL05,4,5,9
MIL200009240,2000,924,MIL,PIT,MIL05,5,8,13
MIL200009260,2000,926,MIL,CIN,MIL05,4,7,11
MIL200009270,2000,927,MIL,CIN,MIL05,6,10,16
MIL200009280,2000,928,MIL,CIN,MIL05,8,1,9
MIL200104060,2001,10406,MIL,CIN,MIL06,4,5,9
MIL200104070,2001,10407,MIL,CIN,MIL06,1,6,7
MIL200104080,2001,10408,MIL,CIN,MIL06,4,8,12
MIL200104100,2001,10410,MIL,HOU,MIL06,3,0,3
MIL200104110,2001,10411,MIL,HOU,MIL06,7,1,8
MIL200104120,2001,10412,MIL,HOU,MIL06,4,12,16
MIL200104130,2001,10413,MIL,SFN,MIL06,7,3,10
MIL200104140,2001,10414,MIL,SFN,MIL06,6,11,17
MIL200104150,2001,10415,MIL,SFN,MIL06,4,7,11
MIL200104240,2001,10424,MIL,NYN,MIL06,4,6,10
MIL200104250,2001,10425,MIL,NYN,MIL06,2,7,9
MIL200104260,2001,10426,MIL,NYN,MIL06,8,12,20
MIL200104270,2001,10427,MIL,MON,MIL06,6,1,7
MIL200104280,2001,10428,MIL,MON,MIL06,4,8,12
MIL200104290,2001,10429,MIL,MON,MIL06,0,10,10
MIL200105070,2001,10507,MIL,CHN,MIL06,7,6,13
MIL200105080,2001,10508,MIL,CHN,MIL06,1,4,5
MIL200105090,2001,10509,MIL,CHN,MIL06,6,3,9
MIL200105100,2001,10510,MIL,CHN,MIL06,1,11,12
MIL200105110,2001,10511,MIL,PIT,MIL06,3,0,3
MIL200105120,2001,10512,MIL,PIT,MIL06,4,5,9
MIL200105130,2001,10513,MIL,PIT,MIL06,1,4,5
MIL200105140,2001,10514,MIL,PIT,MIL06,8,11,19
MIL200105220,2001,10522,MIL,SLN,MIL06,0,5,5
MIL200105230,2001,10523,MIL,SLN,MIL06,3,7,10
MIL200105240,2001,10524,MIL,SLN,MIL06,7,4,11
MIL200106010,2001,10601,MIL,CHN,MIL06,4,3,7
MIL200106020,2001,10602,MIL,CHN,MIL06,10,4,14
MIL200106030,2001,10603,MIL,CHN,MIL06,2,4,6
MIL200106050,2001,10605,MIL,CIN,MIL06,4,3,7
MIL200106060,2001,10606,MIL,CIN,MIL06,6,3,9
MIL200106150,2001,10615,MIL,KCA,MIL06,4,2,6
MIL200106160,2001,10616,MIL,KCA,MIL06,4,1,5
MIL200106170,2001,10617,MIL,KCA,MIL06,2,5,7
MIL200106290,2001,10629,MIL,HOU,MIL06,1,6,7
MIL200106300,2001,10630,MIL,HOU,MIL06,7,4,11
MIL200107010,2001,10701,MIL,HOU,MIL06,6,1,7
MIL200107020,2001,10702,MIL,HOU,MIL06,6,4,10
MIL200107030,2001,10703,MIL,SLN,MIL06,0,2,2
MIL200107040,2001,10704,MIL,SLN,MIL06,7,2,9
MIL200107050,2001,10705,MIL,SLN,MIL06,5,2,7
MIL200107120,2001,10712,MIL,MIN,MIL06,13,5,18
MIL200107130,2001,10713,MIL,MIN,MIL06,3,6,9
MIL200107140,2001,10714,MIL,MIN,MIL06,5,3,8
MIL200107150,2001,10715,MIL,CHA,MIL06,3,2,5
MIL200107160,2001,10716,MIL,CHA,MIL06,6,5,11
MIL200107170,2001,10717,MIL,CHA,MIL06,8,4,12
MIL200107230,2001,10723,MIL,LAN,MIL06,3,1,4
MIL200107240,2001,10724,MIL,LAN,MIL06,7,2,9
MIL200107250,2001,10725,MIL,LAN,MIL06,3,4,7
MIL200107270,2001,10727,MIL,SDN,MIL06,0,8,8
MIL200107280,2001,10728,MIL,SDN,MIL06,6,2,8
MIL200107290,2001,10729,MIL,SDN,MIL06,12,5,17
MIL200107310,2001,10731,MIL,FLO,MIL06,5,1,6
MIL200108010,2001,10801,MIL,FLO,MIL06,5,4,9
MIL200108020,2001,10802,MIL,FLO,MIL06,3,4,7
MIL200108030,2001,10803,MIL,ATL,MIL06,2,3,5
MIL200108040,2001,10804,MIL,ATL,MIL06,14,2,16
MIL200108050,2001,10805,MIL,ATL,MIL06,12,8,20
MIL200108140,2001,10814,MIL,PHI,MIL06,10,4,14
MIL200108150,2001,10815,MIL,PHI,MIL06,8,6,14
MIL200108160,2001,10816,MIL,PHI,MIL06,4,5,9
MIL200108240,2001,10824,MIL,COL,MIL06,12,6,18
MIL200108250,2001,10825,MIL,COL,MIL06,4,5,9
MIL200108260,2001,10826,MIL,COL,MIL06,3,2,5
MIL200108270,2001,10827,MIL,PIT,MIL06,5,12,17
MIL200108280,2001,10828,MIL,PIT,MIL06,6,5,11
MIL200108290,2001,10829,MIL,PIT,MIL06,8,9,17
MIL200108310,2001,10831,MIL,HOU,MIL06,3,2,5
MIL200109010,2001,10901,MIL,HOU,MIL06,3,4,7
MIL200109020,2001,10902,MIL,HOU,MIL06,1,0,1
MIL200109100,2001,10910,MIL,SLN,MIL06,8,0,8
MIL200109210,2001,10921,MIL,CIN,MIL06,5,2,7
MIL200109220,2001,10922,MIL,CIN,MIL06,3,1,4
MIL200109230,2001,10923,MIL,CIN,MIL06,3,6,9
MIL200110020,2001,11002,MIL,SLN,MIL06,5,1,6
MIL200110030,2001,11003,MIL,SLN,MIL06,7,9,16
MIL200110040,2001,11004,MIL,SLN,MIL06,10,3,13
MIL200110050,2001,11005,MIL,ARI,MIL06,5,0,5
MIL200110060,2001,11006,MIL,ARI,MIL06,4,5,9
MIL200110070,2001,11007,MIL,ARI,MIL06,5,15,20
MIL200204050,2002,20405,MIL,ARI,MIL06,2,6,8
MIL200204060,2002,20406,MIL,ARI,MIL06,6,3,9
MIL200204070,2002,20407,MIL,ARI,MIL06,2,0,2
MIL200204150,2002,20415,MIL,PIT,MIL06,6,1,7
MIL200204160,2002,20416,MIL,PIT,MIL06,5,1,6
MIL200204170,2002,20417,MIL,PIT,MIL06,3,2,5
MIL200204180,2002,20418,MIL,SLN,MIL06,5,7,12
MIL200204190,2002,20419,MIL,SLN,MIL06,1,6,7
MIL200204200,2002,20420,MIL,SLN,MIL06,3,5,8
MIL200204210,2002,20421,MIL,SLN,MIL06,3,5,8
MIL200204300,2002,20430,MIL,ATL,MIL06,3,4,7
MIL200205010,2002,20501,MIL,ATL,MIL06,3,1,4
MIL200205020,2002,20502,MIL,ATL,MIL06,3,2,5
MIL200205030,2002,20503,MIL,FLO,MIL06,8,4,12
MIL200205040,2002,20504,MIL,FLO,MIL06,4,6,10
MIL200205050,2002,20505,MIL,FLO,MIL06,7,4,11
MIL200205130,2002,20513,MIL,CIN,MIL06,5,0,5
MIL200205140,2002,20514,MIL,CIN,MIL06,4,3,7
MIL200205150,2002,20515,MIL,CIN,MIL06,7,4,11
MIL200205160,2002,20516,MIL,CIN,MIL06,2,1,3
MIL200205170,2002,20517,MIL,CHN,MIL06,2,6,8
MIL200205180,2002,20518,MIL,CHN,MIL06,1,3,4
MIL200205190,2002,20519,MIL,CHN,MIL06,5,4,9
MIL200205210,2002,20521,MIL,LAN,MIL06,6,8,14
MIL200205220,2002,20522,MIL,LAN,MIL06,1,0,1
MIL200205230,2002,20523,MIL,LAN,MIL06,16,3,19
MIL200205240,2002,20524,MIL,SDN,MIL06,2,6,8
MIL200205250,2002,20525,MIL,SDN,MIL06,0,2,2
MIL200205260,2002,20526,MIL,SDN,MIL06,8,7,15
MIL200206030,2002,20603,MIL,CHN,MIL06,6,7,13
MIL200206040,2002,20604,MIL,CHN,MIL06,5,6,11
MIL200206050,2002,20605,MIL,CHN,MIL06,5,1,6
MIL200206140,2002,20614,MIL,MIN,MIL06,5,7,12
MIL200206150,2002,20615,MIL,MIN,MIL06,5,2,7
MIL200206160,2002,20616,MIL,MIN,MIL06,7,6,13
MIL200206170,2002,20617,MIL,HOU,MIL06,2,5,7
MIL200206180,2002,20618,MIL,HOU,MIL06,1,7,8
MIL200206190,2002,20619,MIL,HOU,MIL06,1,8,9
MIL200206200,2002,20620,MIL,HOU,MIL06,9,3,12
MIL200206210,2002,20621,MIL,ANA,MIL06,11,4,15
MIL200206220,2002,20622,MIL,ANA,MIL06,8,2,10
MIL200206230,2002,20623,MIL,ANA,MIL06,5,2,7
MIL200207110,2002,20711,MIL,PIT,MIL06,3,2,5
MIL200207120,2002,20712,MIL,PIT,MIL06,9,2,11
MIL200207130,2002,20713,MIL,PIT,MIL06,5,3,8
MIL200207140,2002,20714,MIL,PIT,MIL06,3,5,8
MIL200207150,2002,20715,MIL,CIN,MIL06,2,0,2
MIL200207160,2002,20716,MIL,CIN,MIL06,6,1,7
MIL200207170,2002,20717,MIL,HOU,MIL06,7,3,10
MIL200207180,2002,20718,MIL,HOU,MIL06,4,2,6
MIL200207260,2002,20726,MIL,COL,MIL06,3,10,13
MIL200207270,2002,20727,MIL,COL,MIL06,5,6,11
MIL200207280,2002,20728,MIL,COL,MIL06,3,5,8
MIL200208060,2002,20806,MIL,NYN,MIL06,5,1,6
MIL200208070,2002,20807,MIL,NYN,MIL06,2,6,8
MIL200208080,2002,20808,MIL,NYN,MIL06,9,0,9
MIL200208090,2002,20809,MIL,MON,MIL06,11,4,15
MIL200208100,2002,20810,MIL,MON,MIL06,2,5,7
MIL200208110,2002,20811,MIL,MON,MIL06,2,6,8
MIL200208200,2002,20820,MIL,PHI,MIL06,1,2,3
MIL200208210,2002,20821,MIL,PHI,MIL06,13,3,16
MIL200208220,2002,20822,MIL,PHI,MIL06,7,0,7
MIL200208230,2002,20823,MIL,PIT,MIL06,6,3,9
MIL200208240,2002,20824,MIL,PIT,MIL06,17,10,27
MIL200208250,2002,20825,MIL,PIT,MIL06,3,2,5
MIL200208260,2002,20826,MIL,CHN,MIL06,1,2,3
MIL200208270,2002,20827,MIL,CHN,MIL06,6,2,8
MIL200208280,2002,20828,MIL,CHN,MIL06,1,5,6
MIL200208290,2002,20829,MIL,CHN,MIL06,13,10,23
MIL200209060,2002,20906,MIL,CIN,MIL06,5,3,8
MIL200209070,2002,20907,MIL,CIN,MIL06,6,9,15
MIL200209080,2002,20908,MIL,CIN,MIL06,5,4,9
MIL200209090,2002,20909,MIL,SLN,MIL06,3,0,3
MIL200209100,2002,20910,MIL,SLN,MIL06,8,3,11
MIL200209110,2002,20911,MIL,SLN,MIL06,4,3,7
MIL200209170,2002,20917,MIL,HOU,MIL06,4,5,9
MIL200209180,2002,20918,MIL,HOU,MIL06,3,1,4
MIL200209190,2002,20919,MIL,HOU,MIL06,4,5,9
MIL200209200,2002,20920,MIL,SFN,MIL06,5,1,6
MIL200209210,2002,20921,MIL,SFN,MIL06,3,1,4
MIL200209220,2002,20922,MIL,SFN,MIL06,3,1,4
MIL200304040,2003,30404,MIL,SFN,MIL06,7,5,12
MIL200304050,2003,30405,MIL,SFN,MIL06,6,5,11
MIL200304060,2003,30406,MIL,SFN,MIL06,5,0,5
MIL200304140,2003,30414,MIL,SLN,MIL06,7,5,12
MIL200304150,2003,30415,MIL,SLN,MIL06,1,6,7
MIL200304160,2003,30416,MIL,SLN,MIL06,15,2,17
MIL200304170,2003,30417,MIL,HOU,MIL06,2,4,6
MIL200304180,2003,30418,MIL,HOU,MIL06,11,5,16
MIL200304190,2003,30419,MIL,HOU,MIL06,2,3,5
MIL200304200,2003,30420,MIL,HOU,MIL06,4,5,9
MIL200304290,2003,30429,MIL,MON,MIL06,3,2,5
MIL200304300,2003,30430,MIL,MON,MIL06,9,5,14
MIL200305010,2003,30501,MIL,MON,MIL06,5,0,5
MIL200305020,2003,30502,MIL,NYN,MIL06,9,3,12
MIL200305030,2003,30503,MIL,NYN,MIL06,2,3,5
MIL200305040,2003,30504,MIL,NYN,MIL06,5,3,8
MIL200305120,2003,30512,MIL,CHN,MIL06,11,5,16
MIL200305130,2003,30513,MIL,CHN,MIL06,7,2,9
MIL200305140,2003,30514,MIL,CHN,MIL06,6,1,7
MIL200305150,2003,30515,MIL,CHN,MIL06,4,2,6
MIL200305160,2003,30516,MIL,CIN,MIL06,3,12,15
MIL200305170,2003,30517,MIL,CIN,MIL06,6,8,14
MIL200305180,2003,30518,MIL,CIN,MIL06,6,3,9
MIL200305190,2003,30519,MIL,SDN,MIL06,5,6,11
MIL200305200,2003,30520,MIL,SDN,MIL06,7,8,15
MIL200305210,2003,30521,MIL,SDN,MIL06,0,10,10
MIL200305230,2003,30523,MIL,LAN,MIL06,6,4,10
MIL200305240,2003,30524,MIL,LAN,MIL06,6,0,6
MIL200305250,2003,30525,MIL,LAN,MIL06,5,1,6
MIL200306060,2003,30606,MIL,BOS,MIL06,3,9,12
MIL200306070,2003,30607,MIL,BOS,MIL06,11,10,21
MIL200306080,2003,30608,MIL,BOS,MIL06,9,1,10
MIL200306100,2003,30610,MIL,FLO,MIL06,12,4,16
MIL200306110,2003,30611,MIL,FLO,MIL06,6,5,11
MIL200306120,2003,30612,MIL,FLO,MIL06,5,6,11
MIL200306160,2003,30616,MIL,SLN,MIL06,4,9,13
MIL200306170,2003,30617,MIL,SLN,MIL06,12,3,15
MIL200306180,2003,30618,MIL,SLN,MIL06,9,1,10
MIL200306190,2003,30619,MIL,SLN,MIL06,8,4,12
MIL200306200,2003,30620,MIL,MIN,MIL06,2,3,5
MIL200306210,2003,30621,MIL,MIN,MIL06,1,8,9
MIL200306220,2003,30622,MIL,MIN,MIL06,8,3,11
MIL200307040,2003,30704,MIL,COL,MIL06,8,6,14
MIL200307050,2003,30705,MIL,COL,MIL06,9,8,17
MIL200307060,2003,30706,MIL,COL,MIL06,1,3,4
MIL200307070,2003,30707,MIL,PIT,MIL06,2,9,11
MIL200307080,2003,30708,MIL,PIT,MIL06,8,7,15
MIL200307090,2003,30709,MIL,PIT,MIL06,1,2,3
MIL200307100,2003,30710,MIL,PIT,MIL06,5,4,9
MIL200307110,2003,30711,MIL,CIN,MIL06,6,1,7
MIL200307120,2003,30712,MIL,CIN,MIL06,5,1,6
MIL200307130,2003,30713,MIL,CIN,MIL06,10,8,18
MIL200307230,2003,30723,MIL,HOU,MIL06,3,2,5
MIL200307240,2003,30724,MIL,HOU,MIL06,1,2,3
MIL200308050,2003,30805,MIL,ATL,MIL06,3,4,7
MIL200308060,2003,30806,MIL,ATL,MIL06,10,2,12
MIL200308070,2003,30807,MIL,ATL,MIL06,7,1,8
MIL200308080,2003,30808,MIL,FLO,MIL06,5,3,8
MIL200308090,2003,30809,MIL,FLO,MIL06,7,1,8
MIL200308100,2003,30810,MIL,FLO,MIL06,4,5,9
MIL200308190,2003,30819,MIL,PHI,MIL06,4,6,10
MIL200308200,2003,30820,MIL,PHI,MIL06,1,10,11
MIL200308210,2003,30821,MIL,PHI,MIL06,2,5,7
MIL200308220,2003,30822,MIL,PIT,MIL06,2,3,5
MIL200308230,2003,30823,MIL,PIT,MIL06,6,7,13
MIL200308240,2003,30824,MIL,PIT,MIL06,9,10,19
MIL200309010,2003,30901,MIL,CIN,MIL06,5,4,9
MIL200309020,2003,30902,MIL,CIN,MIL06,3,4,7
MIL200309030,2003,30903,MIL,CIN,MIL06,6,9,15
MIL200309050,2003,30905,MIL,CHN,MIL06,4,2,6
MIL200309060,2003,30906,MIL,CHN,MIL06,8,4,12
MIL200309070,2003,30907,MIL,CHN,MIL06,9,2,11
MIL200309080,2003,30908,MIL,HOU,MIL06,8,4,12
MIL200309090,2003,30909,MIL,HOU,MIL06,7,6,13
MIL200309100,2003,30910,MIL,HOU,MIL06,3,1,4
MIL200309110,2003,30911,MIL,HOU,MIL06,3,5,8
MIL200309190,2003,30919,MIL,ARI,MIL06,3,2,5
MIL200309200,2003,30920,MIL,ARI,MIL06,10,4,14
MIL200309210,2003,30921,MIL,ARI,MIL06,4,6,10
MIL200309230,2003,30923,MIL,SLN,MIL06,5,1,6
MIL200309240,2003,30924,MIL,SLN,MIL06,8,4,12
MIL200404090,2004,40409,MIL,HOU,MIL06,13,7,20
MIL200404100,2004,40410,MIL,HOU,MIL06,1,6,7
MIL200404110,2004,40411,MIL,HOU,MIL06,7,4,11
MIL200404200,2004,40420,MIL,ARI,MIL06,2,4,6
MIL200404210,2004,40421,MIL,ARI,MIL06,6,10,16
MIL200404220,2004,40422,MIL,ARI,MIL06,11,9,20
MIL200404230,2004,40423,MIL,SLN,MIL06,1,2,3
MIL200404240,2004,40424,MIL,SLN,MIL06,1,3,4
MIL200404250,2004,40425,MIL,SLN,MIL06,5,2,7
MIL200404270,2004,40427,MIL,CIN,MIL06,8,9,17
MIL200404280,2004,40428,MIL,CIN,MIL06,9,10,19
MIL200404300,2004,40430,MIL,PIT,MIL06,4,2,6
MIL200405010,2004,40501,MIL,PIT,MIL06,8,7,15
MIL200405020,2004,40502,MIL,PIT,MIL06,4,3,7
MIL200405110,2004,40511,MIL,MON,MIL06,5,8,13
MIL200405120,2004,40512,MIL,MON,MIL06,3,4,7
MIL200405130,2004,40513,MIL,MON,MIL06,4,7,11
MIL200405140,2004,40514,MIL,ATL,MIL06,2,0,2
MIL200405150,2004,40515,MIL,ATL,MIL06,11,6,17
MIL200405160,2004,40516,MIL,ATL,MIL06,1,4,5
MIL200405250,2004,40525,MIL,LAN,MIL06,5,3,8
MIL200405260,2004,40526,MIL,LAN,MIL06,1,2,3
MIL200405270,2004,40527,MIL,LAN,MIL06,1,3,4
MIL200405280,2004,40528,MIL,SDN,MIL06,5,3,8
MIL200405290,2004,40529,MIL,SDN,MIL06,3,4,7
MIL200405300,2004,40530,MIL,SDN,MIL06,5,2,7
MIL200406110,2004,40611,MIL,HOU,MIL06,3,9,12
MIL200406120,2004,40612,MIL,HOU,MIL06,4,7,11
MIL200406130,2004,40613,MIL,HOU,MIL06,5,4,9
MIL200406150,2004,40615,MIL,SEA,MIL06,0,3,3
MIL200406160,2004,40616,MIL,SEA,MIL06,1,4,5
MIL200406170,2004,40617,MIL,SEA,MIL06,6,3,9
MIL200406180,2004,40618,MIL,MIN,MIL06,1,4,5
MIL200406190,2004,40619,MIL,MIN,MIL06,6,7,13
MIL200406200,2004,40620,MIL,MIN,MIL06,4,2,6
MIL200406220,2004,40622,MIL,COL,MIL06,2,6,8
MIL200406230,2004,40623,MIL,COL,MIL06,3,2,5
MIL200406240,2004,40624,MIL,COL,MIL06,3,0,3
MIL200407050,2004,40705,MIL,CHN,MIL06,0,1,1
MIL200407060,2004,40706,MIL,CHN,MIL06,2,4,6
MIL200407070,2004,40707,MIL,CHN,MIL06,0,4,4
MIL200407080,2004,40708,MIL,CIN,MIL06,9,3,12
MIL200407090,2004,40709,MIL,CIN,MIL06,3,0,3
MIL200407100,2004,40710,MIL,CIN,MIL06,0,5,5
MIL200407110,2004,40711,MIL,CIN,MIL06,9,6,15
MIL200407260,2004,40726,MIL,CHN,MIL06,3,1,4
MIL200407270,2004,40727,MIL,CHN,MIL06,7,1,8
MIL200407280,2004,40728,MIL,CHN,MIL06,3,6,9
MIL200407290,2004,40729,MIL,CHN,MIL06,4,0,4
MIL200407300,2004,40730,MIL,PIT,MIL06,0,5,5
MIL200407310,2004,40731,MIL,PIT,MIL06,4,1,5
MIL200408010,2004,40801,MIL,PIT,MIL06,7,8,15
MIL200408030,2004,40803,MIL,NYN,MIL06,12,3,15
MIL200408040,2004,40804,MIL,NYN,MIL06,6,5,11
MIL200408050,2004,40805,MIL,NYN,MIL06,11,6,17
MIL200408130,2004,40813,MIL,FLO,MIL06,4,6,10
MIL200408140,2004,40814,MIL,FLO,MIL06,11,1,12
MIL200408150,2004,40815,MIL,FLO,MIL06,5,3,8
MIL200408170,2004,40817,MIL,CHN,MIL06,1,3,4
MIL200408180,2004,40818,MIL,CHN,MIL06,7,5,12
MIL200408190,2004,40819,MIL,CHN,MIL06,9,6,15
MIL200408200,2004,40820,MIL,PHI,MIL06,4,2,6
MIL200408210,2004,40821,MIL,PHI,MIL06,8,6,14
MIL200408220,2004,40822,MIL,PHI,MIL06,9,6,15
MIL200408300,2004,40830,MIL,PIT,MIL06,5,1,6
MIL200408310,2004,40831,MIL,PIT,MIL06,2,4,6
MIL200409010,2004,40901,MIL,PIT,MIL06,5,2,7
MIL200409020,2004,40902,MIL,PIT,MIL06,1,7,8
MIL200409030,2004,40903,MIL,CIN,MIL06,4,11,15
MIL200409040,2004,40904,MIL,CIN,MIL06,3,7,10
MIL200409050,2004,40905,MIL,CIN,MIL06,9,2,11
MIL200409140,2004,40914,MIL,SFN,MIL06,3,2,5
MIL200409150,2004,40915,MIL,SFN,MIL06,8,1,9
MIL200409160,2004,40916,MIL,SFN,MIL06,4,0,4
MIL200409200,2004,40920,MIL,SLN,MIL06,7,4,11
MIL200409210,2004,40921,MIL,SLN,MIL06,4,6,10
MIL200409220,2004,40922,MIL,SLN,MIL06,3,2,5
MIL200409230,2004,40923,MIL,SLN,MIL06,4,2,6
MIL200409240,2004,40924,MIL,HOU,MIL06,1,0,1
MIL200409250,2004,40925,MIL,HOU,MIL06,0,8,8
MIL200409260,2004,40926,MIL,HOU,MIL06,11,7,18
MIL200504110,2005,50411,MIL,PIT,MIL06,2,6,8
MIL200504120,2005,50412,MIL,PIT,MIL06,4,2,6
MIL200504130,2005,50413,MIL,PIT,MIL06,2,6,8
MIL200504150,2005,50415,MIL,SLN,MIL06,3,0,3
MIL200504160,2005,50416,MIL,SLN,MIL06,5,3,8
MIL200504170,2005,50417,MIL,SLN,MIL06,3,2,5
MIL200504180,2005,50418,MIL,LAN,MIL06,7,3,10
MIL200504190,2005,50419,MIL,LAN,MIL06,8,6,14
MIL200504290,2005,50429,MIL,CIN,MIL06,3,4,7
MIL200504300,2005,50430,MIL,CIN,MIL06,5,6,11
MIL200505010,2005,50501,MIL,CIN,MIL06,3,13,16
MIL200505030,2005,50503,MIL,CHN,MIL06,1,4,5
MIL200505040,2005,50504,MIL,CHN,MIL06,3,4,7
MIL200505050,2005,50505,MIL,CHN,MIL06,5,6,11
MIL200505060,2005,50506,MIL,NYN,MIL06,7,4,11
MIL200505070,2005,50507,MIL,NYN,MIL06,7,5,12
MIL200505080,2005,50508,MIL,NYN,MIL06,4,5,9
MIL200505090,2005,50509,MIL,PHI,MIL06,4,2,6
MIL200505100,2005,50510,MIL,PHI,MIL06,5,8,13
MIL200505110,2005,50511,MIL,PHI,MIL06,2,5,7
MIL200505230,2005,50523,MIL,COL,MIL06,1,2,3
MIL200505240,2005,50524,MIL,COL,MIL06,1,6,7
MIL200505250,2005,50525,MIL,COL,MIL06,1,11,12
MIL200505270,2005,50527,MIL,HOU,MIL06,0,3,3
MIL200505280,2005,50528,MIL,HOU,MIL06,9,6,15
MIL200505290,2005,50529,MIL,HOU,MIL06,2,1,3
MIL200506060,2005,50606,MIL,NYA,MIL06,3,4,7
MIL200506070,2005,50607,MIL,NYA,MIL06,1,2,3
MIL200506080,2005,50608,MIL,NYA,MIL06,12,3,15
MIL200506200,2005,50620,MIL,CHN,MIL06,5,4,9
MIL200506210,2005,50621,MIL,CHN,MIL06,4,2,6
MIL200506220,2005,50622,MIL,CHN,MIL06,4,9,13
MIL200506230,2005,50623,MIL,CHN,MIL06,7,8,15
MIL200506240,2005,50624,MIL,MIN,MIL06,1,3,4
MIL200506250,2005,50625,MIL,MIN,MIL06,6,7,13
MIL200506260,2005,50626,MIL,MIN,MIL06,5,2,7
MIL200507010,2005,50701,MIL,PIT,MIL06,4,8,12
MIL200507020,2005,50702,MIL,PIT,MIL06,3,5,8
MIL200507030,2005,50703,MIL,PIT,MIL06,11,10,21
MIL200507140,2005,50714,MIL,WAS,MIL06,2,4,6
MIL200507150,2005,50715,MIL,WAS,MIL06,3,4,7
MIL200507160,2005,50716,MIL,WAS,MIL06,5,3,8
MIL200507170,2005,50717,MIL,WAS,MIL06,3,5,8
MIL200507250,2005,50725,MIL,ARI,MIL06,2,4,6
MIL200507260,2005,50726,MIL,ARI,MIL06,2,7,9
MIL200507270,2005,50727,MIL,ARI,MIL06,3,0,3
MIL200507280,2005,50728,MIL,SFN,MIL06,3,0,3
MIL200507290,2005,50729,MIL,SFN,MIL06,7,6,13
MIL200507300,2005,50730,MIL,SFN,MIL06,1,7,8
MIL200507310,2005,50731,MIL,SFN,MIL06,1,5,6
MIL200508080,2005,50808,MIL,SLN,MIL06,8,4,12
MIL200508090,2005,50809,MIL,SLN,MIL06,5,2,7
MIL200508100,2005,50810,MIL,SLN,MIL06,3,0,3
MIL200508120,2005,50812,MIL,CIN,MIL06,5,3,8
MIL200508130,2005,50813,MIL,CIN,MIL06,4,1,5
MIL200508140,2005,50814,MIL,CIN,MIL06,3,8,11
MIL200508230,2005,50823,MIL,FLO,MIL06,2,11,13
MIL200508240,2005,50824,MIL,FLO,MIL06,4,6,10
MIL200508250,2005,50825,MIL,FLO,MIL06,3,1,4
MIL200508260,2005,50826,MIL,ATL,MIL06,1,3,4
MIL200508270,2005,50827,MIL,ATL,MIL06,8,4,12
MIL200508280,2005,50828,MIL,ATL,MIL06,5,2,7
MIL200508300,2005,50830,MIL,PIT,MIL06,6,0,6
MIL200508310,2005,50831,MIL,PIT,MIL06,5,6,11
MIL200509010,2005,50901,MIL,SDN,MIL06,6,5,11
MIL200509020,2005,50902,MIL,SDN,MIL06,2,12,14
MIL200509030,2005,50903,MIL,SDN,MIL06,6,1,7
MIL200509040,2005,50904,MIL,SDN,MIL06,2,3,5
MIL200509090,2005,50909,MIL,HOU,MIL06,4,7,11
MIL200509100,2005,50910,MIL,HOU,MIL06,7,5,12
MIL200509110,2005,50911,MIL,HOU,MIL06,2,4,6
MIL200509200,2005,50920,MIL,CHN,MIL06,3,5,8
MIL200509210,2005,50921,MIL,CHN,MIL06,6,7,13
MIL200509220,2005,50922,MIL,CHN,MIL06,3,0,3
MIL200509230,2005,50923,MIL,SLN,MIL06,6,9,15
MIL200509240,2005,50924,MIL,SLN,MIL06,7,8,15
MIL200509250,2005,50925,MIL,SLN,MIL06,2,0,2
MIL200509260,2005,50926,MIL,CIN,MIL06,9,12,21
MIL200509270,2005,50927,MIL,CIN,MIL06,2,6,8
MIL200509280,2005,50928,MIL,CIN,MIL06,11,4,15
MIL200509290,2005,50929,MIL,CIN,MIL06,0,2,2
MIL200604030,2006,60403,MIL,PIT,MIL06,2,5,7
MIL200604040,2006,60404,MIL,PIT,MIL06,5,7,12
MIL200604050,2006,60405,MIL,PIT,MIL06,2,3,5
MIL200604070,2006,60407,MIL,ARI,MIL06,1,3,4
MIL200604080,2006,60408,MIL,ARI,MIL06,4,5,9
MIL200604090,2006,60409,MIL,ARI,MIL06,7,0,7
MIL200604200,2006,60420,MIL,CIN,MIL06,12,8,20
MIL200604210,2006,60421,MIL,CIN,MIL06,3,1,4
MIL200604220,2006,60422,MIL,CIN,MIL06,0,11,11
MIL200604230,2006,60423,MIL,CIN,MIL06,11,0,11
MIL200604240,2006,60424,MIL,ATL,MIL06,2,3,5
MIL200604250,2006,60425,MIL,ATL,MIL06,2,4,6
MIL200604260,2006,60426,MIL,ATL,MIL06,4,5,9
MIL200605010,2006,60501,MIL,HOU,MIL06,2,4,6
MIL200605020,2006,60502,MIL,HOU,MIL06,8,5,13
MIL200605030,2006,60503,MIL,SFN,MIL06,2,0,2
MIL200605040,2006,60504,MIL,SFN,MIL06,4,7,11
MIL200605120,2006,60512,MIL,NYN,MIL06,6,9,15
MIL200605130,2006,60513,MIL,NYN,MIL06,9,8,17
MIL200605140,2006,60514,MIL,NYN,MIL06,5,6,11
MIL200605160,2006,60516,MIL,PHI,MIL06,2,3,5
MIL200605170,2006,60517,MIL,PHI,MIL06,7,8,15
MIL200605180,2006,60518,MIL,PHI,MIL06,4,5,9
MIL200605190,2006,60519,MIL,MIN,MIL06,7,1,8
MIL200605200,2006,60520,MIL,MIN,MIL06,16,10,26
MIL200605210,2006,60521,MIL,MIN,MIL06,3,5,8
MIL200606020,2006,60602,MIL,WAS,MIL06,10,4,14
MIL200606030,2006,60603,MIL,WAS,MIL06,4,3,7
MIL200606040,2006,60604,MIL,WAS,MIL06,8,4,12
MIL200606050,2006,60605,MIL,SDN,MIL06,2,5,7
MIL200606060,2006,60606,MIL,SDN,MIL06,1,5,6
MIL200606070,2006,60607,MIL,SDN,MIL06,6,5,11
MIL200606080,2006,60608,MIL,SDN,MIL06,3,4,7
MIL200606090,2006,60609,MIL,SLN,MIL06,10,6,16
MIL200606100,2006,60610,MIL,SLN,MIL06,3,4,7
MIL200606110,2006,60611,MIL,SLN,MIL06,7,5,12
MIL200606160,2006,60616,MIL,CLE,MIL06,4,6,10
MIL200606170,2006,60617,MIL,CLE,MIL06,2,3,5
MIL200606180,2006,60618,MIL,CLE,MIL06,3,6,9
MIL200606190,2006,60619,MIL,DET,MIL06,3,1,4
MIL200606200,2006,60620,MIL,DET,MIL06,10,1,11
MIL200606210,2006,60621,MIL,DET,MIL06,3,4,7
MIL200607030,2006,60703,MIL,CIN,MIL06,7,8,15
MIL200607040,2006,60704,MIL,CIN,MIL06,2,5,7
MIL200607050,2006,60705,MIL,CIN,MIL06,5,6,11
MIL200607060,2006,60706,MIL,CHN,MIL06,0,2,2
MIL200607070,2006,60707,MIL,CHN,MIL06,7,2,9
MIL200607080,2006,60708,MIL,CHN,MIL06,3,1,4
MIL200607090,2006,60709,MIL,CHN,MIL06,11,4,15
MIL200607240,2006,60724,MIL,PIT,MIL06,8,12,20
MIL200607250,2006,60725,MIL,PIT,MIL06,6,1,7
MIL200607260,2006,60726,MIL,PIT,MIL06,8,4,12
MIL200607280,2006,60728,MIL,CIN,MIL06,4,3,7
MIL200607290,2006,60729,MIL,CIN,MIL06,3,6,9
MIL200607300,2006,60730,MIL,CIN,MIL06,3,4,7
MIL200608080,2006,60808,MIL,CHN,MIL06,6,3,9
MIL200608090,2006,60809,MIL,CHN,MIL06,3,6,9
MIL200608100,2006,60810,MIL,CHN,MIL06,6,8,14
MIL200608170,2006,60817,MIL,HOU,MIL06,7,3,10
MIL200608180,2006,60818,MIL,HOU,MIL06,2,3,5
MIL200608190,2006,60819,MIL,HOU,MIL06,4,6,10
MIL200608200,2006,60820,MIL,HOU,MIL06,3,1,4
MIL200608220,2006,60822,MIL,COL,MIL06,1,4,5
MIL200608230,2006,60823,MIL,COL,MIL06,1,7,8
MIL200608240,2006,60824,MIL,COL,MIL06,6,12,18
MIL200609010,2006,60901,MIL,FLO,MIL06,3,2,5
MIL200609020,2006,60902,MIL,FLO,MIL06,9,6,15
MIL200609030,2006,60903,MIL,FLO,MIL06,10,3,13
MIL200609040,2006,60904,MIL,LAN,MIL06,3,6,9
MIL200609050,2006,60905,MIL,LAN,MIL06,0,9,9
MIL200609060,2006,60906,MIL,LAN,MIL06,2,1,3
MIL200609080,2006,60908,MIL,HOU,MIL06,4,3,7
MIL200609090,2006,60909,MIL,HOU,MIL06,10,4,14
MIL200609100,2006,60910,MIL,HOU,MIL06,0,4,4
MIL200609180,2006,60918,MIL,SLN,MIL06,3,4,7
MIL200609190,2006,60919,MIL,SLN,MIL06,12,2,14
MIL200609200,2006,60920,MIL,SLN,MIL06,0,1,1
MIL200609210,2006,60921,MIL,SFN,MIL06,4,9,13
MIL200609220,2006,60922,MIL,SFN,MIL06,12,13,25
MIL200609230,2006,60923,MIL,SFN,MIL06,8,10,18
MIL200609240,2006,60924,MIL,SFN,MIL06,3,5,8
MIL200704020,2007,70402,MIL,LAN,MIL06,1,7,8
MIL200704030,2007,70403,MIL,LAN,MIL06,3,4,7
MIL200704040,2007,70404,MIL,LAN,MIL06,5,4,9
MIL200704060,2007,70406,MIL,CHN,MIL06,9,3,12
MIL200704070,2007,70407,MIL,CHN,MIL06,6,3,9
MIL200704080,2007,70408,MIL,CHN,MIL06,4,9,13
MIL200704180,2007,70418,MIL,PIT,MIL06,3,7,10
MIL200704190,2007,70419,MIL,PIT,MIL06,5,7,12
MIL200704200,2007,70420,MIL,HOU,MIL06,6,5,11
MIL200704210,2007,70421,MIL,HOU,MIL06,4,6,10
MIL200704220,2007,70422,MIL,HOU,MIL06,3,4,7
MIL200704300,2007,70430,MIL,SLN,MIL06,1,7,8
MIL200705010,2007,70501,MIL,SLN,MIL06,2,12,14
MIL200705020,2007,70502,MIL,SLN,MIL06,0,4,4
MIL200705030,2007,70503,MIL,PIT,MIL06,4,2,6
MIL200705040,2007,70504,MIL,PIT,MIL06,0,10,10
MIL200705050,2007,70505,MIL,PIT,MIL06,3,6,9
MIL200705060,2007,70506,MIL,PIT,MIL06,4,6,10
MIL200705070,2007,70507,MIL,WAS,MIL06,0,3,3
MIL200705080,2007,70508,MIL,WAS,MIL06,4,6,10
MIL200705090,2007,70509,MIL,WAS,MIL06,1,3,4
MIL200705180,2007,70518,MIL,MIN,MIL06,8,1,9
MIL200705190,2007,70519,MIL,MIN,MIL06,5,2,7
MIL200705200,2007,70520,MIL,MIN,MIL06,5,6,11
MIL200705280,2007,70528,MIL,ATL,MIL06,2,1,3
MIL200705290,2007,70529,MIL,ATL,MIL06,4,5,9
MIL200705300,2007,70530,MIL,ATL,MIL06,9,3,12
MIL200705310,2007,70531,MIL,FLO,MIL06,3,4,7
MIL200706010,2007,70601,MIL,FLO,MIL06,5,8,13
MIL200706020,2007,70602,MIL,FLO,MIL06,5,2,7
MIL200706030,2007,70603,MIL,FLO,MIL06,0,3,3
MIL200706040,2007,70604,MIL,CHN,MIL06,7,2,9
MIL200706050,2007,70605,MIL,CHN,MIL06,5,7,12
MIL200706060,2007,70606,MIL,CHN,MIL06,6,2,8
MIL200706180,2007,70618,MIL,SFN,MIL06,4,5,9
MIL200706190,2007,70619,MIL,SFN,MIL06,2,6,8
MIL200706200,2007,70620,MIL,SFN,MIL06,5,7,12
MIL200706220,2007,70622,MIL,KCA,MIL06,6,11,17
MIL200706230,2007,70623,MIL,KCA,MIL06,1,7,8
MIL200706240,2007,70624,MIL,KCA,MIL06,4,3,7
MIL200706250,2007,70625,MIL,HOU,MIL06,1,6,7
MIL200706260,2007,70626,MIL,HOU,MIL06,5,11,16
MIL200706270,2007,70627,MIL,HOU,MIL06,3,6,9
MIL200707130,2007,70713,MIL,COL,MIL06,10,6,16
MIL200707140,2007,70714,MIL,COL,MIL06,1,2,3
MIL200707150,2007,70715,MIL,COL,MIL06,3,4,7
MIL200707160,2007,70716,MIL,ARI,MIL06,3,4,7
MIL200707170,2007,70717,MIL,ARI,MIL06,2,3,5
MIL200707180,2007,70718,MIL,ARI,MIL06,5,2,7
MIL200707190,2007,70719,MIL,ARI,MIL06,1,10,11
MIL200707200,2007,70720,MIL,SFN,MIL06,8,4,12
MIL200707210,2007,70721,MIL,SFN,MIL06,8,0,8
MIL200707220,2007,70722,MIL,SFN,MIL06,5,7,12
MIL200707310,2007,70731,MIL,NYN,MIL06,2,4,6
MIL200708010,2007,70801,MIL,NYN,MIL06,8,5,13
MIL200708020,2007,70802,MIL,NYN,MIL06,12,4,16
MIL200708030,2007,70803,MIL,PHI,MIL06,1,2,3
MIL200708040,2007,70804,MIL,PHI,MIL06,5,6,11
MIL200708050,2007,70805,MIL,PHI,MIL06,8,6,14
MIL200708140,2007,70814,MIL,SLN,MIL06,12,4,16
MIL200708150,2007,70815,MIL,SLN,MIL06,8,3,11
MIL200708160,2007,70816,MIL,SLN,MIL06,8,0,8
MIL200708170,2007,70817,MIL,CIN,MIL06,8,3,11
MIL200708180,2007,70818,MIL,CIN,MIL06,4,8,12
MIL200708190,2007,70819,MIL,CIN,MIL06,7,6,13
MIL200708310,2007,70831,MIL,PIT,MIL06,2,3,5
MIL200709010,2007,70901,MIL,PIT,MIL06,3,12,15
MIL200709020,2007,70902,MIL,PIT,MIL06,4,7,11
MIL200709030,2007,70903,MIL,HOU,MIL06,9,7,16
MIL200709040,2007,70904,MIL,HOU,MIL06,3,5,8
MIL200709050,2007,70905,MIL,HOU,MIL06,2,14,16
MIL200709140,2007,70914,MIL,CIN,MIL06,6,5,11
MIL200709150,2007,70915,MIL,CIN,MIL06,3,5,8
MIL200709160,2007,70916,MIL,CIN,MIL06,2,5,7
MIL200709240,2007,70924,MIL,SLN,MIL06,5,13,18
MIL200709250,2007,70925,MIL,SLN,MIL06,1,9,10
MIL200709260,2007,70926,MIL,SLN,MIL06,7,3,10
MIL200709270,2007,70927,MIL,SDN,MIL06,9,5,14
MIL200709280,2007,70928,MIL,SDN,MIL06,6,3,9
MIL200709290,2007,70929,MIL,SDN,MIL06,3,4,7
MIL200709300,2007,70930,MIL,SDN,MIL06,6,11,17
MIL200804040,2008,80404,MIL,SFN,MIL06,4,13,17
MIL200804050,2008,80405,MIL,SFN,MIL06,4,5,9
MIL200804060,2008,80406,MIL,SFN,MIL06,0,7,7
MIL200804080,2008,80408,MIL,CIN,MIL06,2,3,5
MIL200804090,2008,80409,MIL,CIN,MIL06,12,4,16
MIL200804100,2008,80410,MIL,CIN,MIL06,4,1,5
MIL200804210,2008,80421,MIL,SLN,MIL06,4,3,7
MIL200804220,2008,80422,MIL,SLN,MIL06,8,9,17
MIL200804230,2008,80423,MIL,PHI,MIL06,4,5,9
MIL200804240,2008,80424,MIL,PHI,MIL06,3,1,4
MIL200804250,2008,80425,MIL,FLO,MIL06,3,0,3
MIL200804260,2008,80426,MIL,FLO,MIL06,3,4,7
MIL200804270,2008,80427,MIL,FLO,MIL06,3,2,5
MIL200805090,2008,80509,MIL,SLN,MIL06,3,4,7
MIL200805100,2008,80510,MIL,SLN,MIL06,5,3,8
MIL200805110,2008,80511,MIL,SLN,MIL06,3,5,8
MIL200805120,2008,80512,MIL,SLN,MIL06,3,8,11
MIL200805130,2008,80513,MIL,LAN,MIL06,3,5,8
MIL200805140,2008,80514,MIL,LAN,MIL06,6,4,10
MIL200805150,2008,80515,MIL,LAN,MIL06,7,2,9
MIL200805270,2008,80527,MIL,ATL,MIL06,2,3,5
MIL200805280,2008,80528,MIL,ATL,MIL06,0,1,1
MIL200805290,2008,80529,MIL,ATL,MIL06,8,1,9
MIL200805300,2008,80530,MIL,HOU,MIL06,1,5,6
MIL200805310,2008,80531,MIL,HOU,MIL06,1,4,5
MIL200806010,2008,80601,MIL,HOU,MIL06,1,10,11
MIL200806020,2008,80602,MIL,ARI,MIL06,3,4,7
MIL200806030,2008,80603,MIL,ARI,MIL06,1,7,8
MIL200806040,2008,80604,MIL,ARI,MIL06,1,10,11
MIL200806130,2008,80613,MIL,MIN,MIL06,10,2,12
MIL200806140,2008,80614,MIL,MIN,MIL06,9,4,13
MIL200806150,2008,80615,MIL,MIN,MIL06,2,4,6
MIL200806170,2008,80617,MIL,TOR,MIL06,0,7,7
MIL200806180,2008,80618,MIL,TOR,MIL06,4,5,9
MIL200806190,2008,80619,MIL,TOR,MIL06,7,8,15
MIL200806200,2008,80620,MIL,BAL,MIL06,8,5,13
MIL200806210,2008,80621,MIL,BAL,MIL06,2,3,5
MIL200806220,2008,80622,MIL,BAL,MIL06,3,7,10
MIL200807040,2008,80704,MIL,PIT,MIL06,1,9,10
MIL200807050,2008,80705,MIL,PIT,MIL06,1,2,3
MIL200807060,2008,80706,MIL,PIT,MIL06,6,11,17
MIL200807070,2008,80707,MIL,COL,MIL06,4,3,7
MIL200807080,2008,80708,MIL,COL,MIL06,3,7,10
MIL200807090,2008,80709,MIL,COL,MIL06,8,3,11
MIL200807100,2008,80710,MIL,COL,MIL06,1,11,12
MIL200807110,2008,80711,MIL,CIN,MIL06,6,5,11
MIL200807120,2008,80712,MIL,CIN,MIL06,8,2,10
MIL200807130,2008,80713,MIL,CIN,MIL06,2,3,5
MIL200807250,2008,80725,MIL,HOU,MIL06,3,1,4
MIL200807260,2008,80726,MIL,HOU,MIL06,4,6,10
MIL200807270,2008,80727,MIL,HOU,MIL06,11,6,17
MIL200807280,2008,80728,MIL,CHN,MIL06,6,4,10
MIL200807290,2008,80729,MIL,CHN,MIL06,7,1,8
MIL200807300,2008,80730,MIL,CHN,MIL06,7,2,9
MIL200807310,2008,80731,MIL,CHN,MIL06,11,4,15
MIL200808080,2008,80808,MIL,WAS,MIL06,0,5,5
MIL200808090,2008,80809,MIL,WAS,MIL06,0,6,6
MIL200808100,2008,80810,MIL,WAS,MIL06,4,5,9
MIL200808110,2008,80811,MIL,WAS,MIL06,1,7,8
MIL200808180,2008,80818,MIL,HOU,MIL06,3,9,12
MIL200808190,2008,80819,MIL,HOU,MIL06,5,2,7
MIL200808200,2008,80820,MIL,HOU,MIL06,2,5,7
MIL200808220,2008,80822,MIL,PIT,MIL06,4,10,14
MIL200808230,2008,80823,MIL,PIT,MIL06,3,6,9
MIL200808240,2008,80824,MIL,PIT,MIL06,3,4,7
MIL200809010,2008,80901,MIL,NYN,MIL06,4,2,6
MIL200809020,2008,80902,MIL,NYN,MIL06,6,5,11
MIL200809030,2008,80903,MIL,NYN,MIL06,9,2,11
MIL200809040,2008,80904,MIL,SDN,MIL06,5,2,7
MIL200809050,2008,80905,MIL,SDN,MIL06,2,3,5
MIL200809060,2008,80906,MIL,SDN,MIL06,0,1,1
MIL200809070,2008,80907,MIL,SDN,MIL06,10,1,11
MIL200809080,2008,80908,MIL,CIN,MIL06,5,4,9
MIL200809090,2008,80909,MIL,CIN,MIL06,5,4,9
MIL200809100,2008,80910,MIL,CIN,MIL06,3,4,7
MIL200809230,2008,80923,MIL,PIT,MIL06,5,7,12
MIL200809240,2008,80924,MIL,PIT,MIL06,2,4,6
MIL200809250,2008,80925,MIL,PIT,MIL06,1,5,6
MIL200809260,2008,80926,MIL,CHN,MIL06,1,5,6
MIL200809270,2008,80927,MIL,CHN,MIL06,7,3,10
MIL200809280,2008,80928,MIL,CHN,MIL06,1,3,4
MIL200810040,2008,81004,MIL,PHI,MIL06,1,4,5
MIL200810050,2008,81005,MIL,PHI,MIL06,6,2,8
MIL200904100,2009,90410,MIL,CHN,MIL06,3,4,7
MIL200904110,2009,90411,MIL,CHN,MIL06,6,5,11
MIL200904120,2009,90412,MIL,CHN,MIL06,8,5,13
MIL200904130,2009,90413,MIL,CIN,MIL06,7,6,13
MIL200904140,2009,90414,MIL,CIN,MIL06,6,1,7
MIL200904150,2009,90415,MIL,CIN,MIL06,3,9,12
MIL200904270,2009,90427,MIL,PIT,MIL06,5,10,15
MIL200904280,2009,90428,MIL,PIT,MIL06,5,6,11
MIL200904290,2009,90429,MIL,PIT,MIL06,0,1,1
MIL200904300,2009,90430,MIL,ARI,MIL06,1,4,5
MIL200905010,2009,90501,MIL,ARI,MIL06,5,2,7
MIL200905020,2009,90502,MIL,ARI,MIL06,4,1,5
MIL200905030,2009,90503,MIL,ARI,MIL06,3,4,7
MIL200905080,2009,90508,MIL,CHN,MIL06,2,3,5
MIL200905090,2009,90509,MIL,CHN,MIL06,6,12,18
MIL200905100,2009,90510,MIL,CHN,MIL06,4,2,6
MIL200905120,2009,90512,MIL,FLO,MIL06,3,6,9
MIL200905130,2009,90513,MIL,FLO,MIL06,6,8,14
MIL200905140,2009,90514,MIL,FLO,MIL06,3,5,8
MIL200905250,2009,90525,MIL,SLN,MIL06,0,1,1
MIL200905260,2009,90526,MIL,SLN,MIL06,8,1,9
MIL200905270,2009,90527,MIL,SLN,MIL06,3,2,5
MIL200905290,2009,90529,MIL,CIN,MIL06,2,3,5
MIL200905300,2009,90530,MIL,CIN,MIL06,5,9,14
MIL200905310,2009,90531,MIL,CIN,MIL06,2,5,7
MIL200906090,2009,90609,MIL,COL,MIL06,3,2,5
MIL200906100,2009,90610,MIL,COL,MIL06,4,2,6
MIL200906110,2009,90611,MIL,COL,MIL06,5,4,9
MIL200906120,2009,90612,MIL,CHA,MIL06,2,7,9
MIL200906130,2009,90613,MIL,CHA,MIL06,7,1,8
MIL200906140,2009,90614,MIL,CHA,MIL06,5,4,9
MIL200906230,2009,90623,MIL,MIN,MIL06,7,3,10
MIL200906240,2009,90624,MIL,MIN,MIL06,3,4,7
MIL200906250,2009,90625,MIL,MIN,MIL06,6,4,10
MIL200906260,2009,90626,MIL,SFN,MIL06,1,5,6
MIL200906270,2009,90627,MIL,SFN,MIL06,6,7,13
MIL200906280,2009,90628,MIL,SFN,MIL06,7,0,7
MIL200906290,2009,90629,MIL,NYN,MIL06,6,10,16
MIL200906300,2009,90630,MIL,NYN,MIL06,3,6,9
MIL200907010,2009,90701,MIL,NYN,MIL06,1,0,1
MIL200907070,2009,90707,MIL,SLN,MIL06,5,0,5
MIL200907080,2009,90708,MIL,SLN,MIL06,4,5,9
MIL200907090,2009,90709,MIL,SLN,MIL06,5,1,6
MIL200907100,2009,90710,MIL,LAN,MIL06,12,8,20
MIL200907110,2009,90711,MIL,LAN,MIL06,3,6,9
MIL200907120,2009,90712,MIL,LAN,MIL06,7,4,11
MIL200907240,2009,90724,MIL,ATL,MIL06,9,4,13
MIL200907250,2009,90725,MIL,ATL,MIL06,0,4,4
MIL200907260,2009,90726,MIL,ATL,MIL06,10,2,12
MIL200907270,2009,90727,MIL,WAS,MIL06,14,6,20
MIL200907280,2009,90728,MIL,WAS,MIL06,8,3,11
MIL200907290,2009,90729,MIL,WAS,MIL06,5,7,12
MIL200907300,2009,90730,MIL,WAS,MIL06,3,7,10
MIL200908110,2009,90811,MIL,SDN,MIL06,13,6,19
MIL200908120,2009,90812,MIL,SDN,MIL06,6,5,11
MIL200908130,2009,90813,MIL,SDN,MIL06,9,12,21
MIL200908140,2009,90814,MIL,HOU,MIL06,2,11,13
MIL200908150,2009,90815,MIL,HOU,MIL06,2,6,8
MIL200908160,2009,90816,MIL,HOU,MIL06,8,5,13
MIL200908250,2009,90825,MIL,CIN,MIL06,8,6,14
MIL200908260,2009,90826,MIL,CIN,MIL06,4,3,7
MIL200908270,2009,90827,MIL,CIN,MIL06,8,5,13
MIL200908280,2009,90828,MIL,PIT,MIL06,6,8,14
MIL200908290,2009,90829,MIL,PIT,MIL06,3,7,10
MIL200908300,2009,90830,MIL,PIT,MIL06,1,4,5
MIL200909040,2009,90904,MIL,SFN,MIL06,3,2,5
MIL200909050,2009,90905,MIL,SFN,MIL06,3,2,5
MIL200909060,2009,90906,MIL,SFN,MIL06,1,2,3
MIL200909070,2009,90907,MIL,SLN,MIL06,3,0,3
MIL200909080,2009,90908,MIL,SLN,MIL06,4,3,7
MIL200909090,2009,90909,MIL,SLN,MIL06,5,1,6
MIL200909180,2009,90918,MIL,HOU,MIL06,2,3,5
MIL200909190,2009,90919,MIL,HOU,MIL06,2,7,9
MIL200909200,2009,90920,MIL,HOU,MIL06,0,6,6
MIL200909210,2009,90921,MIL,CHN,MIL06,10,2,12
MIL200909220,2009,90922,MIL,CHN,MIL06,7,2,9
MIL200909230,2009,90923,MIL,CHN,MIL06,2,3,5
MIL200909240,2009,90924,MIL,PHI,MIL06,9,4,13
MIL200909250,2009,90925,MIL,PHI,MIL06,4,8,12
MIL200909260,2009,90926,MIL,PHI,MIL06,5,7,12
MIL200909270,2009,90927,MIL,PHI,MIL06,6,5,11
MIN200004030,2000,403,MIN,TBA,MIN03,7,0,7
MIN200004040,2000,404,MIN,TBA,MIN03,5,6,11
MIN200004050,2000,405,MIN,TBA,MIN03,7,10,17
MIN200004060,2000,406,MIN,TBA,MIN03,7,6,13
MIN200004140,2000,414,MIN,BAL,MIN03,9,10,19
MIN200004150,2000,415,MIN,BAL,MIN03,6,4,10
MIN200004160,2000,416,MIN,BAL,MIN03,5,0,5
MIN200004180,2000,418,MIN,KCA,MIN03,1,3,4
MIN200004190,2000,419,MIN,KCA,MIN03,6,7,13
MIN200004200,2000,420,MIN,KCA,MIN03,7,9,16
MIN200004280,2000,428,MIN,OAK,MIN03,5,2,7
MIN200004290,2000,429,MIN,OAK,MIN03,6,2,8
MIN200004300,2000,430,MIN,OAK,MIN03,8,2,10
MIN200005020,2000,502,MIN,SEA,MIN03,5,4,9
MIN200005030,2000,503,MIN,SEA,MIN03,4,5,9
MIN200005040,2000,504,MIN,DET,MIN03,8,6,14
MIN200005050,2000,505,MIN,DET,MIN03,10,8,18
MIN200005060,2000,506,MIN,DET,MIN03,1,6,7
MIN200005070,2000,507,MIN,DET,MIN03,0,4,4
MIN200005080,2000,508,MIN,CLE,MIN03,3,2,5
MIN200005090,2000,509,MIN,CLE,MIN03,5,6,11
MIN200005100,2000,510,MIN,CLE,MIN03,9,10,19
MIN200005230,2000,523,MIN,ANA,MIN03,7,4,11
MIN200005240,2000,524,MIN,ANA,MIN03,6,5,11
MIN200005250,2000,525,MIN,ANA,MIN03,3,1,4
MIN200005260,2000,526,MIN,TEX,MIN03,2,10,12
MIN200005270,2000,527,MIN,TEX,MIN03,5,10,15
MIN200005280,2000,528,MIN,TEX,MIN03,3,4,7
MIN200006090,2000,609,MIN,MIL,MIN03,6,9,15
MIN200006100,2000,610,MIN,MIL,MIN03,5,3,8
MIN200006110,2000,611,MIN,MIL,MIN03,5,3,8
MIN200006120,2000,612,MIN,OAK,MIN03,2,7,9
MIN200006130,2000,613,MIN,OAK,MIN03,6,5,11
MIN200006140,2000,614,MIN,OAK,MIN03,9,6,15
MIN200006150,2000,615,MIN,SEA,MIN03,12,5,17
MIN200006160,2000,616,MIN,SEA,MIN03,2,7,9
MIN200006170,2000,617,MIN,SEA,MIN03,12,3,15
MIN200006180,2000,618,MIN,SEA,MIN03,10,2,12
MIN200007030,2000,703,MIN,BOS,MIN03,11,8,19
MIN200007040,2000,704,MIN,BOS,MIN03,14,4,18
MIN200007050,2000,705,MIN,BOS,MIN03,11,8,19
MIN200007060,2000,706,MIN,BOS,MIN03,8,7,15
MIN200007130,2000,713,MIN,CHN,MIN03,1,5,6
MIN200007140,2000,714,MIN,CHN,MIN03,6,2,8
MIN200007150,2000,715,MIN,CHN,MIN03,8,4,12
MIN200007160,2000,716,MIN,SLN,MIN03,2,5,7
MIN200007170,2000,717,MIN,SLN,MIN03,8,3,11
MIN200007180,2000,718,MIN,SLN,MIN03,2,3,5
MIN200007190,2000,719,MIN,CHA,MIN03,3,2,5
MIN200007200,2000,720,MIN,CHA,MIN03,1,5,6
MIN200007210,2000,721,MIN,CLE,MIN03,1,2,3
MIN200007220,2000,722,MIN,CLE,MIN03,6,10,16
MIN200007230,2000,723,MIN,CLE,MIN03,8,3,11
MIN200007270,2000,727,MIN,NYA,MIN03,3,9,12
MIN200007280,2000,728,MIN,NYA,MIN03,9,5,14
MIN200007290,2000,729,MIN,NYA,MIN03,2,6,8
MIN200007300,2000,730,MIN,NYA,MIN03,7,4,11
MIN200008110,2000,811,MIN,TOR,MIN03,4,9,13
MIN200008120,2000,812,MIN,TOR,MIN03,3,6,9
MIN200008130,2000,813,MIN,TOR,MIN03,13,3,16
MIN200008150,2000,815,MIN,KCA,MIN03,2,6,8
MIN200008160,2000,816,MIN,KCA,MIN03,9,3,12
MIN200008170,2000,817,MIN,KCA,MIN03,8,4,12
MIN200008220,2000,822,MIN,TBA,MIN03,3,2,5
MIN200008230,2000,823,MIN,TBA,MIN03,2,8,10
MIN200008250,2000,825,MIN,DET,MIN03,3,8,11
MIN200008260,2000,826,MIN,DET,MIN03,8,2,10
MIN200008270,2000,827,MIN,DET,MIN03,6,7,13
MIN200009040,2000,904,MIN,BAL,MIN03,3,2,5
MIN200009050,2000,905,MIN,BAL,MIN03,6,5,11
MIN200009060,2000,906,MIN,BAL,MIN03,1,4,5
MIN200009150,2000,915,MIN,ANA,MIN03,16,5,21
MIN200009160,2000,916,MIN,ANA,MIN03,7,6,13
MIN200009170,2000,917,MIN,ANA,MIN03,0,1,1
MIN200009180,2000,918,MIN,TEX,MIN03,1,3,4
MIN200009190,2000,919,MIN,TEX,MIN03,7,15,22
MIN200009200,2000,920,MIN,TEX,MIN03,6,4,10
MIN200009210,2000,921,MIN,CHA,MIN03,9,4,13
MIN200009220,2000,922,MIN,CHA,MIN03,5,4,9
MIN200009230,2000,923,MIN,CHA,MIN03,5,3,8
MIN200009240,2000,924,MIN,CHA,MIN03,5,6,11
MIN200104090,2001,10409,MIN,DET,MIN03,5,11,16
MIN200104100,2001,10410,MIN,DET,MIN03,2,8,10
MIN200104110,2001,10411,MIN,DET,MIN03,1,12,13
MIN200104130,2001,10413,MIN,CHA,MIN03,4,7,11
MIN200104140,2001,10414,MIN,CHA,MIN03,4,9,13
MIN200104150,2001,10415,MIN,CHA,MIN03,3,4,7
MIN200104160,2001,10416,MIN,KCA,MIN03,5,3,8
MIN200104170,2001,10417,MIN,KCA,MIN03,5,6,11
MIN200104180,2001,10418,MIN,KCA,MIN03,3,5,8
MIN200104270,2001,10427,MIN,BAL,MIN03,3,6,9
MIN200104280,2001,10428,MIN,BAL,MIN03,5,2,7
MIN200104290,2001,10429,MIN,BAL,MIN03,0,4,4
MIN200104300,2001,10430,MIN,NYA,MIN03,1,2,3
MIN200105010,2001,10501,MIN,NYA,MIN03,4,0,4
MIN200105020,2001,10502,MIN,NYA,MIN03,2,4,6
MIN200105110,2001,10511,MIN,KCA,MIN03,4,5,9
MIN200105120,2001,10512,MIN,KCA,MIN03,12,4,16
MIN200105130,2001,10513,MIN,KCA,MIN03,3,7,10
MIN200105140,2001,10514,MIN,KCA,MIN03,1,3,4
MIN200105150,2001,10515,MIN,BOS,MIN03,5,2,7
MIN200105160,2001,10516,MIN,BOS,MIN03,3,4,7
MIN200105170,2001,10517,MIN,BOS,MIN03,3,5,8
MIN200105220,2001,10522,MIN,SEA,MIN03,11,12,23
MIN200105230,2001,10523,MIN,SEA,MIN03,5,4,9
MIN200105250,2001,10525,MIN,OAK,MIN03,4,2,6
MIN200105261,2001,10526,MIN,OAK,MIN03,5,4,9
MIN200105262,2001,10526,MIN,OAK,MIN03,6,7,13
MIN200105270,2001,10527,MIN,OAK,MIN03,3,9,12
MIN200106040,2001,10604,MIN,CLE,MIN03,10,11,21
MIN200106050,2001,10605,MIN,CLE,MIN03,5,0,5
MIN200106060,2001,10606,MIN,CLE,MIN03,5,2,7
MIN200106070,2001,10607,MIN,CLE,MIN03,6,2,8
MIN200106080,2001,10608,MIN,PIT,MIN03,6,8,14
MIN200106090,2001,10609,MIN,PIT,MIN03,2,3,5
MIN200106100,2001,10610,MIN,PIT,MIN03,11,8,19
MIN200106120,2001,10612,MIN,HOU,MIN03,0,7,7
MIN200106130,2001,10613,MIN,HOU,MIN03,1,3,4
MIN200106140,2001,10614,MIN,HOU,MIN03,8,3,11
MIN200106260,2001,10626,MIN,CHA,MIN03,6,7,13
MIN200106270,2001,10627,MIN,CHA,MIN03,1,4,5
MIN200106280,2001,10628,MIN,CHA,MIN03,6,3,9
MIN200106290,2001,10629,MIN,DET,MIN03,2,3,5
MIN200106300,2001,10630,MIN,DET,MIN03,2,3,5
MIN200107010,2001,10701,MIN,DET,MIN03,3,8,11
MIN200107060,2001,10706,MIN,CIN,MIN03,4,5,9
MIN200107070,2001,10707,MIN,CIN,MIN03,6,7,13
MIN200107080,2001,10708,MIN,CIN,MIN03,1,7,8
MIN200107180,2001,10718,MIN,OAK,MIN03,7,2,9
MIN200107190,2001,10719,MIN,OAK,MIN03,10,12,22
MIN200107200,2001,10720,MIN,SEA,MIN03,4,0,4
MIN200107210,2001,10721,MIN,SEA,MIN03,6,3,9
MIN200107220,2001,10722,MIN,SEA,MIN03,6,3,9
MIN200107230,2001,10723,MIN,SEA,MIN03,3,2,5
MIN200108030,2001,10803,MIN,KCA,MIN03,7,8,15
MIN200108040,2001,10804,MIN,KCA,MIN03,2,6,8
MIN200108050,2001,10805,MIN,KCA,MIN03,10,5,15
MIN200108070,2001,10807,MIN,CLE,MIN03,7,2,9
MIN200108080,2001,10808,MIN,CLE,MIN03,8,2,10
MIN200108090,2001,10809,MIN,CLE,MIN03,4,6,10
MIN200108170,2001,10817,MIN,TBA,MIN03,9,4,13
MIN200108180,2001,10818,MIN,TBA,MIN03,4,6,10
MIN200108190,2001,10819,MIN,TBA,MIN03,5,1,6
MIN200108200,2001,10820,MIN,TOR,MIN03,3,2,5
MIN200108210,2001,10821,MIN,TOR,MIN03,7,5,12
MIN200108220,2001,10822,MIN,TOR,MIN03,3,6,9
MIN200108230,2001,10823,MIN,TOR,MIN03,6,2,8
MIN200108280,2001,10828,MIN,TEX,MIN03,10,1,11
MIN200108290,2001,10829,MIN,TEX,MIN03,8,10,18
MIN200108300,2001,10830,MIN,TEX,MIN03,5,1,6
MIN200108310,2001,10831,MIN,ANA,MIN03,1,4,5
MIN200109010,2001,10901,MIN,ANA,MIN03,11,9,20
MIN200109020,2001,10902,MIN,ANA,MIN03,4,5,9
MIN200109180,2001,10918,MIN,DET,MIN03,3,8,11
MIN200109190,2001,10919,MIN,DET,MIN03,6,2,8
MIN200109200,2001,10920,MIN,DET,MIN03,0,3,3
MIN200109210,2001,10921,MIN,CLE,MIN03,2,6,8
MIN200109220,2001,10922,MIN,CLE,MIN03,4,2,6
MIN200109230,2001,10923,MIN,CLE,MIN03,4,2,6
MIN200110050,2001,11005,MIN,CHA,MIN03,7,4,11
MIN200110060,2001,11006,MIN,CHA,MIN03,5,6,11
MIN200110070,2001,11007,MIN,CHA,MIN03,5,8,13
MIN200204120,2002,20412,MIN,DET,MIN03,2,4,6
MIN200204130,2002,20413,MIN,DET,MIN03,3,7,10
MIN200204140,2002,20414,MIN,DET,MIN03,7,13,20
MIN200204160,2002,20416,MIN,KCA,MIN03,5,8,13
MIN200204170,2002,20417,MIN,KCA,MIN03,16,3,19
MIN200204180,2002,20418,MIN,KCA,MIN03,1,4,5
MIN200204190,2002,20419,MIN,CLE,MIN03,3,12,15
MIN200204200,2002,20420,MIN,CLE,MIN03,2,6,8
MIN200204210,2002,20421,MIN,CLE,MIN03,2,4,6
MIN200204290,2002,20429,MIN,TBA,MIN03,2,3,5
MIN200204300,2002,20430,MIN,TBA,MIN03,3,6,9
MIN200205010,2002,20501,MIN,TBA,MIN03,3,5,8
MIN200205020,2002,20502,MIN,TBA,MIN03,6,7,13
MIN200205030,2002,20503,MIN,DET,MIN03,4,8,12
MIN200205040,2002,20504,MIN,DET,MIN03,2,3,5
MIN200205050,2002,20505,MIN,DET,MIN03,7,6,13
MIN200205060,2002,20506,MIN,DET,MIN03,1,3,4
MIN200205070,2002,20507,MIN,KCA,MIN03,4,1,5
MIN200205080,2002,20508,MIN,KCA,MIN03,1,3,4
MIN200205100,2002,20510,MIN,NYA,MIN03,5,3,8
MIN200205110,2002,20511,MIN,NYA,MIN03,4,2,6
MIN200205120,2002,20512,MIN,NYA,MIN03,10,4,14
MIN200205210,2002,20521,MIN,TEX,MIN03,2,8,10
MIN200205220,2002,20522,MIN,TEX,MIN03,6,5,11
MIN200205300,2002,20530,MIN,ANA,MIN03,6,7,13
MIN200205310,2002,20531,MIN,ANA,MIN03,11,3,14
MIN200206010,2002,20601,MIN,ANA,MIN03,2,4,6
MIN200206020,2002,20602,MIN,ANA,MIN03,5,4,9
MIN200206040,2002,20604,MIN,CLE,MIN03,2,23,25
MIN200206050,2002,20605,MIN,CLE,MIN03,6,4,10
MIN200206060,2002,20606,MIN,CLE,MIN03,3,8,11
MIN200206070,2002,20607,MIN,FLO,MIN03,7,12,19
MIN200206080,2002,20608,MIN,FLO,MIN03,3,5,8
MIN200206090,2002,20609,MIN,FLO,MIN03,6,3,9
MIN200206100,2002,20610,MIN,ATL,MIN03,5,6,11
MIN200206110,2002,20611,MIN,ATL,MIN03,11,0,11
MIN200206120,2002,20612,MIN,ATL,MIN03,3,2,5
MIN200206240,2002,20624,MIN,CHA,MIN03,4,5,9
MIN200206250,2002,20625,MIN,CHA,MIN03,15,7,22
MIN200206260,2002,20626,MIN,CHA,MIN03,5,6,11
MIN200206270,2002,20627,MIN,CHA,MIN03,7,4,11
MIN200206280,2002,20628,MIN,MIL,MIN03,1,5,6
MIN200206290,2002,20629,MIN,MIL,MIN03,10,2,12
MIN200206300,2002,20630,MIN,MIL,MIN03,3,4,7
MIN200207110,2002,20711,MIN,TEX,MIN03,3,4,7
MIN200207120,2002,20712,MIN,TEX,MIN03,3,4,7
MIN200207130,2002,20713,MIN,TEX,MIN03,8,1,9
MIN200207140,2002,20714,MIN,TEX,MIN03,4,5,9
MIN200207150,2002,20715,MIN,ANA,MIN03,8,10,18
MIN200207160,2002,20716,MIN,ANA,MIN03,4,2,6
MIN200207260,2002,20726,MIN,TOR,MIN03,5,10,15
MIN200207270,2002,20727,MIN,TOR,MIN03,4,5,9
MIN200207280,2002,20728,MIN,TOR,MIN03,0,4,4
MIN200207300,2002,20730,MIN,CHA,MIN03,3,0,3
MIN200207310,2002,20731,MIN,CHA,MIN03,1,2,3
MIN200208010,2002,20801,MIN,CHA,MIN03,0,6,6
MIN200208020,2002,20802,MIN,KCA,MIN03,1,2,3
MIN200208030,2002,20803,MIN,KCA,MIN03,3,4,7
MIN200208040,2002,20804,MIN,KCA,MIN03,4,5,9
MIN200208050,2002,20805,MIN,KCA,MIN03,12,4,16
MIN200208130,2002,20813,MIN,BAL,MIN03,0,6,6
MIN200208140,2002,20814,MIN,BAL,MIN03,6,5,11
MIN200208150,2002,20815,MIN,BAL,MIN03,3,1,4
MIN200208160,2002,20816,MIN,BOS,MIN03,0,5,5
MIN200208170,2002,20817,MIN,BOS,MIN03,5,2,7
MIN200208180,2002,20818,MIN,BOS,MIN03,2,6,8
MIN200208270,2002,20827,MIN,SEA,MIN03,2,5,7
MIN200208280,2002,20828,MIN,SEA,MIN03,1,2,3
MIN200208290,2002,20829,MIN,SEA,MIN03,2,0,2
MIN200209060,2002,20906,MIN,OAK,MIN03,0,6,6
MIN200209070,2002,20907,MIN,OAK,MIN03,2,0,2
MIN200209080,2002,20908,MIN,OAK,MIN03,6,0,6
MIN200209090,2002,20909,MIN,DET,MIN03,2,5,7
MIN200209100,2002,20910,MIN,DET,MIN03,4,11,15
MIN200209110,2002,20911,MIN,DET,MIN03,2,8,10
MIN200209240,2002,20924,MIN,CLE,MIN03,3,4,7
MIN200209250,2002,20925,MIN,CLE,MIN03,5,7,12
MIN200209260,2002,20926,MIN,CLE,MIN03,8,4,12
MIN200209270,2002,20927,MIN,CHA,MIN03,1,3,4
MIN200209280,2002,20928,MIN,CHA,MIN03,2,3,5
MIN200209290,2002,20929,MIN,CHA,MIN03,1,3,4
MIN200210040,2002,21004,MIN,OAK,MIN03,6,3,9
MIN200210050,2002,21005,MIN,OAK,MIN03,2,11,13
MIN200210080,2002,21008,MIN,ANA,MIN03,1,2,3
MIN200210090,2002,21009,MIN,ANA,MIN03,6,3,9
MIN200304040,2003,30404,MIN,TOR,MIN03,7,2,9
MIN200304050,2003,30405,MIN,TOR,MIN03,4,3,7
MIN200304060,2003,30406,MIN,TOR,MIN03,8,1,9
MIN200304150,2003,30415,MIN,DET,MIN03,4,6,10
MIN200304160,2003,30416,MIN,DET,MIN03,2,4,6
MIN200304170,2003,30417,MIN,DET,MIN03,0,6,6
MIN200304180,2003,30418,MIN,NYA,MIN03,11,4,15
MIN200304190,2003,30419,MIN,NYA,MIN03,4,2,6
MIN200304200,2003,30420,MIN,NYA,MIN03,8,2,10
MIN200304210,2003,30421,MIN,NYA,MIN03,15,1,16
MIN200304290,2003,30429,MIN,TBA,MIN03,3,5,8
MIN200304300,2003,30430,MIN,TBA,MIN03,5,8,13
MIN200305010,2003,30501,MIN,TBA,MIN03,5,6,11
MIN200305090,2003,30509,MIN,BOS,MIN03,0,5,5
MIN200305100,2003,30510,MIN,BOS,MIN03,6,5,11
MIN200305110,2003,30511,MIN,BOS,MIN03,8,9,17
MIN200305120,2003,30512,MIN,KCA,MIN03,3,2,5
MIN200305130,2003,30513,MIN,KCA,MIN03,2,4,6
MIN200305140,2003,30514,MIN,KCA,MIN03,0,7,7
MIN200305150,2003,30515,MIN,KCA,MIN03,9,5,14
MIN200305160,2003,30516,MIN,CHA,MIN03,3,18,21
MIN200305170,2003,30517,MIN,CHA,MIN03,1,3,4
MIN200305180,2003,30518,MIN,CHA,MIN03,2,3,5
MIN200305270,2003,30527,MIN,OAK,MIN03,3,4,7
MIN200305280,2003,30528,MIN,OAK,MIN03,5,6,11
MIN200305290,2003,30529,MIN,SEA,MIN03,10,6,16
MIN200305300,2003,30530,MIN,SEA,MIN03,6,0,6
MIN200305310,2003,30531,MIN,SEA,MIN03,5,2,7
MIN200306010,2003,30601,MIN,SEA,MIN03,9,5,14
MIN200306100,2003,30610,MIN,COL,MIN03,5,0,5
MIN200306110,2003,30611,MIN,COL,MIN03,4,7,11
MIN200306120,2003,30612,MIN,COL,MIN03,3,15,18
MIN200306130,2003,30613,MIN,ARI,MIN03,1,3,4
MIN200306140,2003,30614,MIN,ARI,MIN03,9,2,11
MIN200306150,2003,30615,MIN,ARI,MIN03,12,8,20
MIN200306240,2003,30624,MIN,CHA,MIN03,2,1,3
MIN200306250,2003,30625,MIN,CHA,MIN03,5,6,11
MIN200306260,2003,30626,MIN,CHA,MIN03,5,1,6
MIN200306270,2003,30627,MIN,MIL,MIN03,13,1,14
MIN200306280,2003,30628,MIN,MIL,MIN03,2,5,7
MIN200306290,2003,30629,MIN,MIL,MIN03,4,5,9
MIN200307030,2003,30703,MIN,CLE,MIN03,4,1,5
MIN200307040,2003,30704,MIN,CLE,MIN03,2,9,11
MIN200307050,2003,30705,MIN,CLE,MIN03,13,2,15
MIN200307060,2003,30706,MIN,CLE,MIN03,5,3,8
MIN200307170,2003,30717,MIN,OAK,MIN03,2,6,8
MIN200307180,2003,30718,MIN,OAK,MIN03,2,3,5
MIN200307190,2003,30719,MIN,OAK,MIN03,4,9,13
MIN200307200,2003,30720,MIN,OAK,MIN03,4,6,10
MIN200307210,2003,30721,MIN,SEA,MIN03,4,5,9
MIN200307220,2003,30722,MIN,SEA,MIN03,10,8,18
MIN200307230,2003,30723,MIN,KCA,MIN03,8,3,11
MIN200307240,2003,30724,MIN,KCA,MIN03,2,6,8
MIN200307290,2003,30729,MIN,BAL,MIN03,7,5,12
MIN200307300,2003,30730,MIN,BAL,MIN03,1,5,6
MIN200307310,2003,30731,MIN,BAL,MIN03,9,10,19
MIN200308010,2003,30801,MIN,DET,MIN03,4,10,14
MIN200308020,2003,30802,MIN,DET,MIN03,9,2,11
MIN200308030,2003,30803,MIN,DET,MIN03,2,7,9
MIN200308110,2003,30811,MIN,CLE,MIN03,3,5,8
MIN200308120,2003,30812,MIN,CLE,MIN03,9,6,15
MIN200308130,2003,30813,MIN,CLE,MIN03,5,0,5
MIN200308140,2003,30814,MIN,CLE,MIN03,8,3,11
MIN200308210,2003,30821,MIN,KCA,MIN03,3,4,7
MIN200308220,2003,30822,MIN,KCA,MIN03,3,2,5
MIN200308230,2003,30823,MIN,KCA,MIN03,4,3,7
MIN200308240,2003,30824,MIN,KCA,MIN03,1,8,9
MIN200309010,2003,30901,MIN,ANA,MIN03,10,2,12
MIN200309020,2003,30902,MIN,ANA,MIN03,6,12,18
MIN200309030,2003,30903,MIN,ANA,MIN03,5,6,11
MIN200309050,2003,30905,MIN,TEX,MIN03,7,10,17
MIN200309060,2003,30906,MIN,TEX,MIN03,2,5,7
MIN200309070,2003,30907,MIN,TEX,MIN03,4,5,9
MIN200309160,2003,30916,MIN,CHA,MIN03,2,5,7
MIN200309170,2003,30917,MIN,CHA,MIN03,2,4,6
MIN200309180,2003,30918,MIN,CHA,MIN03,3,5,8
MIN200309190,2003,30919,MIN,DET,MIN03,2,6,8
MIN200309200,2003,30920,MIN,DET,MIN03,3,7,10
MIN200309210,2003,30921,MIN,DET,MIN03,4,6,10
MIN200309230,2003,30923,MIN,CLE,MIN03,1,4,5
MIN200309240,2003,30924,MIN,CLE,MIN03,2,3,5
MIN200310040,2003,31004,MIN,NYA,MIN03,3,1,4
MIN200310050,2003,31005,MIN,NYA,MIN03,8,1,9
MIN200404050,2004,40405,MIN,CLE,MIN03,4,7,11
MIN200404060,2004,40406,MIN,CLE,MIN03,6,7,13
MIN200404070,2004,40407,MIN,CLE,MIN03,11,4,15
MIN200404160,2004,40416,MIN,KCA,MIN03,7,9,16
MIN200404170,2004,40417,MIN,KCA,MIN03,4,8,12
MIN200404180,2004,40418,MIN,KCA,MIN03,3,8,11
MIN200404200,2004,40420,MIN,DET,MIN03,4,6,10
MIN200404210,2004,40421,MIN,DET,MIN03,11,8,19
MIN200404220,2004,40422,MIN,DET,MIN03,3,4,7
MIN200404260,2004,40426,MIN,TOR,MIN03,6,1,7
MIN200404270,2004,40427,MIN,TOR,MIN03,4,7,11
MIN200404280,2004,40428,MIN,TOR,MIN03,5,9,14
MIN200404300,2004,40430,MIN,ANA,MIN03,3,6,9
MIN200405010,2004,40501,MIN,ANA,MIN03,1,0,1
MIN200405020,2004,40502,MIN,ANA,MIN03,3,1,4
MIN200405110,2004,40511,MIN,SEA,MIN03,6,7,13
MIN200405120,2004,40512,MIN,SEA,MIN03,3,4,7
MIN200405130,2004,40513,MIN,SEA,MIN03,0,1,1
MIN200405200,2004,40520,MIN,CHA,MIN03,10,3,13
MIN200405210,2004,40521,MIN,CHA,MIN03,8,2,10
MIN200405220,2004,40522,MIN,CHA,MIN03,1,9,10
MIN200405230,2004,40523,MIN,CHA,MIN03,17,7,24
MIN200405310,2004,40531,MIN,TBA,MIN03,7,3,10
MIN200406010,2004,40601,MIN,TBA,MIN03,4,16,20
MIN200406020,2004,40602,MIN,TBA,MIN03,4,2,6
MIN200406030,2004,40603,MIN,TBA,MIN03,5,2,7
MIN200406040,2004,40604,MIN,DET,MIN03,2,3,5
MIN200406050,2004,40605,MIN,DET,MIN03,6,0,6
MIN200406060,2004,40606,MIN,DET,MIN03,5,6,11
MIN200406080,2004,40608,MIN,NYN,MIN03,1,2,3
MIN200406090,2004,40609,MIN,NYN,MIN03,3,5,8
MIN200406100,2004,40610,MIN,NYN,MIN03,2,3,5
MIN200406110,2004,40611,MIN,PHI,MIN03,11,6,17
MIN200406120,2004,40612,MIN,PHI,MIN03,1,6,7
MIN200406130,2004,40613,MIN,PHI,MIN03,2,1,3
MIN200406250,2004,40625,MIN,MIL,MIN03,3,6,9
MIN200406260,2004,40626,MIN,MIL,MIN03,7,2,9
MIN200406270,2004,40627,MIN,MIL,MIN03,7,3,10
MIN200406290,2004,40629,MIN,CHA,MIN03,6,2,8
MIN200406300,2004,40630,MIN,CHA,MIN03,9,6,15
MIN200407010,2004,40701,MIN,CHA,MIN03,2,1,3
MIN200407050,2004,40705,MIN,KCA,MIN03,0,9,9
MIN200407060,2004,40706,MIN,KCA,MIN03,0,4,4
MIN200407070,2004,40707,MIN,KCA,MIN03,0,12,12
MIN200407080,2004,40708,MIN,DET,MIN03,1,7,8
MIN200407090,2004,40709,MIN,DET,MIN03,5,3,8
MIN200407100,2004,40710,MIN,DET,MIN03,4,2,6
MIN200407110,2004,40711,MIN,DET,MIN03,2,0,2
MIN200407210,2004,40721,MIN,TBA,MIN03,2,12,14
MIN200407220,2004,40722,MIN,TBA,MIN03,5,7,12
MIN200407300,2004,40730,MIN,BOS,MIN03,8,2,10
MIN200407310,2004,40731,MIN,BOS,MIN03,4,5,9
MIN200408010,2004,40801,MIN,BOS,MIN03,3,4,7
MIN200408030,2004,40803,MIN,ANA,MIN03,0,10,10
MIN200408040,2004,40804,MIN,ANA,MIN03,3,6,9
MIN200408050,2004,40805,MIN,ANA,MIN03,8,3,11
MIN200408060,2004,40806,MIN,OAK,MIN03,3,1,4
MIN200408070,2004,40807,MIN,OAK,MIN03,3,4,7
MIN200408080,2004,40808,MIN,OAK,MIN03,6,5,11
MIN200408090,2004,40809,MIN,OAK,MIN03,8,2,10
MIN200408170,2004,40817,MIN,NYA,MIN03,2,8,10
MIN200408180,2004,40818,MIN,NYA,MIN03,2,7,9
MIN200408190,2004,40819,MIN,NYA,MIN03,13,10,23
MIN200408200,2004,40820,MIN,CLE,MIN03,1,5,6
MIN200408210,2004,40821,MIN,CLE,MIN03,1,8,9
MIN200408220,2004,40822,MIN,CLE,MIN03,3,7,10
MIN200408310,2004,40831,MIN,TEX,MIN03,5,8,13
MIN200409010,2004,40901,MIN,TEX,MIN03,2,4,6
MIN200409020,2004,40902,MIN,TEX,MIN03,0,2,2
MIN200409030,2004,40903,MIN,KCA,MIN03,0,2,2
MIN200409040,2004,40904,MIN,KCA,MIN03,3,4,7
MIN200409050,2004,40905,MIN,KCA,MIN03,12,3,15
MIN200409140,2004,40914,MIN,CHA,MIN03,2,10,12
MIN200409150,2004,40915,MIN,CHA,MIN03,1,6,7
MIN200409160,2004,40916,MIN,CHA,MIN03,1,10,11
MIN200409170,2004,40917,MIN,BAL,MIN03,11,2,13
MIN200409180,2004,40918,MIN,BAL,MIN03,12,3,15
MIN200409190,2004,40919,MIN,BAL,MIN03,1,5,6
MIN200410010,2004,41001,MIN,CLE,MIN03,3,4,7
MIN200410020,2004,41002,MIN,CLE,MIN03,5,6,11
MIN200410030,2004,41003,MIN,CLE,MIN03,5,2,7
MIN200410080,2004,41008,MIN,NYA,MIN03,8,4,12
MIN200410090,2004,41009,MIN,NYA,MIN03,6,5,11
MIN200504080,2005,50408,MIN,CHA,MIN03,5,1,6
MIN200504090,2005,50409,MIN,CHA,MIN03,8,5,13
MIN200504100,2005,50410,MIN,CHA,MIN03,2,5,7
MIN200504120,2005,50412,MIN,DET,MIN03,4,5,9
MIN200504130,2005,50413,MIN,DET,MIN03,4,8,12
MIN200504140,2005,50414,MIN,DET,MIN03,4,10,14
MIN200504200,2005,50420,MIN,KCA,MIN03,4,5,9
MIN200504210,2005,50421,MIN,KCA,MIN03,9,10,19
MIN200504290,2005,50429,MIN,ANA,MIN03,4,7,11
MIN200504300,2005,50430,MIN,ANA,MIN03,2,4,6
MIN200505010,2005,50501,MIN,ANA,MIN03,2,1,3
MIN200505030,2005,50503,MIN,CLE,MIN03,4,2,6
MIN200505040,2005,50504,MIN,CLE,MIN03,5,4,9
MIN200505050,2005,50505,MIN,CLE,MIN03,0,9,9
MIN200505130,2005,50513,MIN,TEX,MIN03,9,6,15
MIN200505140,2005,50514,MIN,TEX,MIN03,5,0,5
MIN200505150,2005,50515,MIN,TEX,MIN03,2,5,7
MIN200505170,2005,50517,MIN,TOR,MIN03,10,3,13
MIN200505180,2005,50518,MIN,TOR,MIN03,2,3,5
MIN200505190,2005,50519,MIN,TOR,MIN03,0,4,4
MIN200505200,2005,50520,MIN,MIL,MIN03,1,7,8
MIN200505210,2005,50521,MIN,MIL,MIN03,6,0,6
MIN200505220,2005,50522,MIN,MIL,MIN03,5,6,11
MIN200505310,2005,50531,MIN,CLE,MIN03,4,3,7
MIN200506010,2005,50601,MIN,CLE,MIN03,2,6,8
MIN200506020,2005,50602,MIN,CLE,MIN03,3,4,7
MIN200506030,2005,50603,MIN,NYA,MIN03,3,6,9
MIN200506040,2005,50604,MIN,NYA,MIN03,4,3,7
MIN200506050,2005,50605,MIN,NYA,MIN03,3,9,12
MIN200506140,2005,50614,MIN,SFN,MIN03,3,4,7
MIN200506150,2005,50615,MIN,SFN,MIN03,8,4,12
MIN200506160,2005,50616,MIN,SFN,MIN03,14,7,21
MIN200506170,2005,50617,MIN,SDN,MIN03,4,5,9
MIN200506180,2005,50618,MIN,SDN,MIN03,7,2,9
MIN200506190,2005,50619,MIN,SDN,MIN03,5,1,6
MIN200506210,2005,50621,MIN,DET,MIN03,7,2,9
MIN200506220,2005,50622,MIN,DET,MIN03,8,1,9
MIN200506230,2005,50623,MIN,DET,MIN03,2,6,8
MIN200506270,2005,50627,MIN,KCA,MIN03,1,3,4
MIN200506280,2005,50628,MIN,KCA,MIN03,8,11,19
MIN200506290,2005,50629,MIN,KCA,MIN03,3,1,4
MIN200507010,2005,50701,MIN,TBA,MIN03,4,7,11
MIN200507020,2005,50702,MIN,TBA,MIN03,1,4,5
MIN200507030,2005,50703,MIN,TBA,MIN03,2,3,5
MIN200507140,2005,50714,MIN,ANA,MIN03,3,2,5
MIN200507150,2005,50715,MIN,ANA,MIN03,3,2,5
MIN200507160,2005,50716,MIN,ANA,MIN03,4,5,9
MIN200507170,2005,50717,MIN,ANA,MIN03,2,1,3
MIN200507180,2005,50718,MIN,BAL,MIN03,3,2,5
MIN200507190,2005,50719,MIN,BAL,MIN03,3,4,7
MIN200507200,2005,50720,MIN,BAL,MIN03,2,3,5
MIN200508010,2005,50801,MIN,OAK,MIN03,2,1,3
MIN200508020,2005,50802,MIN,OAK,MIN03,5,2,7
MIN200508030,2005,50803,MIN,OAK,MIN03,3,4,7
MIN200508040,2005,50804,MIN,OAK,MIN03,5,2,7
MIN200508050,2005,50805,MIN,BOS,MIN03,0,12,12
MIN200508060,2005,50806,MIN,BOS,MIN03,3,4,7
MIN200508070,2005,50807,MIN,BOS,MIN03,11,7,18
MIN200508180,2005,50818,MIN,SEA,MIN03,3,7,10
MIN200508190,2005,50819,MIN,SEA,MIN03,4,7,11
MIN200508200,2005,50820,MIN,SEA,MIN03,8,3,11
MIN200508210,2005,50821,MIN,SEA,MIN03,3,8,11
MIN200508230,2005,50823,MIN,CHA,MIN03,0,1,1
MIN200508240,2005,50824,MIN,CHA,MIN03,6,4,10
MIN200508250,2005,50825,MIN,CHA,MIN03,2,1,3
MIN200509020,2005,50902,MIN,CLE,MIN03,6,1,7
MIN200509030,2005,50903,MIN,CLE,MIN03,2,3,5
MIN200509040,2005,50904,MIN,CLE,MIN03,5,7,12
MIN200509050,2005,50905,MIN,TEX,MIN03,7,0,7
MIN200509060,2005,50906,MIN,TEX,MIN03,10,7,17
MIN200509070,2005,50907,MIN,TEX,MIN03,6,8,14
MIN200509160,2005,50916,MIN,CHA,MIN03,2,1,3
MIN200509170,2005,50917,MIN,CHA,MIN03,0,5,5
MIN200509180,2005,50918,MIN,CHA,MIN03,2,1,3
MIN200509260,2005,50926,MIN,KCA,MIN03,5,0,5
MIN200509270,2005,50927,MIN,KCA,MIN03,1,3,4
MIN200509280,2005,50928,MIN,KCA,MIN03,3,6,9
MIN200509290,2005,50929,MIN,KCA,MIN03,10,6,16
MIN200509300,2005,50930,MIN,DET,MIN03,3,7,10
MIN200510010,2005,51001,MIN,DET,MIN03,0,3,3
MIN200510020,2005,51002,MIN,DET,MIN03,4,6,10
MIN200604110,2006,60411,MIN,OAK,MIN03,6,7,13
MIN200604120,2006,60412,MIN,OAK,MIN03,5,6,11
MIN200604130,2006,60413,MIN,OAK,MIN03,2,8,10
MIN200604140,2006,60414,MIN,NYA,MIN03,1,5,6
MIN200604150,2006,60415,MIN,NYA,MIN03,5,6,11
MIN200604160,2006,60416,MIN,NYA,MIN03,9,3,12
MIN200604180,2006,60418,MIN,ANA,MIN03,8,2,10
MIN200604190,2006,60419,MIN,ANA,MIN03,10,12,22
MIN200604200,2006,60420,MIN,ANA,MIN03,6,4,10
MIN200605010,2006,60501,MIN,SEA,MIN03,8,2,10
MIN200605020,2006,60502,MIN,SEA,MIN03,1,5,6
MIN200605030,2006,60503,MIN,KCA,MIN03,1,6,7
MIN200605040,2006,60504,MIN,KCA,MIN03,1,0,1
MIN200605050,2006,60505,MIN,DET,MIN03,9,6,15
MIN200605060,2006,60506,MIN,DET,MIN03,6,7,13
MIN200605070,2006,60507,MIN,DET,MIN03,2,4,6
MIN200605120,2006,60512,MIN,CHA,MIN03,1,10,11
MIN200605130,2006,60513,MIN,CHA,MIN03,4,8,12
MIN200605140,2006,60514,MIN,CHA,MIN03,9,7,16
MIN200605150,2006,60515,MIN,CHA,MIN03,7,3,10
MIN200605230,2006,60523,MIN,CLE,MIN03,5,6,11
MIN200605240,2006,60524,MIN,CLE,MIN03,11,0,11
MIN200605260,2006,60526,MIN,SEA,MIN03,1,3,4
MIN200605270,2006,60527,MIN,SEA,MIN03,5,9,14
MIN200605280,2006,60528,MIN,SEA,MIN03,3,4,7
MIN200606090,2006,60609,MIN,BAL,MIN03,5,7,12
MIN200606100,2006,60610,MIN,BAL,MIN03,9,7,16
MIN200606110,2006,60611,MIN,BAL,MIN03,0,4,4
MIN200606130,2006,60613,MIN,BOS,MIN03,2,5,7
MIN200606140,2006,60614,MIN,BOS,MIN03,1,8,9
MIN200606150,2006,60615,MIN,BOS,MIN03,3,5,8
MIN200606230,2006,60623,MIN,CHN,MIN03,2,7,9
MIN200606240,2006,60624,MIN,CHN,MIN03,0,3,3
MIN200606250,2006,60625,MIN,CHN,MIN03,1,8,9
MIN200606260,2006,60626,MIN,LAN,MIN03,2,8,10
MIN200606270,2006,60627,MIN,LAN,MIN03,2,9,11
MIN200606280,2006,60628,MIN,LAN,MIN03,3,6,9
MIN200606300,2006,60630,MIN,MIL,MIN03,2,8,10
MIN200607010,2006,60701,MIN,MIL,MIN03,7,10,17
MIN200607020,2006,60702,MIN,MIL,MIN03,0,8,8
MIN200607130,2006,60713,MIN,CLE,MIN03,6,4,10
MIN200607140,2006,60714,MIN,CLE,MIN03,2,3,5
MIN200607150,2006,60715,MIN,CLE,MIN03,2,6,8
MIN200607160,2006,60716,MIN,CLE,MIN03,2,5,7
MIN200607170,2006,60717,MIN,TBA,MIN03,3,6,9
MIN200607180,2006,60718,MIN,TBA,MIN03,1,8,9
MIN200607190,2006,60719,MIN,TBA,MIN03,2,7,9
MIN200607200,2006,60720,MIN,TBA,MIN03,4,6,10
MIN200607280,2006,60728,MIN,DET,MIN03,3,2,5
MIN200607290,2006,60729,MIN,DET,MIN03,8,6,14
MIN200607300,2006,60730,MIN,DET,MIN03,4,6,10
MIN200607310,2006,60731,MIN,TEX,MIN03,2,15,17
MIN200608010,2006,60801,MIN,TEX,MIN03,9,0,9
MIN200608020,2006,60802,MIN,TEX,MIN03,10,2,12
MIN200608100,2006,60810,MIN,TOR,MIN03,5,0,5
MIN200608110,2006,60811,MIN,TOR,MIN03,7,1,8
MIN200608120,2006,60812,MIN,TOR,MIN03,4,0,4
MIN200608130,2006,60813,MIN,TOR,MIN03,0,5,5
MIN200608150,2006,60815,MIN,CLE,MIN03,1,4,5
MIN200608160,2006,60816,MIN,CLE,MIN03,2,7,9
MIN200608170,2006,60817,MIN,CLE,MIN03,3,2,5
MIN200608180,2006,60818,MIN,CHA,MIN03,3,7,10
MIN200608190,2006,60819,MIN,CHA,MIN03,4,1,5
MIN200608200,2006,60820,MIN,CHA,MIN03,3,7,10
MIN200608290,2006,60829,MIN,KCA,MIN03,2,0,2
MIN200608300,2006,60830,MIN,KCA,MIN03,4,3,7
MIN200608310,2006,60831,MIN,KCA,MIN03,1,3,4
MIN200609070,2006,60907,MIN,DET,MIN03,7,2,9
MIN200609080,2006,60908,MIN,DET,MIN03,5,9,14
MIN200609090,2006,60909,MIN,DET,MIN03,1,2,3
MIN200609100,2006,60910,MIN,DET,MIN03,1,12,13
MIN200609110,2006,60911,MIN,OAK,MIN03,4,9,13
MIN200609120,2006,60912,MIN,OAK,MIN03,5,7,12
MIN200609130,2006,60913,MIN,OAK,MIN03,1,0,1
MIN200609250,2006,60925,MIN,KCA,MIN03,1,8,9
MIN200609260,2006,60926,MIN,KCA,MIN03,2,3,5
MIN200609270,2006,60927,MIN,KCA,MIN03,6,4,10
MIN200609280,2006,60928,MIN,KCA,MIN03,1,2,3
MIN200609290,2006,60929,MIN,CHA,MIN03,4,3,7
MIN200609300,2006,60930,MIN,CHA,MIN03,6,3,9
MIN200610010,2006,61001,MIN,CHA,MIN03,1,5,6
MIN200610030,2006,61003,MIN,OAK,MIN03,3,2,5
MIN200610040,2006,61004,MIN,OAK,MIN03,5,2,7
MIN200704020,2007,70402,MIN,BAL,MIN03,4,7,11
MIN200704030,2007,70403,MIN,BAL,MIN03,2,3,5
MIN200704040,2007,70404,MIN,BAL,MIN03,2,7,9
MIN200704090,2007,70409,MIN,NYA,MIN03,8,2,10
MIN200704100,2007,70410,MIN,NYA,MIN03,10,1,11
MIN200704110,2007,70411,MIN,NYA,MIN03,1,5,6
MIN200704120,2007,70412,MIN,TBA,MIN03,2,3,5
MIN200704130,2007,70413,MIN,TBA,MIN03,4,2,6
MIN200704140,2007,70414,MIN,TBA,MIN03,5,12,17
MIN200704150,2007,70415,MIN,TBA,MIN03,6,4,10
MIN200704230,2007,70423,MIN,CLE,MIN03,7,3,10
MIN200704240,2007,70424,MIN,CLE,MIN03,5,3,8
MIN200704250,2007,70425,MIN,KCA,MIN03,4,3,7
MIN200704260,2007,70426,MIN,KCA,MIN03,0,1,1
MIN200705040,2007,70504,MIN,BOS,MIN03,2,0,2
MIN200705050,2007,70505,MIN,BOS,MIN03,1,2,3
MIN200705060,2007,70506,MIN,BOS,MIN03,4,3,7
MIN200705080,2007,70508,MIN,CHA,MIN03,4,7,11
MIN200705090,2007,70509,MIN,CHA,MIN03,6,3,9
MIN200705100,2007,70510,MIN,CHA,MIN03,3,0,3
MIN200705110,2007,70511,MIN,DET,MIN03,7,3,10
MIN200705120,2007,70512,MIN,DET,MIN03,8,2,10
MIN200705130,2007,70513,MIN,DET,MIN03,4,16,20
MIN200705250,2007,70525,MIN,TOR,MIN03,3,4,7
MIN200705260,2007,70526,MIN,TOR,MIN03,9,8,17
MIN200705270,2007,70527,MIN,TOR,MIN03,2,4,6
MIN200705280,2007,70528,MIN,CHA,MIN03,4,10,14
MIN200705290,2007,70529,MIN,CHA,MIN03,2,9,11
MIN200705300,2007,70530,MIN,CHA,MIN03,6,7,13
MIN200706080,2007,70608,MIN,WAS,MIN03,8,5,13
MIN200706090,2007,70609,MIN,WAS,MIN03,3,1,4
MIN200706100,2007,70610,MIN,WAS,MIN03,3,6,9
MIN200706120,2007,70612,MIN,ATL,MIN03,3,7,10
MIN200706130,2007,70613,MIN,ATL,MIN03,0,6,6
MIN200706140,2007,70614,MIN,ATL,MIN03,2,3,5
MIN200706150,2007,70615,MIN,MIL,MIN03,11,3,14
MIN200706160,2007,70616,MIN,MIL,MIN03,5,2,7
MIN200706170,2007,70617,MIN,MIL,MIN03,9,10,19
MIN200706250,2007,70625,MIN,TOR,MIN03,8,5,13
MIN200706260,2007,70626,MIN,TOR,MIN03,1,2,3
MIN200706270,2007,70627,MIN,TOR,MIN03,5,4,9
MIN200706280,2007,70628,MIN,TOR,MIN03,5,8,13
MIN200707120,2007,70712,MIN,OAK,MIN03,2,6,8
MIN200707130,2007,70713,MIN,OAK,MIN03,3,5,8
MIN200707140,2007,70714,MIN,OAK,MIN03,3,4,7
MIN200707150,2007,70715,MIN,OAK,MIN03,3,4,7
MIN200707170,2007,70717,MIN,DET,MIN03,1,0,1
MIN200707180,2007,70718,MIN,DET,MIN03,3,2,5
MIN200707190,2007,70719,MIN,DET,MIN03,4,3,7
MIN200707200,2007,70720,MIN,ANA,MIN03,5,7,12
MIN200707210,2007,70721,MIN,ANA,MIN03,2,5,7
MIN200707220,2007,70722,MIN,ANA,MIN03,7,2,9
MIN200707300,2007,70730,MIN,KCA,MIN03,1,3,4
MIN200707310,2007,70731,MIN,KCA,MIN03,3,5,8
MIN200708010,2007,70801,MIN,KCA,MIN03,5,3,8
MIN200708030,2007,70803,MIN,CLE,MIN03,5,2,7
MIN200708040,2007,70804,MIN,CLE,MIN03,2,3,5
MIN200708050,2007,70805,MIN,CLE,MIN03,0,1,1
MIN200708060,2007,70806,MIN,CLE,MIN03,4,0,4
MIN200708170,2007,70817,MIN,TEX,MIN03,1,2,3
MIN200708180,2007,70818,MIN,TEX,MIN03,5,0,5
MIN200708190,2007,70819,MIN,TEX,MIN03,0,1,1
MIN200708200,2007,70820,MIN,SEA,MIN03,9,4,13
MIN200708210,2007,70821,MIN,SEA,MIN03,7,2,9
MIN200708220,2007,70822,MIN,SEA,MIN03,4,8,12
MIN200708311,2007,70831,MIN,KCA,MIN03,9,4,13
MIN200708312,2007,70831,MIN,KCA,MIN03,0,5,5
MIN200709010,2007,70901,MIN,KCA,MIN03,4,6,10
MIN200709020,2007,70902,MIN,KCA,MIN03,8,1,9
MIN200709030,2007,70903,MIN,CLE,MIN03,5,0,5
MIN200709040,2007,70904,MIN,CLE,MIN03,7,5,12
MIN200709050,2007,70905,MIN,CLE,MIN03,6,2,8
MIN200709140,2007,70914,MIN,DET,MIN03,4,2,6
MIN200709150,2007,70915,MIN,DET,MIN03,4,3,7
MIN200709160,2007,70916,MIN,DET,MIN03,6,4,10
MIN200709170,2007,70917,MIN,TEX,MIN03,4,5,9
MIN200709180,2007,70918,MIN,TEX,MIN03,2,4,6
MIN200709190,2007,70919,MIN,TEX,MIN03,2,4,6
MIN200709210,2007,70921,MIN,CHA,MIN03,6,4,10
MIN200709220,2007,70922,MIN,CHA,MIN03,8,3,11
MIN200709230,2007,70923,MIN,CHA,MIN03,1,7,8
MIN200803310,2008,80331,MIN,ANA,MIN03,2,3,5
MIN200804010,2008,80401,MIN,ANA,MIN03,9,1,10
MIN200804020,2008,80402,MIN,ANA,MIN03,1,0,1
MIN200804030,2008,80403,MIN,ANA,MIN03,5,4,9
MIN200804040,2008,80404,MIN,KCA,MIN03,3,4,7
MIN200804050,2008,80405,MIN,KCA,MIN03,4,6,10
MIN200804060,2008,80406,MIN,KCA,MIN03,3,1,4
MIN200804160,2008,80416,MIN,TBA,MIN03,5,6,11
MIN200804170,2008,80417,MIN,TBA,MIN03,7,3,10
MIN200804180,2008,80418,MIN,CLE,MIN03,4,0,4
MIN200804190,2008,80419,MIN,CLE,MIN03,0,3,3
MIN200804200,2008,80420,MIN,CLE,MIN03,1,2,3
MIN200804290,2008,80429,MIN,CHA,MIN03,1,3,4
MIN200804300,2008,80430,MIN,CHA,MIN03,3,4,7
MIN200805020,2008,80502,MIN,DET,MIN03,1,11,12
MIN200805030,2008,80503,MIN,DET,MIN03,1,4,5
MIN200805040,2008,80504,MIN,DET,MIN03,6,7,13
MIN200805090,2008,80509,MIN,BOS,MIN03,6,7,13
MIN200805100,2008,80510,MIN,BOS,MIN03,5,2,7
MIN200805110,2008,80511,MIN,BOS,MIN03,8,9,17
MIN200805120,2008,80512,MIN,BOS,MIN03,3,7,10
MIN200805130,2008,80513,MIN,TOR,MIN03,5,3,8
MIN200805140,2008,80514,MIN,TOR,MIN03,6,5,11
MIN200805150,2008,80515,MIN,TOR,MIN03,3,2,5
MIN200805190,2008,80519,MIN,TEX,MIN03,6,7,13
MIN200805200,2008,80520,MIN,TEX,MIN03,4,11,15
MIN200805210,2008,80521,MIN,TEX,MIN03,10,1,11
MIN200805220,2008,80522,MIN,TEX,MIN03,8,7,15
MIN200805300,2008,80530,MIN,NYA,MIN03,6,5,11
MIN200805310,2008,80531,MIN,NYA,MIN03,7,6,13
MIN200806010,2008,80601,MIN,NYA,MIN03,1,5,6
MIN200806020,2008,80602,MIN,NYA,MIN03,5,6,11
MIN200806030,2008,80603,MIN,BAL,MIN03,5,3,8
MIN200806040,2008,80604,MIN,BAL,MIN03,5,7,12
MIN200806050,2008,80605,MIN,BAL,MIN03,3,2,5
MIN200806170,2008,80617,MIN,WAS,MIN03,1,2,3
MIN200806180,2008,80618,MIN,WAS,MIN03,2,11,13
MIN200806190,2008,80619,MIN,WAS,MIN03,3,9,12
MIN200806200,2008,80620,MIN,ARI,MIN03,2,7,9
MIN200806210,2008,80621,MIN,ARI,MIN03,1,6,7
MIN200806220,2008,80622,MIN,ARI,MIN03,3,5,8
MIN200806270,2008,80627,MIN,MIL,MIN03,6,7,13
MIN200806280,2008,80628,MIN,MIL,MIN03,5,1,6
MIN200806290,2008,80629,MIN,MIL,MIN03,0,5,5
MIN200806300,2008,80630,MIN,DET,MIN03,5,4,9
MIN200807010,2008,80701,MIN,DET,MIN03,4,6,10
MIN200807020,2008,80702,MIN,DET,MIN03,0,7,7
MIN200807040,2008,80704,MIN,CLE,MIN03,3,12,15
MIN200807050,2008,80705,MIN,CLE,MIN03,6,9,15
MIN200807060,2008,80706,MIN,CLE,MIN03,3,4,7
MIN200807180,2008,80718,MIN,TEX,MIN03,0,6,6
MIN200807190,2008,80719,MIN,TEX,MIN03,2,14,16
MIN200807200,2008,80720,MIN,TEX,MIN03,1,0,1
MIN200807280,2008,80728,MIN,CHA,MIN03,0,7,7
MIN200807290,2008,80729,MIN,CHA,MIN03,5,6,11
MIN200807300,2008,80730,MIN,CHA,MIN03,8,3,11
MIN200807310,2008,80731,MIN,CHA,MIN03,6,10,16
MIN200808010,2008,80801,MIN,CLE,MIN03,1,4,5
MIN200808020,2008,80802,MIN,CLE,MIN03,5,1,6
MIN200808030,2008,80803,MIN,CLE,MIN03,2,6,8
MIN200808110,2008,80811,MIN,NYA,MIN03,0,4,4
MIN200808120,2008,80812,MIN,NYA,MIN03,9,6,15
MIN200808130,2008,80813,MIN,NYA,MIN03,2,4,6
MIN200808150,2008,80815,MIN,SEA,MIN03,3,9,12
MIN200808160,2008,80816,MIN,SEA,MIN03,6,7,13
MIN200808170,2008,80817,MIN,SEA,MIN03,8,11,19
MIN200808180,2008,80818,MIN,OAK,MIN03,3,2,5
MIN200808190,2008,80819,MIN,OAK,MIN03,2,13,15
MIN200808200,2008,80820,MIN,OAK,MIN03,1,3,4
MIN200809050,2008,80905,MIN,DET,MIN03,2,10,12
MIN200809060,2008,80906,MIN,DET,MIN03,6,4,10
MIN200809070,2008,80907,MIN,DET,MIN03,7,5,12
MIN200809090,2008,80909,MIN,KCA,MIN03,2,7,9
MIN200809100,2008,80910,MIN,KCA,MIN03,1,7,8
MIN200809110,2008,80911,MIN,KCA,MIN03,3,2,5
MIN200809230,2008,80923,MIN,CHA,MIN03,3,9,12
MIN200809240,2008,80924,MIN,CHA,MIN03,2,3,5
MIN200809250,2008,80925,MIN,CHA,MIN03,6,7,13
MIN200809260,2008,80926,MIN,KCA,MIN03,8,1,9
MIN200809270,2008,80927,MIN,KCA,MIN03,4,2,6
MIN200809280,2008,80928,MIN,KCA,MIN03,0,6,6
MIN200904060,2009,90406,MIN,SEA,MIN03,6,1,7
MIN200904070,2009,90407,MIN,SEA,MIN03,5,6,11
MIN200904080,2009,90408,MIN,SEA,MIN03,5,6,11
MIN200904090,2009,90409,MIN,SEA,MIN03,2,0,2
MIN200904130,2009,90413,MIN,TOR,MIN03,8,6,14
MIN200904140,2009,90414,MIN,TOR,MIN03,2,3,5
MIN200904150,2009,90415,MIN,TOR,MIN03,12,2,14
MIN200904160,2009,90416,MIN,TOR,MIN03,9,2,11
MIN200904170,2009,90417,MIN,ANA,MIN03,9,11,20
MIN200904180,2009,90418,MIN,ANA,MIN03,2,9,11
MIN200904190,2009,90419,MIN,ANA,MIN03,1,3,4
MIN200904270,2009,90427,MIN,TBA,MIN03,7,1,8
MIN200904280,2009,90428,MIN,TBA,MIN03,3,4,7
MIN200904290,2009,90429,MIN,TBA,MIN03,3,8,11
MIN200905010,2009,90501,MIN,KCA,MIN03,5,7,12
MIN200905020,2009,90502,MIN,KCA,MIN03,10,7,17
MIN200905030,2009,90503,MIN,KCA,MIN03,7,5,12
MIN200905080,2009,90508,MIN,SEA,MIN03,0,11,11
MIN200905090,2009,90509,MIN,SEA,MIN03,6,9,15
MIN200905100,2009,90510,MIN,SEA,MIN03,5,3,8
MIN200905120,2009,90512,MIN,DET,MIN03,2,6,8
MIN200905130,2009,90513,MIN,DET,MIN03,10,14,24
MIN200905140,2009,90514,MIN,DET,MIN03,5,6,11
MIN200905220,2009,90522,MIN,MIL,MIN03,3,11,14
MIN200905230,2009,90523,MIN,MIL,MIN03,2,6,8
MIN200905240,2009,90524,MIN,MIL,MIN03,3,6,9
MIN200905250,2009,90525,MIN,BOS,MIN03,6,5,11
MIN200905260,2009,90526,MIN,BOS,MIN03,2,5,7
MIN200905270,2009,90527,MIN,BOS,MIN03,2,4,6
MIN200905280,2009,90528,MIN,BOS,MIN03,3,1,4
MIN200906020,2009,90602,MIN,CLE,MIN03,3,4,7
MIN200906030,2009,90603,MIN,CLE,MIN03,10,1,11
MIN200906040,2009,90604,MIN,CLE,MIN03,3,11,14
MIN200906160,2009,90616,MIN,PIT,MIN03,2,8,10
MIN200906170,2009,90617,MIN,PIT,MIN03,8,2,10
MIN200906180,2009,90618,MIN,PIT,MIN03,1,5,6
MIN200906190,2009,90619,MIN,HOU,MIN03,2,5,7
MIN200906200,2009,90620,MIN,HOU,MIN03,6,5,11
MIN200906210,2009,90621,MIN,HOU,MIN03,4,1,5
MIN200907030,2009,90703,MIN,DET,MIN03,11,9,20
MIN200907040,2009,90704,MIN,DET,MIN03,3,4,7
MIN200907050,2009,90705,MIN,DET,MIN03,2,6,8
MIN200907070,2009,90707,MIN,NYA,MIN03,10,2,12
MIN200907080,2009,90708,MIN,NYA,MIN03,4,3,7
MIN200907090,2009,90709,MIN,NYA,MIN03,6,4,10
MIN200907100,2009,90710,MIN,CHA,MIN03,4,6,10
MIN200907110,2009,90711,MIN,CHA,MIN03,8,7,15
MIN200907120,2009,90712,MIN,CHA,MIN03,7,13,20
MIN200907270,2009,90727,MIN,CHA,MIN03,3,4,7
MIN200907280,2009,90728,MIN,CHA,MIN03,3,5,8
MIN200907290,2009,90729,MIN,CHA,MIN03,2,3,5
MIN200907310,2009,90731,MIN,ANA,MIN03,11,5,16
MIN200908010,2009,90801,MIN,ANA,MIN03,11,6,17
MIN200908020,2009,90802,MIN,ANA,MIN03,13,4,17
MIN200908110,2009,90811,MIN,KCA,MIN03,14,6,20
MIN200908120,2009,90812,MIN,KCA,MIN03,1,7,8
MIN200908130,2009,90813,MIN,KCA,MIN03,5,4,9
MIN200908140,2009,90814,MIN,CLE,MIN03,0,11,11
MIN200908150,2009,90815,MIN,CLE,MIN03,7,3,10
MIN200908160,2009,90816,MIN,CLE,MIN03,7,4,11
MIN200908240,2009,90824,MIN,BAL,MIN03,1,2,3
MIN200908250,2009,90825,MIN,BAL,MIN03,6,7,13
MIN200908260,2009,90826,MIN,BAL,MIN03,5,1,6
MIN200908280,2009,90828,MIN,TEX,MIN03,2,3,5
MIN200908290,2009,90829,MIN,TEX,MIN03,3,0,3
MIN200908300,2009,90830,MIN,TEX,MIN03,3,5,8
MIN200908310,2009,90831,MIN,CHA,MIN03,1,4,5
MIN200909010,2009,90901,MIN,CHA,MIN03,3,4,7
MIN200909020,2009,90902,MIN,CHA,MIN03,4,2,6
MIN200909110,2009,90911,MIN,OAK,MIN03,12,5,17
MIN200909120,2009,90912,MIN,OAK,MIN03,4,2,6
MIN200909130,2009,90913,MIN,OAK,MIN03,0,8,8
MIN200909140,2009,90914,MIN,CLE,MIN03,3,6,9
MIN200909150,2009,90915,MIN,CLE,MIN03,4,5,9
MIN200909160,2009,90916,MIN,CLE,MIN03,3,7,10
MIN200909180,2009,90918,MIN,DET,MIN03,0,3,3
MIN200909190,2009,90919,MIN,DET,MIN03,2,6,8
MIN200909200,2009,90920,MIN,DET,MIN03,6,2,8
MIN200910020,2009,91002,MIN,KCA,MIN03,7,10,17
MIN200910030,2009,91003,MIN,KCA,MIN03,4,5,9
MIN200910040,2009,91004,MIN,KCA,MIN03,4,13,17
MIN200910060,2009,91006,MIN,DET,MIN03,5,6,11
MIN200910110,2009,91011,MIN,NYA,MIN03,4,1,5
MON200004030,2000,403,MON,LAN,MON02,10,4,14
MON200004040,2000,404,MON,LAN,MON02,10,4,14
MON200004050,2000,405,MON,LAN,MON02,5,6,11
MON200004060,2000,406,MON,LAN,MON02,3,11,14
MON200004070,2000,407,MON,SDN,MON02,10,5,15
MON200004080,2000,408,MON,SDN,MON02,9,10,19
MON200004090,2000,409,MON,SDN,MON02,1,2,3
MON200004180,2000,418,MON,CHN,MON02,3,4,7
MON200004190,2000,419,MON,CHN,MON02,3,7,10
MON200004200,2000,420,MON,CHN,MON02,10,6,16
MON200004210,2000,421,MON,MIL,MON02,1,5,6
MON200004220,2000,422,MON,MIL,MON02,7,3,10
MON200004230,2000,423,MON,MIL,MON02,4,6,10
MON200004250,2000,425,MON,COL,MON02,4,10,14
MON200004260,2000,426,MON,COL,MON02,2,9,11
MON200005090,2000,509,MON,PHI,MON02,2,3,5
MON200005100,2000,510,MON,PHI,MON02,8,0,8
MON200005110,2000,511,MON,PHI,MON02,6,4,10
MON200005120,2000,512,MON,CHN,MON02,3,8,11
MON200005130,2000,513,MON,CHN,MON02,2,1,3
MON200005140,2000,514,MON,CHN,MON02,15,16,31
MON200005160,2000,516,MON,ARI,MON02,0,2,2
MON200005170,2000,517,MON,ARI,MON02,2,10,12
MON200005180,2000,518,MON,ARI,MON02,8,6,14
MON200005190,2000,519,MON,HOU,MON02,2,3,5
MON200005200,2000,520,MON,HOU,MON02,7,8,15
MON200005210,2000,521,MON,HOU,MON02,3,8,11
MON200006020,2000,602,MON,BAL,MON02,3,5,8
MON200006030,2000,603,MON,BAL,MON02,4,7,11
MON200006040,2000,604,MON,BAL,MON02,0,1,1
MON200006050,2000,605,MON,NYA,MON02,4,6,10
MON200006060,2000,606,MON,NYA,MON02,8,1,9
MON200006070,2000,607,MON,NYA,MON02,7,2,9
MON200006190,2000,619,MON,PIT,MON02,1,2,3
MON200006200,2000,620,MON,PIT,MON02,2,1,3
MON200006210,2000,621,MON,PIT,MON02,8,3,11
MON200006220,2000,622,MON,PIT,MON02,5,6,11
MON200006230,2000,623,MON,PHI,MON02,13,6,19
MON200006240,2000,624,MON,PHI,MON02,8,1,9
MON200006250,2000,625,MON,PHI,MON02,1,3,4
MON200006270,2000,627,MON,ATL,MON02,4,6,10
MON200006280,2000,628,MON,ATL,MON02,7,4,11
MON200006300,2000,630,MON,FLO,MON02,5,4,9
MON200007010,2000,701,MON,FLO,MON02,6,5,11
MON200007020,2000,702,MON,FLO,MON02,2,1,3
MON200007070,2000,707,MON,TOR,MON02,5,10,15
MON200007080,2000,708,MON,TOR,MON02,6,3,9
MON200007090,2000,709,MON,TOR,MON02,13,3,16
MON200007190,2000,719,MON,NYN,MON02,5,3,8
MON200007200,2000,720,MON,NYN,MON02,1,4,5
MON200007280,2000,728,MON,CIN,MON02,8,3,11
MON200007290,2000,729,MON,CIN,MON02,4,3,7
MON200007300,2000,730,MON,CIN,MON02,7,4,11
MON200007310,2000,731,MON,SLN,MON02,4,0,4
MON200008010,2000,801,MON,SLN,MON02,0,4,4
MON200008020,2000,802,MON,SLN,MON02,10,7,17
MON200008110,2000,811,MON,COL,MON02,10,3,13
MON200008120,2000,812,MON,COL,MON02,14,2,16
MON200008130,2000,813,MON,COL,MON02,5,3,8
MON200008140,2000,814,MON,COL,MON02,4,3,7
MON200008150,2000,815,MON,SFN,MON02,9,7,16
MON200008160,2000,816,MON,SFN,MON02,4,1,5
MON200008170,2000,817,MON,SFN,MON02,5,4,9
MON200008250,2000,825,MON,HOU,MON02,3,1,4
MON200008260,2000,826,MON,HOU,MON02,4,5,9
MON200008270,2000,827,MON,HOU,MON02,7,3,10
MON200008280,2000,828,MON,ARI,MON02,5,9,14
MON200008290,2000,829,MON,ARI,MON02,8,7,15
MON200008300,2000,830,MON,ARI,MON02,7,0,7
MON200009140,2000,914,MON,NYN,MON02,10,4,14
MON200009150,2000,915,MON,NYN,MON02,3,4,7
MON200009160,2000,916,MON,NYN,MON02,10,4,14
MON200009170,2000,917,MON,NYN,MON02,0,5,5
MON200009180,2000,918,MON,FLO,MON02,4,11,15
MON200009190,2000,919,MON,FLO,MON02,3,1,4
MON200009200,2000,920,MON,FLO,MON02,2,4,6
MON200009210,2000,921,MON,FLO,MON02,3,10,13
MON200009220,2000,922,MON,ATL,MON02,4,6,10
MON200009230,2000,923,MON,ATL,MON02,10,0,10
MON200009240,2000,924,MON,ATL,MON02,14,5,19
MON200009250,2000,925,MON,ATL,MON02,6,0,6
MON200104060,2001,10406,MON,NYN,MON02,6,10,16
MON200104070,2001,10407,MON,NYN,MON02,0,10,10
MON200104080,2001,10408,MON,NYN,MON02,2,5,7
MON200104090,2001,10409,MON,CHN,MON02,5,7,12
MON200104100,2001,10410,MON,CHN,MON02,4,2,6
MON200104110,2001,10411,MON,CHN,MON02,4,2,6
MON200104130,2001,10413,MON,FLO,MON02,9,3,12
MON200104140,2001,10414,MON,FLO,MON02,2,8,10
MON200104150,2001,10415,MON,FLO,MON02,6,3,9
MON200105010,2001,10501,MON,ARI,MON02,8,3,11
MON200105020,2001,10502,MON,ARI,MON02,3,4,7
MON200105030,2001,10503,MON,ARI,MON02,2,1,3
MON200105040,2001,10504,MON,HOU,MON02,8,4,12
MON200105050,2001,10505,MON,HOU,MON02,4,3,7
MON200105060,2001,10506,MON,HOU,MON02,13,7,20
MON200105150,2001,10515,MON,LAN,MON02,0,2,2
MON200105160,2001,10516,MON,LAN,MON02,7,2,9
MON200105170,2001,10517,MON,LAN,MON02,1,3,4
MON200105180,2001,10518,MON,SDN,MON02,1,3,4
MON200105190,2001,10519,MON,SDN,MON02,20,7,27
MON200105200,2001,10520,MON,SDN,MON02,5,3,8
MON200105210,2001,10521,MON,NYN,MON02,6,3,9
MON200105220,2001,10522,MON,NYN,MON02,0,3,3
MON200105230,2001,10523,MON,NYN,MON02,4,2,6
MON200105310,2001,10531,MON,PHI,MON02,5,2,7
MON200106010,2001,10601,MON,PHI,MON02,13,2,15
MON200106020,2001,10602,MON,PHI,MON02,5,12,17
MON200106030,2001,10603,MON,PHI,MON02,3,10,13
MON200106050,2001,10605,MON,ATL,MON02,3,1,4
MON200106060,2001,10606,MON,ATL,MON02,2,0,2
MON200106070,2001,10607,MON,ATL,MON02,4,3,7
MON200106150,2001,10615,MON,TOR,MON02,9,3,12
MON200106160,2001,10616,MON,TOR,MON02,2,7,9
MON200106170,2001,10617,MON,TOR,MON02,1,4,5
MON200106290,2001,10629,MON,PIT,MON02,3,12,15
MON200106300,2001,10630,MON,PIT,MON02,6,7,13
MON200107010,2001,10701,MON,PIT,MON02,3,9,12
MON200107030,2001,10703,MON,FLO,MON02,7,0,7
MON200107040,2001,10704,MON,FLO,MON02,6,9,15
MON200107050,2001,10705,MON,FLO,MON02,6,9,15
MON200107120,2001,10712,MON,TBA,MON02,10,0,10
MON200107130,2001,10713,MON,TBA,MON02,2,6,8
MON200107140,2001,10714,MON,TBA,MON02,2,10,12
MON200107150,2001,10715,MON,BOS,MON02,8,5,13
MON200107160,2001,10716,MON,BOS,MON02,6,5,11
MON200107170,2001,10717,MON,BOS,MON02,7,11,18
MON200107180,2001,10718,MON,PHI,MON02,6,7,13
MON200107190,2001,10719,MON,PHI,MON02,2,5,7
MON200107260,2001,10726,MON,ATL,MON02,2,3,5
MON200107270,2001,10727,MON,ATL,MON02,7,3,10
MON200107280,2001,10728,MON,ATL,MON02,10,5,15
MON200107290,2001,10729,MON,ATL,MON02,8,1,9
MON200108070,2001,10807,MON,SLN,MON02,3,1,4
MON200108080,2001,10808,MON,SLN,MON02,5,6,11
MON200108090,2001,10809,MON,SLN,MON02,9,6,15
MON200108100,2001,10810,MON,MIL,MON02,5,1,6
MON200108110,2001,10811,MON,MIL,MON02,6,0,6
MON200108120,2001,10812,MON,MIL,MON02,0,5,5
MON200108210,2001,10821,MON,SFN,MON02,10,2,12
MON200108220,2001,10822,MON,SFN,MON02,1,7,8
MON200108230,2001,10823,MON,SFN,MON02,10,5,15
MON200108240,2001,10824,MON,CIN,MON02,4,6,10
MON200108250,2001,10825,MON,CIN,MON02,4,2,6
MON200108260,2001,10826,MON,CIN,MON02,17,4,21
MON200109030,2001,10903,MON,ATL,MON02,5,0,5
MON200109040,2001,10904,MON,ATL,MON02,3,2,5
MON200109050,2001,10905,MON,ATL,MON02,4,10,14
MON200109060,2001,10906,MON,PHI,MON02,3,0,3
MON200109070,2001,10907,MON,PHI,MON02,2,4,6
MON200109080,2001,10908,MON,PHI,MON02,6,0,6
MON200109090,2001,10909,MON,PHI,MON02,12,4,16
MON200109170,2001,10917,MON,FLO,MON02,10,6,16
MON200109180,2001,10918,MON,FLO,MON02,3,1,4
MON200109190,2001,10919,MON,FLO,MON02,2,5,7
MON200109200,2001,10920,MON,COL,MON02,3,8,11
MON200109210,2001,10921,MON,COL,MON02,11,9,20
MON200109220,2001,10922,MON,COL,MON02,1,3,4
MON200109230,2001,10923,MON,COL,MON02,5,3,8
MON200109250,2001,10925,MON,NYN,MON02,2,0,2
MON200109260,2001,10926,MON,NYN,MON02,5,2,7
MON200109270,2001,10927,MON,NYN,MON02,12,6,18
MON200204020,2002,20402,MON,FLO,MON02,6,7,13
MON200204030,2002,20403,MON,FLO,MON02,6,5,11
MON200204040,2002,20404,MON,FLO,MON02,1,0,1
MON200204150,2002,20415,MON,CHN,MON02,6,4,10
MON200204160,2002,20416,MON,CHN,MON02,4,8,12
MON200204170,2002,20417,MON,CHN,MON02,8,15,23
MON200204180,2002,20418,MON,NYN,MON02,1,0,1
MON200204190,2002,20419,MON,NYN,MON02,3,5,8
MON200204200,2002,20420,MON,NYN,MON02,5,7,12
MON200204210,2002,20421,MON,NYN,MON02,3,6,9
MON200204230,2002,20423,MON,MIL,MON02,4,5,9
MON200204240,2002,20424,MON,MIL,MON02,4,5,9
MON200204250,2002,20425,MON,MIL,MON02,1,5,6
MON200204260,2002,20426,MON,SLN,MON02,7,6,13
MON200204270,2002,20427,MON,SLN,MON02,5,0,5
MON200204280,2002,20428,MON,SLN,MON02,2,5,7
MON200205070,2002,20507,MON,COL,MON02,5,3,8
MON200205080,2002,20508,MON,COL,MON02,5,0,5
MON200205090,2002,20509,MON,COL,MON02,5,6,11
MON200205100,2002,20510,MON,SFN,MON02,3,6,9
MON200205110,2002,20511,MON,SFN,MON02,3,2,5
MON200205120,2002,20512,MON,SFN,MON02,2,4,6
MON200205210,2002,20521,MON,ATL,MON02,4,5,9
MON200205220,2002,20522,MON,ATL,MON02,2,0,2
MON200205240,2002,20524,MON,PHI,MON02,1,4,5
MON200205250,2002,20525,MON,PHI,MON02,9,13,22
MON200205260,2002,20526,MON,PHI,MON02,5,6,11
MON200206030,2002,20603,MON,PIT,MON02,5,7,12
MON200206040,2002,20604,MON,PIT,MON02,5,2,7
MON200206050,2002,20605,MON,PIT,MON02,1,3,4
MON200206140,2002,20614,MON,TOR,MON02,2,8,10
MON200206150,2002,20615,MON,TOR,MON02,3,9,12
MON200206160,2002,20616,MON,TOR,MON02,5,6,11
MON200206180,2002,20618,MON,KCA,MON02,4,5,9
MON200206190,2002,20619,MON,KCA,MON02,3,6,9
MON200206200,2002,20620,MON,KCA,MON02,4,5,9
MON200206210,2002,20621,MON,CLE,MON02,1,3,4
MON200206220,2002,20622,MON,CLE,MON02,5,4,9
MON200206230,2002,20623,MON,CLE,MON02,2,7,9
MON200207110,2002,20711,MON,ATL,MON02,8,5,13
MON200207120,2002,20712,MON,ATL,MON02,8,3,11
MON200207130,2002,20713,MON,ATL,MON02,3,6,9
MON200207140,2002,20714,MON,ATL,MON02,3,10,13
MON200207150,2002,20715,MON,PHI,MON02,11,8,19
MON200207160,2002,20716,MON,PHI,MON02,6,3,9
MON200207170,2002,20717,MON,NYN,MON02,9,6,15
MON200207180,2002,20718,MON,NYN,MON02,1,2,3
MON200207250,2002,20725,MON,FLO,MON02,3,2,5
MON200207260,2002,20726,MON,FLO,MON02,5,6,11
MON200207270,2002,20727,MON,FLO,MON02,7,2,9
MON200207280,2002,20728,MON,FLO,MON02,1,4,5
MON200207300,2002,20730,MON,ARI,MON02,4,5,9
MON200207310,2002,20731,MON,ARI,MON02,5,1,6
MON200208010,2002,20801,MON,ARI,MON02,1,2,3
MON200208020,2002,20802,MON,HOU,MON02,1,3,4
MON200208030,2002,20803,MON,HOU,MON02,5,3,8
MON200208040,2002,20804,MON,HOU,MON02,5,4,9
MON200208130,2002,20813,MON,LAN,MON02,3,4,7
MON200208140,2002,20814,MON,LAN,MON02,5,2,7
MON200208150,2002,20815,MON,LAN,MON02,1,0,1
MON200208160,2002,20816,MON,SDN,MON02,6,11,17
MON200208170,2002,20817,MON,SDN,MON02,6,5,11
MON200208180,2002,20818,MON,SDN,MON02,2,9,11
MON200208190,2002,20819,MON,SDN,MON02,0,4,4
MON200208300,2002,20830,MON,ATL,MON02,4,2,6
MON200208310,2002,20831,MON,ATL,MON02,5,3,8
MON200209010,2002,20901,MON,ATL,MON02,6,4,10
MON200209020,2002,20902,MON,PHI,MON02,1,5,6
MON200209030,2002,20903,MON,PHI,MON02,6,7,13
MON200209040,2002,20904,MON,PHI,MON02,5,8,13
MON200209050,2002,20905,MON,PHI,MON02,4,1,5
MON200209120,2002,20912,MON,NYN,MON02,8,2,10
MON200209130,2002,20913,MON,NYN,MON02,8,11,19
MON200209140,2002,20914,MON,NYN,MON02,4,5,9
MON200209150,2002,20915,MON,NYN,MON02,1,10,11
MON200209240,2002,20924,MON,FLO,MON02,9,6,15
MON200209250,2002,20925,MON,FLO,MON02,10,2,12
MON200209260,2002,20926,MON,FLO,MON02,3,4,7
MON200209270,2002,20927,MON,CIN,MON02,3,4,7
MON200209280,2002,20928,MON,CIN,MON02,0,6,6
MON200209290,2002,20929,MON,CIN,MON02,2,7,9
MON200304110,2003,30411,MON,NYN,SJU01,0,10,10
MON200304120,2003,30412,MON,NYN,SJU01,4,5,9
MON200304130,2003,30413,MON,NYN,SJU01,1,2,3
MON200304140,2003,30414,MON,NYN,SJU01,3,5,8
MON200304150,2003,30415,MON,ATL,SJU01,2,1,3
MON200304160,2003,30416,MON,ATL,SJU01,3,2,5
MON200304170,2003,30417,MON,ATL,SJU01,14,8,22
MON200304191,2003,30419,MON,CIN,SJU01,7,8,15
MON200304192,2003,30419,MON,CIN,SJU01,5,9,14
MON200304200,2003,30420,MON,CIN,SJU01,7,5,12
MON200304220,2003,30422,MON,ARI,MON02,0,4,4
MON200304230,2003,30423,MON,ARI,MON02,6,2,8
MON200304240,2003,30424,MON,ARI,MON02,0,1,1
MON200304250,2003,30425,MON,HOU,MON02,2,10,12
MON200304260,2003,30426,MON,HOU,MON02,2,3,5
MON200304270,2003,30427,MON,HOU,MON02,6,3,9
MON200305060,2003,30506,MON,SDN,MON02,2,4,6
MON200305070,2003,30507,MON,SDN,MON02,9,12,21
MON200305080,2003,30508,MON,SDN,MON02,5,12,17
MON200305090,2003,30509,MON,LAN,MON02,9,5,14
MON200305100,2003,30510,MON,LAN,MON02,5,6,11
MON200305110,2003,30511,MON,LAN,MON02,4,3,7
MON200305200,2003,30520,MON,FLO,MON02,4,6,10
MON200305210,2003,30521,MON,FLO,MON02,2,7,9
MON200305220,2003,30522,MON,FLO,MON02,2,8,10
MON200305230,2003,30523,MON,PHI,MON02,4,2,6
MON200305240,2003,30524,MON,PHI,MON02,2,3,5
MON200305250,2003,30525,MON,PHI,MON02,3,5,8
MON200306030,2003,30603,MON,ANA,SJU01,15,4,19
MON200306040,2003,30604,MON,ANA,SJU01,11,2,13
MON200306050,2003,30605,MON,ANA,SJU01,7,8,15
MON200306060,2003,30606,MON,TEX,SJU01,10,13,23
MON200306070,2003,30607,MON,TEX,SJU01,4,5,9
MON200306080,2003,30608,MON,TEX,SJU01,2,3,5
MON200306200,2003,30620,MON,TOR,MON02,8,4,12
MON200306210,2003,30621,MON,TOR,MON02,5,8,13
MON200306220,2003,30622,MON,TOR,MON02,4,2,6
MON200306230,2003,30623,MON,PIT,MON02,0,3,3
MON200306240,2003,30624,MON,PIT,MON02,4,6,10
MON200306250,2003,30625,MON,PIT,MON02,6,5,11
MON200307070,2003,30707,MON,PHI,MON02,1,8,9
MON200307080,2003,30708,MON,PHI,MON02,13,6,19
MON200307090,2003,30709,MON,PHI,MON02,2,0,2
MON200307110,2003,30711,MON,FLO,MON02,5,4,9
MON200307120,2003,30712,MON,FLO,MON02,1,7,8
MON200307130,2003,30713,MON,FLO,MON02,11,4,15
MON200307230,2003,30723,MON,NYN,MON02,2,5,7
MON200307240,2003,30724,MON,NYN,MON02,1,5,6
MON200307250,2003,30725,MON,ATL,MON02,8,9,17
MON200307260,2003,30726,MON,ATL,MON02,15,4,19
MON200307270,2003,30727,MON,ATL,MON02,10,13,23
MON200307280,2003,30728,MON,ATL,MON02,10,8,18
MON200307290,2003,30729,MON,SLN,MON02,2,1,3
MON200307300,2003,30730,MON,SLN,MON02,11,1,12
MON200307310,2003,30731,MON,SLN,MON02,2,3,5
MON200308010,2003,30801,MON,MIL,MON02,4,8,12
MON200308020,2003,30802,MON,MIL,MON02,1,7,8
MON200308030,2003,30803,MON,MIL,MON02,2,4,6
MON200308110,2003,30811,MON,COL,MON02,1,3,4
MON200308120,2003,30812,MON,COL,MON02,6,3,9
MON200308130,2003,30813,MON,COL,MON02,5,6,11
MON200308150,2003,30815,MON,SFN,MON02,1,4,5
MON200308160,2003,30816,MON,SFN,MON02,1,4,5
MON200308170,2003,30817,MON,SFN,MON02,2,4,6
MON200308180,2003,30818,MON,SFN,MON02,0,4,4
MON200308250,2003,30825,MON,PHI,MON02,1,12,13
MON200308260,2003,30826,MON,PHI,MON02,10,14,24
MON200308270,2003,30827,MON,PHI,MON02,6,9,15
MON200308280,2003,30828,MON,PHI,MON02,0,4,4
MON200309050,2003,30905,MON,FLO,SJU01,2,6,8
MON200309060,2003,30906,MON,FLO,SJU01,14,4,18
MON200309070,2003,30907,MON,FLO,SJU01,3,1,4
MON200309090,2003,30909,MON,CHN,SJU01,4,3,7
MON200309100,2003,30910,MON,CHN,SJU01,4,8,12
MON200309110,2003,30911,MON,CHN,SJU01,2,3,5
MON200309120,2003,30912,MON,NYN,MON02,4,7,11
MON200309130,2003,30913,MON,NYN,MON02,5,4,9
MON200309140,2003,30914,MON,NYN,MON02,3,7,10
MON200309150,2003,30915,MON,ATL,MON02,10,6,16
MON200309160,2003,30916,MON,ATL,MON02,4,5,9
MON200309170,2003,30917,MON,ATL,MON02,14,4,18
MON200404090,2004,40409,MON,NYN,SJU01,3,2,5
MON200404100,2004,40410,MON,NYN,SJU01,0,1,1
MON200404110,2004,40411,MON,NYN,SJU01,4,1,5
MON200404130,2004,40413,MON,FLO,SJU01,5,0,5
MON200404140,2004,40414,MON,FLO,SJU01,9,0,9
MON200404150,2004,40415,MON,FLO,SJU01,3,0,3
MON200404230,2004,40423,MON,PHI,MON02,8,6,14
MON200404240,2004,40424,MON,PHI,MON02,7,0,7
MON200404250,2004,40425,MON,PHI,MON02,0,2,2
MON200405040,2004,40504,MON,COL,MON02,4,10,14
MON200405050,2004,40505,MON,COL,MON02,2,0,2
MON200405060,2004,40506,MON,COL,MON02,1,3,4
MON200405070,2004,40507,MON,SLN,MON02,2,4,6
MON200405080,2004,40508,MON,SLN,MON02,0,2,2
MON200405090,2004,40509,MON,SLN,MON02,5,2,7
MON200405180,2004,40518,MON,MIL,SJU01,2,3,5
MON200405190,2004,40519,MON,MIL,SJU01,6,3,9
MON200405200,2004,40520,MON,MIL,SJU01,3,2,5
MON200405210,2004,40521,MON,SFN,SJU01,6,5,11
MON200405220,2004,40522,MON,SFN,SJU01,7,2,9
MON200405240,2004,40524,MON,ATL,MON02,5,0,5
MON200405250,2004,40525,MON,ATL,MON02,1,3,4
MON200405260,2004,40526,MON,ATL,MON02,6,1,7
MON200405280,2004,40528,MON,CIN,MON02,7,6,13
MON200405290,2004,40529,MON,CIN,MON02,4,1,5
MON200405300,2004,40530,MON,CIN,MON02,2,6,8
MON200406150,2004,40615,MON,MIN,MON02,8,2,10
MON200406160,2004,40616,MON,MIN,MON02,5,4,9
MON200406170,2004,40617,MON,MIN,MON02,6,4,10
MON200406180,2004,40618,MON,CHA,MON02,11,7,18
MON200406190,2004,40619,MON,CHA,MON02,14,17,31
MON200406200,2004,40620,MON,CHA,MON02,2,4,6
MON200406220,2004,40622,MON,PHI,MON02,2,5,7
MON200406230,2004,40623,MON,PHI,MON02,5,2,7
MON200406240,2004,40624,MON,PHI,MON02,2,3,5
MON200407020,2004,40702,MON,TOR,SJU01,0,2,2
MON200407030,2004,40703,MON,TOR,SJU01,2,0,2
MON200407040,2004,40704,MON,TOR,SJU01,4,6,10
MON200407050,2004,40705,MON,ATL,SJU01,11,4,15
MON200407060,2004,40706,MON,ATL,SJU01,1,0,1
MON200407070,2004,40707,MON,ATL,SJU01,14,2,16
MON200407080,2004,40708,MON,PIT,SJU01,1,2,3
MON200407090,2004,40709,MON,PIT,SJU01,11,0,11
MON200407100,2004,40710,MON,PIT,SJU01,0,4,4
MON200407110,2004,40711,MON,PIT,SJU01,1,2,3
MON200407230,2004,40723,MON,FLO,MON02,1,2,3
MON200407240,2004,40724,MON,FLO,MON02,2,6,8
MON200407250,2004,40725,MON,FLO,MON02,4,6,10
MON200407260,2004,40726,MON,NYN,MON02,10,19,29
MON200407270,2004,40727,MON,NYN,MON02,4,2,6
MON200407280,2004,40728,MON,NYN,MON02,4,7,11
MON200407290,2004,40729,MON,NYN,MON02,10,1,11
MON200408100,2004,40810,MON,ARI,MON02,0,4,4
MON200408110,2004,40811,MON,ARI,MON02,3,7,10
MON200408120,2004,40812,MON,ARI,MON02,5,7,12
MON200408130,2004,40813,MON,HOU,MON02,5,6,11
MON200408140,2004,40814,MON,HOU,MON02,3,8,11
MON200408150,2004,40815,MON,HOU,MON02,5,4,9
MON200408230,2004,40823,MON,LAN,MON02,7,8,15
MON200408240,2004,40824,MON,LAN,MON02,10,2,12
MON200408250,2004,40825,MON,LAN,MON02,3,6,9
MON200408260,2004,40826,MON,LAN,MON02,10,3,13
MON200408270,2004,40827,MON,SDN,MON02,3,10,13
MON200408280,2004,40828,MON,SDN,MON02,5,2,7
MON200408290,2004,40829,MON,SDN,MON02,11,3,14
MON200408300,2004,40830,MON,CHN,MON02,5,2,7
MON200408310,2004,40831,MON,CHN,MON02,0,8,8
MON200409010,2004,40901,MON,CHN,MON02,2,1,3
MON200409030,2004,40903,MON,ATL,MON02,7,1,8
MON200409040,2004,40904,MON,ATL,MON02,9,0,9
MON200409050,2004,40905,MON,ATL,MON02,3,4,7
MON200409210,2004,40921,MON,NYN,MON02,1,6,7
MON200409220,2004,40922,MON,NYN,MON02,3,2,5
MON200409230,2004,40923,MON,NYN,MON02,4,2,6
MON200409240,2004,40924,MON,PHI,MON02,1,8,9
MON200409250,2004,40925,MON,PHI,MON02,4,3,7
MON200409260,2004,40926,MON,PHI,MON02,2,1,3
MON200409270,2004,40927,MON,FLO,MON02,4,1,5
MON200409280,2004,40928,MON,FLO,MON02,5,2,7
MON200409290,2004,40929,MON,FLO,MON02,9,1,10
NYA200004120,2000,412,NYA,TEX,NYC16,6,8,14
NYA200004130,2000,413,NYA,TEX,NYC16,1,5,6
NYA200004140,2000,414,NYA,KCA,NYC16,5,7,12
NYA200004150,2000,415,NYA,KCA,NYC16,1,7,8
NYA200004160,2000,416,NYA,KCA,NYC16,4,8,12
NYA200004240,2000,424,NYA,MIN,NYC16,7,3,10
NYA200004250,2000,425,NYA,MIN,NYC16,6,1,7
NYA200004260,2000,426,NYA,MIN,NYC16,0,2,2
NYA200004280,2000,428,NYA,TOR,NYC16,0,6,6
NYA200004290,2000,429,NYA,TOR,NYC16,6,2,8
NYA200004300,2000,430,NYA,TOR,NYC16,1,7,8
NYA200005050,2000,505,NYA,BAL,NYC16,10,12,22
NYA200005060,2000,506,NYA,BAL,NYC16,1,3,4
NYA200005070,2000,507,NYA,BAL,NYC16,7,6,13
NYA200005080,2000,508,NYA,TBA,NYC16,3,6,9
NYA200005090,2000,509,NYA,TBA,NYC16,3,4,7
NYA200005110,2000,511,NYA,TBA,NYC16,1,0,1
NYA200005160,2000,516,NYA,CHA,NYC16,4,0,4
NYA200005170,2000,517,NYA,CHA,NYC16,4,9,13
NYA200005260,2000,526,NYA,BOS,NYC16,4,1,5
NYA200005270,2000,527,NYA,BOS,NYC16,3,8,11
NYA200005280,2000,528,NYA,BOS,NYC16,2,0,2
NYA200005290,2000,529,NYA,OAK,NYC16,1,4,5
NYA200005300,2000,530,NYA,OAK,NYC16,7,4,11
NYA200005310,2000,531,NYA,OAK,NYC16,8,7,15
NYA200006090,2000,609,NYA,NYN,NYC16,12,2,14
NYA200006100,2000,610,NYA,NYN,NYC16,5,13,18
NYA200006130,2000,613,NYA,BOS,NYC16,5,3,8
NYA200006140,2000,614,NYA,BOS,NYC16,1,2,3
NYA200006150,2000,615,NYA,CHA,NYC16,12,3,15
NYA200006160,2000,616,NYA,CHA,NYC16,3,1,4
NYA200006170,2000,617,NYA,CHA,NYC16,10,9,19
NYA200006180,2000,618,NYA,CHA,NYC16,17,4,21
NYA200007040,2000,704,NYA,BAL,NYC16,7,6,13
NYA200007050,2000,705,NYA,BAL,NYC16,6,12,18
NYA200007060,2000,706,NYA,BAL,NYC16,9,13,22
NYA200007082,2000,708,NYA,NYN,NYC16,2,4,6
NYA200007130,2000,713,NYA,FLO,NYC16,11,9,20
NYA200007140,2000,714,NYA,FLO,NYC16,2,6,8
NYA200007160,2000,716,NYA,PHI,NYC16,8,9,17
NYA200007170,2000,717,NYA,PHI,NYC16,10,8,18
NYA200007180,2000,718,NYA,PHI,NYC16,1,3,4
NYA200007190,2000,719,NYA,DET,NYC16,1,9,10
NYA200007200,2000,720,NYA,DET,NYC16,5,3,8
NYA200007210,2000,721,NYA,TBA,NYC16,1,11,12
NYA200007220,2000,722,NYA,TBA,NYC16,12,4,16
NYA200007230,2000,723,NYA,TBA,NYC16,1,5,6
NYA200008010,2000,801,NYA,KCA,NYC16,4,5,9
NYA200008020,2000,802,NYA,KCA,NYC16,4,1,5
NYA200008030,2000,803,NYA,KCA,NYC16,2,3,5
NYA200008040,2000,804,NYA,SEA,NYC16,6,13,19
NYA200008050,2000,805,NYA,SEA,NYC16,6,5,11
NYA200008060,2000,806,NYA,SEA,NYC16,11,1,12
NYA200008070,2000,807,NYA,SEA,NYC16,8,5,13
NYA200008080,2000,808,NYA,OAK,NYC16,3,4,7
NYA200008090,2000,809,NYA,OAK,NYC16,1,12,13
NYA200008100,2000,810,NYA,OAK,NYC16,6,12,18
NYA200008170,2000,817,NYA,ANA,NYC16,1,6,7
NYA200008180,2000,818,NYA,ANA,NYC16,9,8,17
NYA200008190,2000,819,NYA,ANA,NYC16,1,9,10
NYA200008200,2000,820,NYA,ANA,NYC16,5,4,9
NYA200008210,2000,821,NYA,TEX,NYC16,3,12,15
NYA200008220,2000,822,NYA,TEX,NYC16,5,4,9
NYA200008230,2000,823,NYA,TEX,NYC16,9,10,19
NYA200008240,2000,824,NYA,TEX,NYC16,7,8,15
NYA200009010,2000,901,NYA,MIN,NYC16,2,4,6
NYA200009020,2000,902,NYA,MIN,NYC16,4,13,17
NYA200009030,2000,903,NYA,MIN,NYC16,2,1,3
NYA200009110,2000,911,NYA,BOS,NYC16,4,0,4
NYA200009120,2000,912,NYA,TOR,NYC16,2,10,12
NYA200009130,2000,913,NYA,TOR,NYC16,2,3,5
NYA200009140,2000,914,NYA,TOR,NYC16,3,2,5
NYA200009150,2000,915,NYA,CLE,NYC16,11,1,12
NYA200009160,2000,916,NYA,CLE,NYC16,3,6,9
NYA200009170,2000,917,NYA,CLE,NYC16,15,4,19
NYA200009180,2000,918,NYA,CLE,NYC16,2,0,2
NYA200009220,2000,922,NYA,DET,NYC16,9,6,15
NYA200009230,2000,923,NYA,DET,NYC16,8,13,21
NYA200009240,2000,924,NYA,DET,NYC16,3,6,9
NYA200009250,2000,925,NYA,DET,NYC16,15,4,19
NYA200010060,2000,1006,NYA,OAK,NYC16,2,4,6
NYA200010070,2000,1007,NYA,OAK,NYC16,11,1,12
NYA200010100,2000,1010,NYA,SEA,NYC16,2,0,2
NYA200010110,2000,1011,NYA,SEA,NYC16,1,7,8
NYA200010170,2000,1017,NYA,SEA,NYC16,7,9,16
NYA200010210,2000,1021,NYA,NYN,NYC16,3,4,7
NYA200010220,2000,1022,NYA,NYN,NYC16,5,6,11
NYA200104020,2001,10402,NYA,KCA,NYC16,3,7,10
NYA200104040,2001,10404,NYA,KCA,NYC16,2,8,10
NYA200104050,2001,10405,NYA,KCA,NYC16,0,1,1
NYA200104060,2001,10406,NYA,TOR,NYC16,13,4,17
NYA200104070,2001,10407,NYA,TOR,NYC16,3,2,5
NYA200104080,2001,10408,NYA,TOR,NYC16,5,16,21
NYA200104200,2001,10420,NYA,BOS,NYC16,1,6,7
NYA200104210,2001,10421,NYA,BOS,NYC16,8,3,11
NYA200104220,2001,10422,NYA,BOS,NYC16,3,4,7
NYA200104240,2001,10424,NYA,SEA,NYC16,7,5,12
NYA200104250,2001,10425,NYA,SEA,NYC16,7,5,12
NYA200104260,2001,10426,NYA,SEA,NYC16,7,3,10
NYA200104270,2001,10427,NYA,OAK,NYC16,2,3,5
NYA200104280,2001,10428,NYA,OAK,NYC16,6,7,13
NYA200104290,2001,10429,NYA,OAK,NYC16,1,3,4
NYA200105080,2001,10508,NYA,MIN,NYC16,2,0,2
NYA200105090,2001,10509,NYA,MIN,NYC16,0,2,2
NYA200105100,2001,10510,NYA,MIN,NYC16,5,4,9
NYA200105110,2001,10511,NYA,BAL,NYC16,5,14,19
NYA200105120,2001,10512,NYA,BAL,NYC16,5,8,13
NYA200105130,2001,10513,NYA,BAL,NYC16,10,5,15
NYA200105230,2001,10523,NYA,BOS,NYC16,3,7,10
NYA200105240,2001,10524,NYA,BOS,NYC16,1,2,3
NYA200106010,2001,10601,NYA,CLE,NYC16,7,4,11
NYA200106020,2001,10602,NYA,CLE,NYC16,4,9,13
NYA200106030,2001,10603,NYA,CLE,NYC16,4,3,7
NYA200106040,2001,10604,NYA,BOS,NYC16,6,7,13
NYA200106050,2001,10605,NYA,BAL,NYC16,10,3,13
NYA200106060,2001,10606,NYA,BAL,NYC16,4,7,11
NYA200106070,2001,10607,NYA,BAL,NYC16,0,4,4
NYA200106080,2001,10608,NYA,ATL,NYC16,4,7,11
NYA200106090,2001,10609,NYA,ATL,NYC16,10,6,16
NYA200106100,2001,10610,NYA,ATL,NYC16,4,1,5
NYA200106120,2001,10612,NYA,MON,NYC16,2,1,3
NYA200106130,2001,10613,NYA,MON,NYC16,3,9,12
NYA200106140,2001,10614,NYA,MON,NYC16,6,9,15
NYA200106250,2001,10625,NYA,CLE,NYC16,7,8,15
NYA200106260,2001,10626,NYA,CLE,NYC16,5,3,8
NYA200106270,2001,10627,NYA,CLE,NYC16,5,15,20
NYA200106290,2001,10629,NYA,TBA,NYC16,5,7,12
NYA200106300,2001,10630,NYA,TBA,NYC16,4,5,9
NYA200107010,2001,10701,NYA,TBA,NYC16,1,6,7
NYA200107020,2001,10702,NYA,TBA,NYC16,1,7,8
NYA200107060,2001,10706,NYA,NYN,NYC16,3,8,11
NYA200107070,2001,10707,NYA,NYN,NYC16,3,0,3
NYA200107080,2001,10708,NYA,NYN,NYC16,1,4,5
NYA200107200,2001,10720,NYA,TOR,NYC16,10,4,14
NYA200107210,2001,10721,NYA,TOR,NYC16,5,3,8
NYA200107220,2001,10722,NYA,TOR,NYC16,3,7,10
NYA200107230,2001,10723,NYA,TOR,NYC16,2,7,9
NYA200107240,2001,10724,NYA,DET,NYC16,5,6,11
NYA200107250,2001,10725,NYA,DET,NYC16,2,4,6
NYA200107260,2001,10726,NYA,DET,NYC16,8,14,22
NYA200107310,2001,10731,NYA,TEX,NYC16,6,2,8
NYA200108010,2001,10801,NYA,TEX,NYC16,7,9,16
NYA200108020,2001,10802,NYA,TEX,NYC16,12,2,14
NYA200108030,2001,10803,NYA,ANA,NYC16,2,4,6
NYA200108040,2001,10804,NYA,ANA,NYC16,4,5,9
NYA200108050,2001,10805,NYA,ANA,NYC16,4,3,7
NYA200108060,2001,10806,NYA,ANA,NYC16,3,1,4
NYA200108140,2001,10814,NYA,TBA,NYC16,3,5,8
NYA200108150,2001,10815,NYA,TBA,NYC16,3,10,13
NYA200108160,2001,10816,NYA,TBA,NYC16,5,12,17
NYA200108170,2001,10817,NYA,SEA,NYC16,0,4,4
NYA200108180,2001,10818,NYA,SEA,NYC16,7,6,13
NYA200108190,2001,10819,NYA,SEA,NYC16,10,2,12
NYA200108280,2001,10828,NYA,TOR,NYC16,0,4,4
NYA200108290,2001,10829,NYA,TOR,NYC16,3,2,5
NYA200108300,2001,10830,NYA,TOR,NYC16,4,5,9
NYA200109070,2001,10907,NYA,BOS,NYC16,2,3,5
NYA200109080,2001,10908,NYA,BOS,NYC16,2,9,11
NYA200109090,2001,10909,NYA,BOS,NYC16,2,7,9
NYA200109250,2001,10925,NYA,TBA,NYC16,4,0,4
NYA200109260,2001,10926,NYA,TBA,NYC16,1,5,6
NYA200109280,2001,10928,NYA,BAL,NYC16,0,7,7
NYA200109290,2001,10929,NYA,BAL,NYC16,7,2,9
NYA200109300,2001,10930,NYA,BAL,NYC16,1,1,2
NYA200110010,2001,11001,NYA,CHA,NYC16,1,8,9
NYA200110020,2001,11002,NYA,CHA,NYC16,4,6,10
NYA200110030,2001,11003,NYA,CHA,NYC16,1,2,3
NYA200110100,2001,11010,NYA,OAK,NYC16,5,3,8
NYA200110110,2001,11011,NYA,OAK,NYC16,2,0,2
NYA200110150,2001,11015,NYA,OAK,NYC16,3,5,8
NYA200110200,2001,11020,NYA,SEA,NYC16,14,3,17
NYA200110210,2001,11021,NYA,SEA,NYC16,1,3,4
NYA200110220,2001,11022,NYA,SEA,NYC16,3,12,15
NYA200110300,2001,11030,NYA,ARI,NYC16,1,2,3
NYA200110310,2001,11031,NYA,ARI,NYC16,3,4,7
NYA200111010,2001,11101,NYA,ARI,NYC16,2,3,5
NYA200204050,2002,20405,NYA,TBA,NYC16,0,4,4
NYA200204060,2002,20406,NYA,TBA,NYC16,0,3,3
NYA200204070,2002,20407,NYA,TBA,NYC16,2,7,9
NYA200204160,2002,20416,NYA,BAL,NYC16,5,4,9
NYA200204170,2002,20417,NYA,BAL,NYC16,1,7,8
NYA200204180,2002,20418,NYA,BAL,NYC16,4,8,12
NYA200204190,2002,20419,NYA,TOR,NYC16,5,6,11
NYA200204200,2002,20420,NYA,TOR,NYC16,5,4,9
NYA200204210,2002,20421,NYA,TOR,NYC16,2,9,11
NYA200204300,2002,20430,NYA,OAK,NYC16,2,8,10
NYA200205010,2002,20501,NYA,OAK,NYC16,4,1,5
NYA200205020,2002,20502,NYA,OAK,NYC16,2,9,11
NYA200205030,2002,20503,NYA,SEA,NYC16,6,2,8
NYA200205040,2002,20504,NYA,SEA,NYC16,9,5,14
NYA200205050,2002,20505,NYA,SEA,NYC16,10,6,16
NYA200205140,2002,20514,NYA,TBA,NYC16,3,10,13
NYA200205150,2002,20515,NYA,TBA,NYC16,10,7,17
NYA200205160,2002,20516,NYA,TBA,NYC16,0,13,13
NYA200205170,2002,20517,NYA,MIN,NYC16,12,13,25
NYA200205180,2002,20518,NYA,MIN,NYC16,2,6,8
NYA200205190,2002,20519,NYA,MIN,NYC16,0,3,3
NYA200205200,2002,20520,NYA,TOR,NYC16,3,6,9
NYA200205210,2002,20521,NYA,TOR,NYC16,1,4,5
NYA200205220,2002,20522,NYA,TOR,NYC16,8,3,11
NYA200205310,2002,20531,NYA,BOS,NYC16,5,2,7
NYA200206010,2002,20601,NYA,BOS,NYC16,2,10,12
NYA200206020,2002,20602,NYA,BOS,NYC16,7,1,8
NYA200206030,2002,20603,NYA,BAL,NYC16,4,3,7
NYA200206040,2002,20604,NYA,BAL,NYC16,5,13,18
NYA200206050,2002,20605,NYA,BAL,NYC16,4,3,7
NYA200206070,2002,20607,NYA,SFN,NYC16,1,2,3
NYA200206080,2002,20608,NYA,SFN,NYC16,4,3,7
NYA200206090,2002,20609,NYA,SFN,NYC16,2,4,6
NYA200206100,2002,20610,NYA,ARI,NYC16,5,7,12
NYA200206110,2002,20611,NYA,ARI,NYC16,4,6,10
NYA200206120,2002,20612,NYA,ARI,NYC16,9,5,14
NYA200206280,2002,20628,NYA,NYN,NYC16,5,11,16
NYA200206290,2002,20629,NYA,NYN,NYC16,11,2,13
NYA200206300,2002,20630,NYA,NYN,NYC16,0,8,8
NYA200207020,2002,20702,NYA,CLE,NYC16,5,10,15
NYA200207030,2002,20703,NYA,CLE,NYC16,8,11,19
NYA200207040,2002,20704,NYA,CLE,NYC16,1,7,8
NYA200207050,2002,20705,NYA,TOR,NYC16,3,6,9
NYA200207060,2002,20706,NYA,TOR,NYC16,8,3,11
NYA200207070,2002,20707,NYA,TOR,NYC16,6,10,16
NYA200207170,2002,20717,NYA,DET,NYC16,1,2,3
NYA200207180,2002,20718,NYA,DET,NYC16,5,6,11
NYA200207190,2002,20719,NYA,BOS,NYC16,4,2,6
NYA200207200,2002,20720,NYA,BOS,NYC16,8,9,17
NYA200207210,2002,20721,NYA,BOS,NYC16,8,9,17
NYA200208060,2002,20806,NYA,KCA,NYC16,6,2,8
NYA200208070,2002,20807,NYA,KCA,NYC16,2,6,8
NYA200208080,2002,20808,NYA,KCA,NYC16,3,6,9
NYA200208090,2002,20809,NYA,OAK,NYC16,3,2,5
NYA200208100,2002,20810,NYA,OAK,NYC16,8,0,8
NYA200208110,2002,20811,NYA,OAK,NYC16,5,8,13
NYA200208200,2002,20820,NYA,ANA,NYC16,5,7,12
NYA200208210,2002,20821,NYA,ANA,NYC16,5,1,6
NYA200208220,2002,20822,NYA,ANA,NYC16,2,4,6
NYA200208230,2002,20823,NYA,TEX,NYC16,6,2,8
NYA200208240,2002,20824,NYA,TEX,NYC16,2,3,5
NYA200208250,2002,20825,NYA,TEX,NYC16,6,2,8
NYA200208260,2002,20826,NYA,TEX,NYC16,3,10,13
NYA200209020,2002,20902,NYA,BOS,NYC16,8,4,12
NYA200209030,2002,20903,NYA,BOS,NYC16,2,4,6
NYA200209040,2002,20904,NYA,BOS,NYC16,1,3,4
NYA200209050,2002,20905,NYA,DET,NYC16,3,9,12
NYA200209060,2002,20906,NYA,DET,NYC16,1,8,9
NYA200209070,2002,20907,NYA,DET,NYC16,2,1,3
NYA200209080,2002,20908,NYA,DET,NYC16,4,6,10
NYA200209101,2002,20910,NYA,BAL,NYC16,2,5,7
NYA200209102,2002,20910,NYA,BAL,NYC16,1,3,4
NYA200209110,2002,20911,NYA,BAL,NYC16,4,5,9
NYA200209120,2002,20912,NYA,BAL,NYC16,3,7,10
NYA200209130,2002,20913,NYA,CHA,NYC16,13,2,15
NYA200209140,2002,20914,NYA,CHA,NYC16,8,1,9
NYA200209150,2002,20915,NYA,CHA,NYC16,4,8,12
NYA200209230,2002,20923,NYA,TBA,NYC16,3,2,5
NYA200209240,2002,20924,NYA,TBA,NYC16,0,6,6
NYA200209250,2002,20925,NYA,TBA,NYC16,3,4,7
NYA200210010,2002,21001,NYA,ANA,NYC16,5,8,13
NYA200210020,2002,21002,NYA,ANA,NYC16,8,6,14
NYA200304080,2003,30408,NYA,MIN,NYC16,3,7,10
NYA200304090,2003,30409,NYA,MIN,NYC16,1,2,3
NYA200304100,2003,30410,NYA,MIN,NYC16,0,2,2
NYA200304120,2003,30412,NYA,TBA,NYC16,4,5,9
NYA200304130,2003,30413,NYA,TBA,NYC16,2,1,3
NYA200304140,2003,30414,NYA,TOR,NYC16,9,10,19
NYA200304150,2003,30415,NYA,TOR,NYC16,0,5,5
NYA200304160,2003,30416,NYA,TOR,NYC16,7,6,13
NYA200304170,2003,30417,NYA,TOR,NYC16,0,4,4
NYA200304290,2003,30429,NYA,SEA,NYC16,6,0,6
NYA200304300,2003,30430,NYA,SEA,NYC16,5,8,13
NYA200305010,2003,30501,NYA,SEA,NYC16,1,2,3
NYA200305020,2003,30502,NYA,OAK,NYC16,3,5,8
NYA200305030,2003,30503,NYA,OAK,NYC16,5,3,8
NYA200305040,2003,30504,NYA,OAK,NYC16,2,0,2
NYA200305130,2003,30513,NYA,ANA,NYC16,10,3,13
NYA200305140,2003,30514,NYA,ANA,NYC16,5,3,8
NYA200305150,2003,30515,NYA,ANA,NYC16,4,10,14
NYA200305160,2003,30516,NYA,TEX,NYC16,8,5,13
NYA200305170,2003,30517,NYA,TEX,NYC16,5,2,7
NYA200305180,2003,30518,NYA,TEX,NYC16,5,1,6
NYA200305220,2003,30522,NYA,TOR,NYC16,8,3,11
NYA200305230,2003,30523,NYA,TOR,NYC16,6,2,8
NYA200305240,2003,30524,NYA,TOR,NYC16,5,2,7
NYA200305250,2003,30525,NYA,TOR,NYC16,5,3,8
NYA200305260,2003,30526,NYA,BOS,NYC16,8,4,12
NYA200305270,2003,30527,NYA,BOS,NYC16,3,11,14
NYA200305280,2003,30528,NYA,BOS,NYC16,5,6,11
NYA200306100,2003,30610,NYA,HOU,NYC16,3,5,8
NYA200306110,2003,30611,NYA,HOU,NYC16,8,0,8
NYA200306120,2003,30612,NYA,HOU,NYC16,5,6,11
NYA200306130,2003,30613,NYA,SLN,NYC16,2,5,7
NYA200306140,2003,30614,NYA,SLN,NYC16,4,13,17
NYA200306150,2003,30615,NYA,SLN,NYC16,2,5,7
NYA200306171,2003,30617,NYA,TBA,NYC16,11,2,13
NYA200306172,2003,30617,NYA,TBA,NYC16,2,10,12
NYA200306180,2003,30618,NYA,TBA,NYC16,0,1,1
NYA200306270,2003,30627,NYA,NYN,NYC16,4,6,10
NYA200306280,2003,30628,NYA,NYN,NYC16,1,7,8
NYA200306290,2003,30629,NYA,NYN,NYC16,3,5,8
NYA200307040,2003,30704,NYA,BOS,NYC16,10,3,13
NYA200307050,2003,30705,NYA,BOS,NYC16,10,2,12
NYA200307060,2003,30706,NYA,BOS,NYC16,1,7,8
NYA200307070,2003,30707,NYA,BOS,NYC16,1,2,3
NYA200307170,2003,30717,NYA,CLE,NYC16,4,5,9
NYA200307180,2003,30718,NYA,CLE,NYC16,4,10,14
NYA200307190,2003,30719,NYA,CLE,NYC16,4,7,11
NYA200307200,2003,30720,NYA,CLE,NYC16,4,7,11
NYA200307210,2003,30721,NYA,TOR,NYC16,8,0,8
NYA200307230,2003,30723,NYA,BAL,NYC16,2,4,6
NYA200307240,2003,30724,NYA,BAL,NYC16,5,3,8
NYA200308050,2003,30805,NYA,TEX,NYC16,2,6,8
NYA200308060,2003,30806,NYA,TEX,NYC16,5,4,9
NYA200308070,2003,30807,NYA,TEX,NYC16,5,7,12
NYA200308080,2003,30808,NYA,SEA,NYC16,7,9,16
NYA200308090,2003,30809,NYA,SEA,NYC16,2,1,3
NYA200308100,2003,30810,NYA,SEA,NYC16,8,6,14
NYA200308180,2003,30818,NYA,KCA,NYC16,6,11,17
NYA200308190,2003,30819,NYA,KCA,NYC16,3,6,9
NYA200308200,2003,30820,NYA,KCA,NYC16,7,8,15
NYA200308220,2003,30822,NYA,BAL,NYC16,4,3,7
NYA200308230,2003,30823,NYA,BAL,NYC16,7,2,9
NYA200308240,2003,30824,NYA,BAL,NYC16,0,7,7
NYA200308250,2003,30825,NYA,BAL,NYC16,2,5,7
NYA200308260,2003,30826,NYA,CHA,NYC16,13,2,15
NYA200308270,2003,30827,NYA,CHA,NYC16,11,2,13
NYA200308280,2003,30828,NYA,CHA,NYC16,5,7,12
NYA200309050,2003,30905,NYA,BOS,NYC16,9,3,12
NYA200309060,2003,30906,NYA,BOS,NYC16,11,0,11
NYA200309070,2003,30907,NYA,BOS,NYC16,1,3,4
NYA200309080,2003,30908,NYA,TOR,NYC16,3,9,12
NYA200309090,2003,30909,NYA,DET,NYC16,2,4,6
NYA200309100,2003,30910,NYA,DET,NYC16,5,15,20
NYA200309110,2003,30911,NYA,DET,NYC16,2,5,7
NYA200309120,2003,30912,NYA,TBA,NYC16,4,10,14
NYA200309131,2003,30913,NYA,TBA,NYC16,5,6,11
NYA200309132,2003,30913,NYA,TBA,NYC16,3,6,9
NYA200309140,2003,30914,NYA,TBA,NYC16,5,2,7
NYA200309261,2003,30926,NYA,BAL,NYC16,2,11,13
NYA200309262,2003,30926,NYA,BAL,NYC16,3,2,5
NYA200309270,2003,30927,NYA,BAL,NYC16,2,6,8
NYA200309280,2003,30928,NYA,BAL,NYC16,1,3,4
NYA200309300,2003,30930,NYA,MIN,NYC16,3,1,4
NYA200310020,2003,31002,NYA,MIN,NYC16,1,4,5
NYA200310080,2003,31008,NYA,BOS,NYC16,5,2,7
NYA200310090,2003,31009,NYA,BOS,NYC16,2,6,8
NYA200310150,2003,31015,NYA,BOS,NYC16,9,6,15
NYA200310160,2003,31016,NYA,BOS,NYC16,5,6,11
NYA200310180,2003,31018,NYA,FLO,NYC16,3,2,5
NYA200310190,2003,31019,NYA,FLO,NYC16,1,6,7
NYA200310250,2003,31025,NYA,FLO,NYC16,2,0,2
NYA200404080,2004,40408,NYA,CHA,NYC16,1,3,4
NYA200404090,2004,40409,NYA,CHA,NYC16,9,3,12
NYA200404100,2004,40410,NYA,CHA,NYC16,7,3,10
NYA200404110,2004,40411,NYA,CHA,NYC16,4,5,9
NYA200404140,2004,40414,NYA,TBA,NYC16,1,5,6
NYA200404230,2004,40423,NYA,BOS,NYC16,11,2,13
NYA200404240,2004,40424,NYA,BOS,NYC16,3,2,5
NYA200404250,2004,40425,NYA,BOS,NYC16,2,0,2
NYA200404270,2004,40427,NYA,OAK,NYC16,8,10,18
NYA200404280,2004,40428,NYA,OAK,NYC16,1,5,6
NYA200404290,2004,40429,NYA,OAK,NYC16,5,7,12
NYA200404300,2004,40430,NYA,KCA,NYC16,2,5,7
NYA200405010,2004,40501,NYA,KCA,NYC16,4,12,16
NYA200405020,2004,40502,NYA,KCA,NYC16,2,4,6
NYA200405110,2004,40511,NYA,ANA,NYC16,7,8,15
NYA200405120,2004,40512,NYA,ANA,NYC16,11,2,13
NYA200405130,2004,40513,NYA,ANA,NYC16,4,7,11
NYA200405140,2004,40514,NYA,SEA,NYC16,5,9,14
NYA200405150,2004,40515,NYA,SEA,NYC16,13,7,20
NYA200405160,2004,40516,NYA,SEA,NYC16,1,2,3
NYA200406010,2004,40601,NYA,BAL,NYC16,7,8,15
NYA200406020,2004,40602,NYA,BAL,NYC16,5,6,11
NYA200406030,2004,40603,NYA,BAL,NYC16,2,5,7
NYA200406040,2004,40604,NYA,TEX,NYC16,6,7,13
NYA200406050,2004,40605,NYA,TEX,NYC16,8,1,9
NYA200406060,2004,40606,NYA,TEX,NYC16,1,2,3
NYA200406080,2004,40608,NYA,COL,NYC16,1,2,3
NYA200406090,2004,40609,NYA,COL,NYC16,5,7,12
NYA200406100,2004,40610,NYA,COL,NYC16,4,10,14
NYA200406110,2004,40611,NYA,SDN,NYC16,10,2,12
NYA200406120,2004,40612,NYA,SDN,NYC16,2,3,5
NYA200406130,2004,40613,NYA,SDN,NYC16,5,6,11
NYA200406260,2004,40626,NYA,NYN,NYC16,9,3,12
NYA200406271,2004,40627,NYA,NYN,NYC16,1,8,9
NYA200406272,2004,40627,NYA,NYN,NYC16,6,11,17
NYA200406290,2004,40629,NYA,BOS,NYC16,3,11,14
NYA200406300,2004,40630,NYA,BOS,NYC16,2,4,6
NYA200407010,2004,40701,NYA,BOS,NYC16,4,5,9
NYA200407050,2004,40705,NYA,DET,NYC16,3,10,13
NYA200407060,2004,40706,NYA,DET,NYC16,9,1,10
NYA200407070,2004,40707,NYA,DET,NYC16,10,8,18
NYA200407080,2004,40708,NYA,TBA,NYC16,1,7,8
NYA200407090,2004,40709,NYA,TBA,NYC16,4,5,9
NYA200407100,2004,40710,NYA,TBA,NYC16,3,6,9
NYA200407110,2004,40711,NYA,TBA,NYC16,3,10,13
NYA200407210,2004,40721,NYA,TOR,NYC16,3,10,13
NYA200407220,2004,40722,NYA,TOR,NYC16,0,1,1
NYA200407290,2004,40729,NYA,BAL,NYC16,9,1,10
NYA200407300,2004,40730,NYA,BAL,NYC16,1,2,3
NYA200407310,2004,40731,NYA,BAL,NYC16,4,6,10
NYA200408010,2004,40801,NYA,BAL,NYC16,7,9,16
NYA200408030,2004,40803,NYA,OAK,NYC16,13,4,17
NYA200408040,2004,40804,NYA,OAK,NYC16,6,8,14
NYA200408050,2004,40805,NYA,OAK,NYC16,1,5,6
NYA200408060,2004,40806,NYA,TOR,NYC16,4,11,15
NYA200408070,2004,40807,NYA,TOR,NYC16,0,6,6
NYA200408080,2004,40808,NYA,TOR,NYC16,2,8,10
NYA200408090,2004,40809,NYA,TOR,NYC16,5,4,9
NYA200408200,2004,40820,NYA,ANA,NYC16,5,0,5
NYA200408210,2004,40821,NYA,ANA,NYC16,6,1,7
NYA200408220,2004,40822,NYA,ANA,NYC16,4,3,7
NYA200408310,2004,40831,NYA,CLE,NYC16,22,0,22
NYA200409010,2004,40901,NYA,CLE,NYC16,3,5,8
NYA200409020,2004,40902,NYA,CLE,NYC16,1,9,10
NYA200409030,2004,40903,NYA,BAL,NYC16,3,1,4
NYA200409040,2004,40904,NYA,BAL,NYC16,7,0,7
NYA200409050,2004,40905,NYA,BAL,NYC16,3,4,7
NYA200409060,2004,40906,NYA,TBA,NYC16,4,7,11
NYA200409070,2004,40907,NYA,TBA,NYC16,2,11,13
NYA200409091,2004,40909,NYA,TBA,NYC16,1,9,10
NYA200409092,2004,40909,NYA,TBA,NYC16,5,10,15
NYA200409170,2004,40917,NYA,BOS,NYC16,3,2,5
NYA200409180,2004,40918,NYA,BOS,NYC16,4,14,18
NYA200409190,2004,40919,NYA,BOS,NYC16,1,11,12
NYA200409200,2004,40920,NYA,TOR,NYC16,6,3,9
NYA200409210,2004,40921,NYA,TOR,NYC16,3,5,8
NYA200409220,2004,40922,NYA,TOR,NYC16,5,4,9
NYA200409230,2004,40923,NYA,TBA,NYC16,3,7,10
NYA200409291,2004,40929,NYA,MIN,NYC16,3,5,8
NYA200409292,2004,40929,NYA,MIN,NYC16,4,5,9
NYA200409300,2004,40930,NYA,MIN,NYC16,4,6,10
NYA200410050,2004,41005,NYA,MIN,NYC16,2,0,2
NYA200410060,2004,41006,NYA,MIN,NYC16,6,7,13
NYA200410120,2004,41012,NYA,BOS,NYC16,7,10,17
NYA200410130,2004,41013,NYA,BOS,NYC16,1,3,4
NYA200410190,2004,41019,NYA,BOS,NYC16,4,2,6
NYA200410200,2004,41020,NYA,BOS,NYC16,10,3,13
NYA200504030,2005,50403,NYA,BOS,NYC16,2,9,11
NYA200504050,2005,50405,NYA,BOS,NYC16,3,4,7
NYA200504060,2005,50406,NYA,BOS,NYC16,7,3,10
NYA200504080,2005,50408,NYA,BAL,NYC16,12,5,17
NYA200504090,2005,50409,NYA,BAL,NYC16,5,8,13
NYA200504100,2005,50410,NYA,BAL,NYC16,7,2,9
NYA200504180,2005,50418,NYA,TBA,NYC16,8,19,27
NYA200504190,2005,50419,NYA,TBA,NYC16,6,2,8
NYA200504220,2005,50422,NYA,TEX,NYC16,5,3,8
NYA200504230,2005,50423,NYA,TEX,NYC16,10,2,12
NYA200504240,2005,50424,NYA,TEX,NYC16,1,11,12
NYA200504260,2005,50426,NYA,ANA,NYC16,4,12,16
NYA200504270,2005,50427,NYA,ANA,NYC16,5,1,6
NYA200504280,2005,50428,NYA,ANA,NYC16,3,1,4
NYA200504290,2005,50429,NYA,TOR,NYC16,2,0,2
NYA200504300,2005,50430,NYA,TOR,NYC16,3,4,7
NYA200505010,2005,50501,NYA,TOR,NYC16,8,6,14
NYA200505060,2005,50506,NYA,OAK,NYC16,6,3,9
NYA200505070,2005,50507,NYA,OAK,NYC16,0,5,5
NYA200505080,2005,50508,NYA,OAK,NYC16,0,6,6
NYA200505090,2005,50509,NYA,SEA,NYC16,3,4,7
NYA200505100,2005,50510,NYA,SEA,NYC16,4,7,11
NYA200505110,2005,50511,NYA,SEA,NYC16,9,13,22
NYA200505240,2005,50524,NYA,DET,NYC16,3,12,15
NYA200505250,2005,50525,NYA,DET,NYC16,2,4,6
NYA200505260,2005,50526,NYA,DET,NYC16,3,4,7
NYA200505270,2005,50527,NYA,BOS,NYC16,3,6,9
NYA200505280,2005,50528,NYA,BOS,NYC16,17,1,18
NYA200505290,2005,50529,NYA,BOS,NYC16,7,2,9
NYA200506140,2005,50614,NYA,PIT,NYC16,0,9,9
NYA200506150,2005,50615,NYA,PIT,NYC16,5,7,12
NYA200506160,2005,50616,NYA,PIT,NYC16,1,6,7
NYA200506170,2005,50617,NYA,CHN,NYC16,6,9,15
NYA200506180,2005,50618,NYA,CHN,NYC16,1,8,9
NYA200506190,2005,50619,NYA,CHN,NYC16,3,6,9
NYA200506200,2005,50620,NYA,TBA,NYC16,5,4,9
NYA200506210,2005,50621,NYA,TBA,NYC16,11,20,31
NYA200506220,2005,50622,NYA,TBA,NYC16,5,3,8
NYA200506230,2005,50623,NYA,TBA,NYC16,9,4,13
NYA200506240,2005,50624,NYA,NYN,NYC16,6,4,10
NYA200506250,2005,50625,NYA,NYN,NYC16,10,3,13
NYA200506260,2005,50626,NYA,NYN,NYC16,4,5,9
NYA200507040,2005,50704,NYA,BAL,NYC16,8,13,21
NYA200507050,2005,50705,NYA,BAL,NYC16,3,12,15
NYA200507070,2005,50707,NYA,CLE,NYC16,2,7,9
NYA200507080,2005,50708,NYA,CLE,NYC16,4,5,9
NYA200507090,2005,50709,NYA,CLE,NYC16,8,7,15
NYA200507100,2005,50710,NYA,CLE,NYC16,4,9,13
NYA200507260,2005,50726,NYA,MIN,NYC16,0,4,4
NYA200507270,2005,50727,NYA,MIN,NYC16,7,3,10
NYA200507280,2005,50728,NYA,MIN,NYC16,3,6,9
NYA200507290,2005,50729,NYA,ANA,NYC16,4,1,5
NYA200507300,2005,50730,NYA,ANA,NYC16,7,8,15
NYA200507310,2005,50731,NYA,ANA,NYC16,7,8,15
NYA200508080,2005,50808,NYA,CHA,NYC16,2,3,5
NYA200508090,2005,50809,NYA,CHA,NYC16,2,1,3
NYA200508100,2005,50810,NYA,CHA,NYC16,2,1,3
NYA200508110,2005,50811,NYA,TEX,NYC16,8,9,17
NYA200508120,2005,50812,NYA,TEX,NYC16,5,6,11
NYA200508130,2005,50813,NYA,TEX,NYC16,5,7,12
NYA200508140,2005,50814,NYA,TEX,NYC16,3,10,13
NYA200508220,2005,50822,NYA,TOR,NYC16,0,7,7
NYA200508230,2005,50823,NYA,TOR,NYC16,4,5,9
NYA200508240,2005,50824,NYA,TOR,NYC16,9,5,14
NYA200508250,2005,50825,NYA,TOR,NYC16,2,6,8
NYA200508260,2005,50826,NYA,KCA,NYC16,1,5,6
NYA200508270,2005,50827,NYA,KCA,NYC16,7,8,15
NYA200508280,2005,50828,NYA,KCA,NYC16,3,10,13
NYA200509060,2005,50906,NYA,TBA,NYC16,4,3,7
NYA200509070,2005,50907,NYA,TBA,NYC16,4,5,9
NYA200509080,2005,50908,NYA,TBA,NYC16,7,4,11
NYA200509090,2005,50909,NYA,BOS,NYC16,4,8,12
NYA200509100,2005,50910,NYA,BOS,NYC16,9,2,11
NYA200509110,2005,50911,NYA,BOS,NYC16,0,1,1
NYA200509190,2005,50919,NYA,BAL,NYC16,2,3,5
NYA200509200,2005,50920,NYA,BAL,NYC16,9,12,21
NYA200509210,2005,50921,NYA,BAL,NYC16,1,2,3
NYA200509220,2005,50922,NYA,BAL,NYC16,6,7,13
NYA200509230,2005,50923,NYA,TOR,NYC16,0,5,5
NYA200509240,2005,50924,NYA,TOR,NYC16,7,4,11
NYA200509250,2005,50925,NYA,TOR,NYC16,4,8,12
NYA200510070,2005,51007,NYA,ANA,NYC16,11,7,18
NYA200510090,2005,51009,NYA,ANA,NYC16,2,3,5
NYA200604110,2006,60411,NYA,KCA,NYC16,7,9,16
NYA200604120,2006,60412,NYA,KCA,NYC16,5,12,17
NYA200604130,2006,60413,NYA,KCA,NYC16,3,9,12
NYA200604210,2006,60421,NYA,BAL,NYC16,6,5,11
NYA200604220,2006,60422,NYA,BAL,NYC16,1,6,7
NYA200604230,2006,60423,NYA,BAL,NYC16,1,7,8
NYA200604250,2006,60425,NYA,TBA,NYC16,1,9,10
NYA200604260,2006,60426,NYA,TBA,NYC16,4,2,6
NYA200604270,2006,60427,NYA,TBA,NYC16,1,4,5
NYA200604280,2006,60428,NYA,TOR,NYC16,7,2,9
NYA200604290,2006,60429,NYA,TOR,NYC16,6,17,23
NYA200604300,2006,60430,NYA,TOR,NYC16,1,4,5
NYA200605090,2006,60509,NYA,BOS,NYC16,14,3,17
NYA200605100,2006,60510,NYA,BOS,NYC16,3,7,10
NYA200605110,2006,60511,NYA,BOS,NYC16,5,3,8
NYA200605120,2006,60512,NYA,OAK,NYC16,0,2,2
NYA200605130,2006,60513,NYA,OAK,NYC16,3,4,7
NYA200605140,2006,60514,NYA,OAK,NYC16,6,1,7
NYA200605150,2006,60515,NYA,TEX,NYC16,4,2,6
NYA200605160,2006,60516,NYA,TEX,NYC16,13,14,27
NYA200605170,2006,60517,NYA,TEX,NYC16,3,4,7
NYA200605180,2006,60518,NYA,TEX,NYC16,6,2,8
NYA200605260,2006,60526,NYA,KCA,NYC16,7,6,13
NYA200605270,2006,60527,NYA,KCA,NYC16,4,15,19
NYA200605280,2006,60528,NYA,KCA,NYC16,5,6,11
NYA200606050,2006,60605,NYA,BOS,NYC16,5,13,18
NYA200606060,2006,60606,NYA,BOS,NYC16,1,2,3
NYA200606080,2006,60608,NYA,BOS,NYC16,9,3,12
NYA200606090,2006,60609,NYA,OAK,NYC16,6,5,11
NYA200606100,2006,60610,NYA,OAK,NYC16,5,2,7
NYA200606110,2006,60611,NYA,OAK,NYC16,6,5,11
NYA200606130,2006,60613,NYA,CLE,NYC16,0,1,1
NYA200606140,2006,60614,NYA,CLE,NYC16,1,6,7
NYA200606150,2006,60615,NYA,CLE,NYC16,8,4,12
NYA200606230,2006,60623,NYA,FLO,NYC16,5,6,11
NYA200606251,2006,60625,NYA,FLO,NYC16,1,2,3
NYA200606252,2006,60625,NYA,FLO,NYC16,5,0,5
NYA200606260,2006,60626,NYA,ATL,NYC16,2,5,7
NYA200606270,2006,60627,NYA,ATL,NYC16,5,2,7
NYA200606280,2006,60628,NYA,ATL,NYC16,3,4,7
NYA200606300,2006,60630,NYA,NYN,NYC16,0,2,2
NYA200607010,2006,60701,NYA,NYN,NYC16,8,3,11
NYA200607020,2006,60702,NYA,NYN,NYC16,7,16,23
NYA200607140,2006,60714,NYA,CHA,NYC16,5,6,11
NYA200607150,2006,60715,NYA,CHA,NYC16,3,14,17
NYA200607160,2006,60716,NYA,CHA,NYC16,4,6,10
NYA200607170,2006,60717,NYA,SEA,NYC16,2,4,6
NYA200607180,2006,60718,NYA,SEA,NYC16,4,5,9
NYA200607190,2006,60719,NYA,SEA,NYC16,3,2,5
NYA200607280,2006,60728,NYA,TBA,NYC16,0,6,6
NYA200607290,2006,60729,NYA,TBA,NYC16,19,6,25
NYA200607300,2006,60730,NYA,TBA,NYC16,2,4,6
NYA200608010,2006,60801,NYA,TOR,NYC16,1,5,6
NYA200608020,2006,60802,NYA,TOR,NYC16,2,7,9
NYA200608030,2006,60803,NYA,TOR,NYC16,1,8,9
NYA200608110,2006,60811,NYA,ANA,NYC16,7,4,11
NYA200608120,2006,60812,NYA,ANA,NYC16,2,5,7
NYA200608130,2006,60813,NYA,ANA,NYC16,5,3,8
NYA200608140,2006,60814,NYA,ANA,NYC16,2,7,9
NYA200608150,2006,60815,NYA,BAL,NYC16,3,6,9
NYA200608160,2006,60816,NYA,BAL,NYC16,3,2,5
NYA200608170,2006,60817,NYA,BAL,NYC16,12,2,14
NYA200608301,2006,60830,NYA,DET,NYC16,0,2,2
NYA200608302,2006,60830,NYA,DET,NYC16,5,3,8
NYA200608310,2006,60831,NYA,DET,NYC16,4,6,10
NYA200609010,2006,60901,NYA,MIN,NYC16,1,8,9
NYA200609020,2006,60902,NYA,MIN,NYC16,6,1,7
NYA200609030,2006,60903,NYA,MIN,NYC16,1,10,11
NYA200609120,2006,60912,NYA,TBA,NYC16,4,12,16
NYA200609130,2006,60913,NYA,TBA,NYC16,4,8,12
NYA200609140,2006,60914,NYA,TBA,NYC16,4,7,11
NYA200609161,2006,60916,NYA,BOS,NYC16,5,2,7
NYA200609162,2006,60916,NYA,BOS,NYC16,5,7,12
NYA200609171,2006,60917,NYA,BOS,NYC16,6,3,9
NYA200609172,2006,60917,NYA,BOS,NYC16,5,4,9
NYA200609260,2006,60926,NYA,BAL,NYC16,4,5,9
NYA200609270,2006,60927,NYA,BAL,NYC16,5,16,21
NYA200609280,2006,60928,NYA,BAL,NYC16,7,1,8
NYA200609290,2006,60929,NYA,TOR,NYC16,2,7,9
NYA200609300,2006,60930,NYA,TOR,NYC16,6,5,11
NYA200610010,2006,61001,NYA,TOR,NYC16,7,5,12
NYA200610030,2006,61003,NYA,DET,NYC16,4,8,12
NYA200610050,2006,61005,NYA,DET,NYC16,4,3,7
NYA200704020,2007,70402,NYA,TBA,NYC16,5,9,14
NYA200704050,2007,70405,NYA,TBA,NYC16,7,6,13
NYA200704060,2007,70406,NYA,BAL,NYC16,6,4,10
NYA200704070,2007,70407,NYA,BAL,NYC16,7,10,17
NYA200704080,2007,70408,NYA,BAL,NYC16,6,4,10
NYA200704170,2007,70417,NYA,CLE,NYC16,3,10,13
NYA200704180,2007,70418,NYA,CLE,NYC16,2,9,11
NYA200704190,2007,70419,NYA,CLE,NYC16,6,8,14
NYA200704260,2007,70426,NYA,TOR,NYC16,6,0,6
NYA200704270,2007,70427,NYA,BOS,NYC16,11,4,15
NYA200704280,2007,70428,NYA,BOS,NYC16,1,3,4
NYA200704290,2007,70429,NYA,BOS,NYC16,7,4,11
NYA200705040,2007,70504,NYA,SEA,NYC16,15,11,26
NYA200705050,2007,70505,NYA,SEA,NYC16,1,8,9
NYA200705060,2007,70506,NYA,SEA,NYC16,0,5,5
NYA200705070,2007,70507,NYA,SEA,NYC16,3,2,5
NYA200705080,2007,70508,NYA,TEX,NYC16,2,8,10
NYA200705090,2007,70509,NYA,TEX,NYC16,2,6,8
NYA200705100,2007,70510,NYA,TEX,NYC16,14,2,16
NYA200705210,2007,70521,NYA,BOS,NYC16,2,6,8
NYA200705220,2007,70522,NYA,BOS,NYC16,7,3,10
NYA200705230,2007,70523,NYA,BOS,NYC16,3,8,11
NYA200705250,2007,70525,NYA,ANA,NYC16,10,6,16
NYA200705260,2007,70526,NYA,ANA,NYC16,3,1,4
NYA200705270,2007,70527,NYA,ANA,NYC16,4,3,7
NYA200706080,2007,70608,NYA,PIT,NYC16,4,5,9
NYA200706090,2007,70609,NYA,PIT,NYC16,3,9,12
NYA200706100,2007,70610,NYA,PIT,NYC16,6,13,19
NYA200706120,2007,70612,NYA,ARI,NYC16,1,4,5
NYA200706130,2007,70613,NYA,ARI,NYC16,2,7,9
NYA200706140,2007,70614,NYA,ARI,NYC16,1,7,8
NYA200706150,2007,70615,NYA,NYN,NYC16,2,0,2
NYA200706160,2007,70616,NYA,NYN,NYC16,8,11,19
NYA200706170,2007,70617,NYA,NYN,NYC16,2,8,10
NYA200706290,2007,70629,NYA,OAK,NYC16,1,2,3
NYA200706300,2007,70630,NYA,OAK,NYC16,7,0,7
NYA200707010,2007,70701,NYA,OAK,NYC16,11,5,16
NYA200707020,2007,70702,NYA,MIN,NYC16,1,5,6
NYA200707030,2007,70703,NYA,MIN,NYC16,0,8,8
NYA200707040,2007,70704,NYA,MIN,NYC16,6,2,8
NYA200707050,2007,70705,NYA,MIN,NYC16,6,7,13
NYA200707060,2007,70706,NYA,ANA,NYC16,9,14,23
NYA200707070,2007,70707,NYA,ANA,NYC16,2,1,3
NYA200707080,2007,70708,NYA,ANA,NYC16,0,12,12
NYA200707160,2007,70716,NYA,TOR,NYC16,4,6,10
NYA200707170,2007,70717,NYA,TOR,NYC16,2,3,5
NYA200707180,2007,70718,NYA,TOR,NYC16,1,6,7
NYA200707190,2007,70719,NYA,TOR,NYC16,3,2,5
NYA200707200,2007,70720,NYA,TBA,NYC16,14,4,18
NYA200707211,2007,70721,NYA,TBA,NYC16,3,7,10
NYA200707212,2007,70721,NYA,TBA,NYC16,5,17,22
NYA200707220,2007,70722,NYA,TBA,NYC16,4,21,25
NYA200707310,2007,70731,NYA,CHA,NYC16,3,16,19
NYA200708010,2007,70801,NYA,CHA,NYC16,1,8,9
NYA200708020,2007,70802,NYA,CHA,NYC16,13,9,22
NYA200708030,2007,70803,NYA,KCA,NYC16,1,7,8
NYA200708040,2007,70804,NYA,KCA,NYC16,8,16,24
NYA200708050,2007,70805,NYA,KCA,NYC16,5,8,13
NYA200708130,2007,70813,NYA,BAL,NYC16,6,7,13
NYA200708140,2007,70814,NYA,BAL,NYC16,12,0,12
NYA200708150,2007,70815,NYA,BAL,NYC16,6,3,9
NYA200708160,2007,70816,NYA,DET,NYC16,8,5,13
NYA200708170,2007,70817,NYA,DET,NYC16,1,6,7
NYA200708180,2007,70818,NYA,DET,NYC16,2,5,7
NYA200708190,2007,70819,NYA,DET,NYC16,3,9,12
NYA200708280,2007,70828,NYA,BOS,NYC16,3,5,8
NYA200708290,2007,70829,NYA,BOS,NYC16,3,4,7
NYA200708300,2007,70830,NYA,BOS,NYC16,0,5,5
NYA200708310,2007,70831,NYA,TBA,NYC16,9,1,10
NYA200709010,2007,70901,NYA,TBA,NYC16,6,9,15
NYA200709020,2007,70902,NYA,TBA,NYC16,8,2,10
NYA200709030,2007,70903,NYA,SEA,NYC16,7,1,8
NYA200709040,2007,70904,NYA,SEA,NYC16,3,12,15
NYA200709050,2007,70905,NYA,SEA,NYC16,2,10,12
NYA200709170,2007,70917,NYA,BAL,NYC16,5,8,13
NYA200709180,2007,70918,NYA,BAL,NYC16,0,12,12
NYA200709190,2007,70919,NYA,BAL,NYC16,1,2,3
NYA200709210,2007,70921,NYA,TOR,NYC16,5,4,9
NYA200709220,2007,70922,NYA,TOR,NYC16,11,12,23
NYA200709230,2007,70923,NYA,TOR,NYC16,5,7,12
NYA200709240,2007,70924,NYA,TOR,NYC16,4,1,5
NYA200710070,2007,71007,NYA,CLE,NYC16,4,8,12
NYA200710080,2007,71008,NYA,CLE,NYC16,6,4,10
NYA200804010,2008,80401,NYA,TOR,NYC16,2,3,5
NYA200804020,2008,80402,NYA,TOR,NYC16,5,2,7
NYA200804030,2008,80403,NYA,TOR,NYC16,2,3,5
NYA200804040,2008,80404,NYA,TBA,NYC16,13,4,17
NYA200804050,2008,80405,NYA,TBA,NYC16,6,3,9
NYA200804060,2008,80406,NYA,TBA,NYC16,0,2,2
NYA200804070,2008,80407,NYA,TBA,NYC16,1,6,7
NYA200804160,2008,80416,NYA,BOS,NYC16,9,15,24
NYA200804170,2008,80417,NYA,BOS,NYC16,7,5,12
NYA200804290,2008,80429,NYA,DET,NYC16,6,4,10
NYA200804300,2008,80430,NYA,DET,NYC16,6,2,8
NYA200805010,2008,80501,NYA,DET,NYC16,8,4,12
NYA200805020,2008,80502,NYA,SEA,NYC16,1,5,6
NYA200805030,2008,80503,NYA,SEA,NYC16,1,6,7
NYA200805040,2008,80504,NYA,SEA,NYC16,2,8,10
NYA200805060,2008,80506,NYA,CLE,NYC16,5,3,8
NYA200805070,2008,80507,NYA,CLE,NYC16,3,0,3
NYA200805080,2008,80508,NYA,CLE,NYC16,3,6,9
NYA200805170,2008,80517,NYA,NYN,NYC16,7,4,11
NYA200805180,2008,80518,NYA,NYN,NYC16,11,2,13
NYA200805200,2008,80520,NYA,BAL,NYC16,12,2,14
NYA200805210,2008,80521,NYA,BAL,NYC16,0,8,8
NYA200805220,2008,80522,NYA,BAL,NYC16,1,2,3
NYA200805230,2008,80523,NYA,SEA,NYC16,2,13,15
NYA200805240,2008,80524,NYA,SEA,NYC16,6,12,18
NYA200805250,2008,80525,NYA,SEA,NYC16,5,6,11
NYA200806030,2008,80603,NYA,TOR,NYC16,9,3,12
NYA200806040,2008,80604,NYA,TOR,NYC16,1,5,6
NYA200806050,2008,80605,NYA,TOR,NYC16,8,9,17
NYA200806060,2008,80606,NYA,KCA,NYC16,2,1,3
NYA200806070,2008,80607,NYA,KCA,NYC16,11,12,23
NYA200806080,2008,80608,NYA,KCA,NYC16,3,6,9
NYA200806090,2008,80609,NYA,KCA,NYC16,3,2,5
NYA200806170,2008,80617,NYA,SDN,NYC16,0,8,8
NYA200806180,2008,80618,NYA,SDN,NYC16,5,8,13
NYA200806190,2008,80619,NYA,SDN,NYC16,1,2,3
NYA200806200,2008,80620,NYA,CIN,NYC16,4,2,6
NYA200806210,2008,80621,NYA,CIN,NYC16,6,0,6
NYA200806220,2008,80622,NYA,CIN,NYC16,1,4,5
NYA200806270,2008,80627,NYA,NYN,NYC16,15,6,21
NYA200806300,2008,80630,NYA,TEX,NYC16,2,1,3
NYA200807010,2008,80701,NYA,TEX,NYC16,3,2,5
NYA200807020,2008,80702,NYA,TEX,NYC16,7,18,25
NYA200807030,2008,80703,NYA,BOS,NYC16,7,0,7
NYA200807040,2008,80704,NYA,BOS,NYC16,6,4,10
NYA200807050,2008,80705,NYA,BOS,NYC16,1,2,3
NYA200807060,2008,80706,NYA,BOS,NYC16,4,5,9
NYA200807080,2008,80708,NYA,TBA,NYC16,0,5,5
NYA200807090,2008,80709,NYA,TBA,NYC16,1,2,3
NYA200807180,2008,80718,NYA,OAK,NYC16,1,7,8
NYA200807190,2008,80719,NYA,OAK,NYC16,3,4,7
NYA200807200,2008,80720,NYA,OAK,NYC16,1,2,3
NYA200807210,2008,80721,NYA,MIN,NYC16,4,12,16
NYA200807220,2008,80722,NYA,MIN,NYC16,2,8,10
NYA200807230,2008,80723,NYA,MIN,NYC16,1,5,6
NYA200807280,2008,80728,NYA,BAL,NYC16,13,4,17
NYA200807290,2008,80729,NYA,BAL,NYC16,7,6,13
NYA200807300,2008,80730,NYA,BAL,NYC16,3,13,16
NYA200807310,2008,80731,NYA,ANA,NYC16,12,6,18
NYA200808010,2008,80801,NYA,ANA,NYC16,1,0,1
NYA200808020,2008,80802,NYA,ANA,NYC16,2,8,10
NYA200808030,2008,80803,NYA,ANA,NYC16,9,14,23
NYA200808150,2008,80815,NYA,KCA,NYC16,4,3,7
NYA200808160,2008,80816,NYA,KCA,NYC16,2,3,5
NYA200808170,2008,80817,NYA,KCA,NYC16,6,15,21
NYA200808260,2008,80826,NYA,BOS,NYC16,7,3,10
NYA200808270,2008,80827,NYA,BOS,NYC16,11,3,14
NYA200808280,2008,80828,NYA,BOS,NYC16,2,3,5
NYA200808290,2008,80829,NYA,TOR,NYC16,1,2,3
NYA200808300,2008,80830,NYA,TOR,NYC16,7,6,13
NYA200808310,2008,80831,NYA,TOR,NYC16,6,2,8
NYA200809131,2008,80913,NYA,TBA,NYC16,7,1,8
NYA200809132,2008,80913,NYA,TBA,NYC16,5,6,11
NYA200809140,2008,80914,NYA,TBA,NYC16,4,8,12
NYA200809150,2008,80915,NYA,CHA,NYC16,2,4,6
NYA200809160,2008,80916,NYA,CHA,NYC16,6,2,8
NYA200809170,2008,80917,NYA,CHA,NYC16,1,5,6
NYA200809180,2008,80918,NYA,CHA,NYC16,2,9,11
NYA200809190,2008,80919,NYA,BAL,NYC16,2,3,5
NYA200809200,2008,80920,NYA,BAL,NYC16,0,1,1
NYA200809210,2008,80921,NYA,BAL,NYC16,3,7,10
NYA200904160,2009,90416,NYA,CLE,NYC21,10,2,12
NYA200904170,2009,90417,NYA,CLE,NYC21,5,6,11
NYA200904180,2009,90418,NYA,CLE,NYC21,22,4,26
NYA200904190,2009,90419,NYA,CLE,NYC21,3,7,10
NYA200904210,2009,90421,NYA,OAK,NYC21,3,5,8
NYA200904220,2009,90422,NYA,OAK,NYC21,7,9,16
NYA200904300,2009,90430,NYA,ANA,NYC21,4,7,11
NYA200905010,2009,90501,NYA,ANA,NYC21,9,10,19
NYA200905020,2009,90502,NYA,ANA,NYC21,8,4,12
NYA200905040,2009,90504,NYA,BOS,NYC21,6,4,10
NYA200905050,2009,90505,NYA,BOS,NYC21,7,3,10
NYA200905060,2009,90506,NYA,TBA,NYC21,4,3,7
NYA200905070,2009,90507,NYA,TBA,NYC21,8,6,14
NYA200905150,2009,90515,NYA,MIN,NYC21,4,5,9
NYA200905160,2009,90516,NYA,MIN,NYC21,4,6,10
NYA200905170,2009,90517,NYA,MIN,NYC21,2,3,5
NYA200905180,2009,90518,NYA,MIN,NYC21,6,7,13
NYA200905190,2009,90519,NYA,BAL,NYC21,1,9,10
NYA200905200,2009,90520,NYA,BAL,NYC21,4,11,15
NYA200905210,2009,90521,NYA,BAL,NYC21,4,7,11
NYA200905220,2009,90522,NYA,PHI,NYC21,7,3,10
NYA200905230,2009,90523,NYA,PHI,NYC21,4,5,9
NYA200905240,2009,90524,NYA,PHI,NYC21,4,3,7
NYA200906020,2009,90602,NYA,TEX,NYC21,3,12,15
NYA200906030,2009,90603,NYA,TEX,NYC21,4,2,6
NYA200906040,2009,90604,NYA,TEX,NYC21,6,8,14
NYA200906060,2009,90606,NYA,TBA,NYC21,9,7,16
NYA200906070,2009,90607,NYA,TBA,NYC21,3,4,7
NYA200906080,2009,90608,NYA,TBA,NYC21,3,5,8
NYA200906120,2009,90612,NYA,NYN,NYC21,8,9,17
NYA200906130,2009,90613,NYA,NYN,NYC21,6,2,8
NYA200906140,2009,90614,NYA,NYN,NYC21,0,15,15
NYA200906160,2009,90616,NYA,WAS,NYC21,3,5,8
NYA200906170,2009,90617,NYA,WAS,NYC21,3,2,5
NYA200906180,2009,90618,NYA,WAS,NYC21,3,0,3
NYA200906300,2009,90630,NYA,SEA,NYC21,5,8,13
NYA200907010,2009,90701,NYA,SEA,NYC21,2,4,6
NYA200907020,2009,90702,NYA,SEA,NYC21,8,4,12
NYA200907030,2009,90703,NYA,TOR,NYC21,2,4,6
NYA200907040,2009,90704,NYA,TOR,NYC21,5,6,11
NYA200907050,2009,90705,NYA,TOR,NYC21,8,10,18
NYA200907060,2009,90706,NYA,TOR,NYC21,7,6,13
NYA200907170,2009,90717,NYA,DET,NYC21,3,5,8
NYA200907180,2009,90718,NYA,DET,NYC21,1,2,3
NYA200907190,2009,90719,NYA,DET,NYC21,1,2,3
NYA200907200,2009,90720,NYA,BAL,NYC21,1,2,3
NYA200907210,2009,90721,NYA,BAL,NYC21,4,6,10
NYA200907220,2009,90722,NYA,BAL,NYC21,4,6,10
NYA200907230,2009,90723,NYA,OAK,NYC21,3,6,9
NYA200907240,2009,90724,NYA,OAK,NYC21,3,8,11
NYA200907250,2009,90725,NYA,OAK,NYC21,6,4,10
NYA200907260,2009,90726,NYA,OAK,NYC21,5,7,12
NYA200908060,2009,90806,NYA,BOS,NYC21,6,13,19
NYA200908070,2009,90807,NYA,BOS,NYC21,0,2,2
NYA200908080,2009,90808,NYA,BOS,NYC21,0,5,5
NYA200908090,2009,90809,NYA,BOS,NYC21,2,5,7
NYA200908100,2009,90810,NYA,TOR,NYC21,5,4,9
NYA200908110,2009,90811,NYA,TOR,NYC21,5,7,12
NYA200908120,2009,90812,NYA,TOR,NYC21,3,4,7
NYA200908250,2009,90825,NYA,TEX,NYC21,10,9,19
NYA200908260,2009,90826,NYA,TEX,NYC21,2,9,11
NYA200908270,2009,90827,NYA,TEX,NYC21,7,2,9
NYA200908280,2009,90828,NYA,CHA,NYC21,2,5,7
NYA200908290,2009,90829,NYA,CHA,NYC21,0,10,10
NYA200908300,2009,90830,NYA,CHA,NYC21,3,8,11
NYA200909071,2009,90907,NYA,TBA,NYC21,1,4,5
NYA200909072,2009,90907,NYA,TBA,NYC21,1,11,12
NYA200909080,2009,90908,NYA,TBA,NYC21,2,3,5
NYA200909090,2009,90909,NYA,TBA,NYC21,2,4,6
NYA200909110,2009,90911,NYA,BAL,NYC21,10,4,14
NYA200909120,2009,90912,NYA,BAL,NYC21,7,3,10
NYA200909130,2009,90913,NYA,BAL,NYC21,3,13,16
NYA200909140,2009,90914,NYA,ANA,NYC21,3,5,8
NYA200909150,2009,90915,NYA,TOR,NYC21,10,4,14
NYA200909160,2009,90916,NYA,TOR,NYC21,4,5,9
NYA200909250,2009,90925,NYA,BOS,NYC21,5,9,14
NYA200909260,2009,90926,NYA,BOS,NYC21,0,3,3
NYA200909270,2009,90927,NYA,BOS,NYC21,2,4,6
NYA200909280,2009,90928,NYA,KCA,NYC21,2,8,10
NYA200909290,2009,90929,NYA,KCA,NYC21,3,4,7
NYA200909300,2009,90930,NYA,KCA,NYC21,4,3,7
NYA200910070,2009,91007,NYA,MIN,NYC21,2,7,9
NYA200910090,2009,91009,NYA,MIN,NYC21,3,4,7
NYA200910160,2009,91016,NYA,ANA,NYC21,1,4,5
NYA200910170,2009,91017,NYA,ANA,NYC21,3,4,7
NYA200910250,2009,91025,NYA,ANA,NYC21,2,5,7
NYA200910280,2009,91028,NYA,PHI,NYC21,6,1,7
NYA200910290,2009,91029,NYA,PHI,NYC21,1,3,4
NYA200911040,2009,91104,NYA,PHI,NYC21,3,7,10
NYN200003290,2000,329,NYN,CHN,TOK01,5,3,8
NYN200004030,2000,403,NYN,SDN,NYC17,1,2,3
NYN200004050,2000,405,NYN,SDN,NYC17,4,0,4
NYN200004060,2000,406,NYN,SDN,NYC17,8,5,13
NYN200004070,2000,407,NYN,LAN,NYC17,1,2,3
NYN200004080,2000,408,NYN,LAN,NYC17,6,5,11
NYN200004180,2000,418,NYN,MIL,NYC17,7,10,17
NYN200004190,2000,419,NYN,MIL,NYC17,1,3,4
NYN200004200,2000,420,NYN,MIL,NYC17,4,5,9
NYN200004221,2000,422,NYN,CHN,NYC17,3,8,11
NYN200004222,2000,422,NYN,CHN,NYC17,6,7,13
NYN200004230,2000,423,NYN,CHN,NYC17,8,15,23
NYN200004240,2000,424,NYN,LAN,NYC17,0,1,1
NYN200004250,2000,425,NYN,CIN,NYC17,5,6,11
NYN200004260,2000,426,NYN,CIN,NYC17,12,1,13
NYN200004270,2000,427,NYN,CIN,NYC17,2,1,3
NYN200005120,2000,512,NYN,FLO,NYC17,6,4,10
NYN200005130,2000,513,NYN,FLO,NYC17,7,6,13
NYN200005140,2000,514,NYN,FLO,NYC17,1,5,6
NYN200005160,2000,516,NYN,COL,NYC17,4,3,7
NYN200005170,2000,517,NYN,COL,NYC17,2,4,6
NYN200005190,2000,519,NYN,ARI,NYC17,3,4,7
NYN200005200,2000,520,NYN,ARI,NYC17,7,8,15
NYN200005210,2000,521,NYN,ARI,NYC17,6,7,13
NYN200006020,2000,602,NYN,TBA,NYC17,3,5,8
NYN200006030,2000,603,NYN,TBA,NYC17,0,1,1
NYN200006040,2000,604,NYN,TBA,NYC17,15,5,20
NYN200006050,2000,605,NYN,BAL,NYC17,4,2,6
NYN200006070,2000,607,NYN,BAL,NYC17,3,11,14
NYN200006080,2000,608,NYN,BAL,NYC17,7,8,15
NYN200006200,2000,620,NYN,PHI,NYC17,3,2,5
NYN200006210,2000,621,NYN,PHI,NYC17,10,5,15
NYN200006220,2000,622,NYN,PHI,NYC17,4,5,9
NYN200006230,2000,623,NYN,PIT,NYC17,2,12,14
NYN200006240,2000,624,NYN,PIT,NYC17,8,10,18
NYN200006250,2000,625,NYN,PIT,NYC17,0,9,9
NYN200006260,2000,626,NYN,FLO,NYC17,5,10,15
NYN200006270,2000,627,NYN,FLO,NYC17,2,5,7
NYN200006280,2000,628,NYN,FLO,NYC17,5,6,11
NYN200006290,2000,629,NYN,ATL,NYC17,6,4,10
NYN200006300,2000,630,NYN,ATL,NYC17,8,11,19
NYN200007010,2000,701,NYN,ATL,NYC17,1,9,10
NYN200007020,2000,702,NYN,ATL,NYC17,10,2,12
NYN200007070,2000,707,NYN,NYA,NYC17,2,1,3
NYN200007081,2000,708,NYN,NYA,NYC17,4,2,6
NYN200007090,2000,709,NYN,NYA,NYC17,0,2,2
NYN200007250,2000,725,NYN,MON,NYC17,0,5,5
NYN200007271,2000,727,NYN,MON,NYC17,8,9,17
NYN200007272,2000,727,NYN,MON,NYC17,3,4,7
NYN200007280,2000,728,NYN,SLN,NYC17,2,3,5
NYN200007290,2000,729,NYN,SLN,NYC17,3,4,7
NYN200007300,2000,730,NYN,SLN,NYC17,2,4,6
NYN200007310,2000,731,NYN,CIN,NYC17,6,0,6
NYN200008010,2000,801,NYN,CIN,NYC17,2,3,5
NYN200008020,2000,802,NYN,CIN,NYC17,1,2,3
NYN200008110,2000,811,NYN,SFN,NYC17,1,4,5
NYN200008120,2000,812,NYN,SFN,NYC17,2,3,5
NYN200008130,2000,813,NYN,SFN,NYC17,0,2,2
NYN200008140,2000,814,NYN,SFN,NYC17,11,1,12
NYN200008151,2000,815,NYN,COL,NYC17,5,7,12
NYN200008152,2000,815,NYN,COL,NYC17,3,4,7
NYN200008160,2000,816,NYN,COL,NYC17,7,5,12
NYN200008170,2000,817,NYN,COL,NYC17,2,13,15
NYN200008250,2000,825,NYN,ARI,NYC17,3,13,16
NYN200008260,2000,826,NYN,ARI,NYC17,5,1,6
NYN200008270,2000,827,NYN,ARI,NYC17,1,2,3
NYN200008280,2000,828,NYN,HOU,NYC17,2,4,6
NYN200008290,2000,829,NYN,HOU,NYC17,11,1,12
NYN200008300,2000,830,NYN,HOU,NYC17,0,1,1
NYN200009080,2000,908,NYN,PHI,NYC17,2,0,2
NYN200009090,2000,909,NYN,PHI,NYC17,6,3,9
NYN200009100,2000,910,NYN,PHI,NYC17,0,3,3
NYN200009110,2000,911,NYN,MIL,NYC17,8,2,10
NYN200009120,2000,912,NYN,MIL,NYC17,2,10,12
NYN200009130,2000,913,NYN,MIL,NYC17,1,4,5
NYN200009260,2000,926,NYN,ATL,NYC17,7,1,8
NYN200009270,2000,927,NYN,ATL,NYC17,2,6,8
NYN200009280,2000,928,NYN,ATL,NYC17,2,8,10
NYN200009290,2000,929,NYN,MON,NYC17,2,11,13
NYN200009300,2000,930,NYN,MON,NYC17,2,4,6
NYN200010010,2000,1001,NYN,MON,NYC17,2,3,5
NYN200010070,2000,1007,NYN,SFN,NYC17,2,3,5
NYN200010080,2000,1008,NYN,SFN,NYC17,0,4,4
NYN200010140,2000,1014,NYN,SLN,NYC17,8,2,10
NYN200010150,2000,1015,NYN,SLN,NYC17,6,10,16
NYN200010160,2000,1016,NYN,SLN,NYC17,0,7,7
NYN200010240,2000,1024,NYN,NYA,NYC17,2,4,6
NYN200010250,2000,1025,NYN,NYA,NYC17,3,2,5
NYN200010260,2000,1026,NYN,NYA,NYC17,4,2,6
NYN200104090,2001,10409,NYN,ATL,NYC17,4,9,13
NYN200104110,2001,10411,NYN,ATL,NYC17,2,0,2
NYN200104120,2001,10412,NYN,ATL,NYC17,0,1,1
NYN200104130,2001,10413,NYN,CIN,NYC17,3,2,5
NYN200104140,2001,10414,NYN,CIN,NYC17,1,0,1
NYN200104150,2001,10415,NYN,CIN,NYC17,3,1,4
NYN200104160,2001,10416,NYN,MON,NYC17,3,4,7
NYN200104170,2001,10417,NYN,MON,NYC17,0,4,4
NYN200104180,2001,10418,NYN,MON,NYC17,7,1,8
NYN200104300,2001,10430,NYN,HOU,NYC17,2,8,10
NYN200105010,2001,10501,NYN,HOU,NYC17,5,7,12
NYN200105020,2001,10502,NYN,HOU,NYC17,6,5,11
NYN200105040,2001,10504,NYN,ARI,NYC17,2,4,6
NYN200105050,2001,10505,NYN,ARI,NYC17,1,8,9
NYN200105060,2001,10506,NYN,ARI,NYC17,8,2,10
NYN200105150,2001,10515,NYN,SDN,NYC17,0,1,1
NYN200105160,2001,10516,NYN,SDN,NYC17,5,2,7
NYN200105170,2001,10517,NYN,SDN,NYC17,15,3,18
NYN200105180,2001,10518,NYN,LAN,NYC17,0,8,8
NYN200105190,2001,10519,NYN,LAN,NYC17,10,2,12
NYN200105200,2001,10520,NYN,LAN,NYC17,5,6,11
NYN200105240,2001,10524,NYN,FLO,NYC17,3,11,14
NYN200105250,2001,10525,NYN,FLO,NYC17,3,4,7
NYN200105260,2001,10526,NYN,FLO,NYC17,7,3,10
NYN200105270,2001,10527,NYN,FLO,NYC17,4,5,9
NYN200105280,2001,10528,NYN,PHI,NYC17,5,3,8
NYN200105290,2001,10529,NYN,PHI,NYC17,7,3,10
NYN200105300,2001,10530,NYN,PHI,NYC17,6,3,9
NYN200106150,2001,10615,NYN,NYA,NYC17,5,4,9
NYN200106160,2001,10616,NYN,NYA,NYC17,2,1,3
NYN200106170,2001,10617,NYN,NYA,NYC17,7,8,15
NYN200106180,2001,10618,NYN,MON,NYC17,1,2,3
NYN200106190,2001,10619,NYN,MON,NYC17,1,4,5
NYN200106200,2001,10620,NYN,MON,NYC17,3,4,7
NYN200106210,2001,10621,NYN,MON,NYC17,10,3,13
NYN200106220,2001,10622,NYN,ATL,NYC17,10,1,11
NYN200106230,2001,10623,NYN,ATL,NYC17,9,3,12
NYN200106240,2001,10624,NYN,ATL,NYC17,8,4,12
NYN200107030,2001,10703,NYN,CHN,NYC17,3,0,3
NYN200107040,2001,10704,NYN,CHN,NYC17,1,2,3
NYN200107050,2001,10705,NYN,CHN,NYC17,13,4,17
NYN200107120,2001,10712,NYN,BOS,NYC17,2,4,6
NYN200107130,2001,10713,NYN,BOS,NYC17,3,1,4
NYN200107140,2001,10714,NYN,BOS,NYC17,0,2,2
NYN200107150,2001,10715,NYN,TOR,NYC17,2,6,8
NYN200107160,2001,10716,NYN,TOR,NYC17,0,3,3
NYN200107170,2001,10717,NYN,TOR,NYC17,0,1,1
NYN200107180,2001,10718,NYN,FLO,NYC17,3,4,7
NYN200107190,2001,10719,NYN,FLO,NYC17,8,3,11
NYN200107260,2001,10726,NYN,PHI,NYC17,3,2,5
NYN200107270,2001,10727,NYN,PHI,NYC17,1,6,7
NYN200107280,2001,10728,NYN,PHI,NYC17,3,4,7
NYN200107290,2001,10729,NYN,PHI,NYC17,5,6,11
NYN200108070,2001,10807,NYN,MIL,NYC17,0,3,3
NYN200108080,2001,10808,NYN,MIL,NYC17,4,5,9
NYN200108090,2001,10809,NYN,MIL,NYC17,3,4,7
NYN200108100,2001,10810,NYN,SLN,NYC17,7,6,13
NYN200108110,2001,10811,NYN,SLN,NYC17,6,3,9
NYN200108120,2001,10812,NYN,SLN,NYC17,4,1,5
NYN200108210,2001,10821,NYN,COL,NYC17,2,5,7
NYN200108220,2001,10822,NYN,COL,NYC17,1,2,3
NYN200108230,2001,10823,NYN,COL,NYC17,10,0,10
NYN200108240,2001,10824,NYN,SFN,NYC17,3,4,7
NYN200108250,2001,10825,NYN,SFN,NYC17,2,3,5
NYN200108260,2001,10826,NYN,SFN,NYC17,5,6,11
NYN200108270,2001,10827,NYN,SFN,NYC17,6,5,11
NYN200108280,2001,10828,NYN,PHI,NYC17,9,6,15
NYN200108290,2001,10829,NYN,PHI,NYC17,5,7,12
NYN200108300,2001,10830,NYN,PHI,NYC17,2,6,8
NYN200108310,2001,10831,NYN,FLO,NYC17,1,6,7
NYN200109010,2001,10901,NYN,FLO,NYC17,2,3,5
NYN200109020,2001,10902,NYN,FLO,NYC17,5,1,6
NYN200109210,2001,10921,NYN,ATL,NYC17,2,3,5
NYN200109220,2001,10922,NYN,ATL,NYC17,3,7,10
NYN200109230,2001,10923,NYN,ATL,NYC17,5,4,9
NYN200110010,2001,11001,NYN,PIT,NYC17,5,1,6
NYN200110020,2001,11002,NYN,PIT,NYC17,10,1,11
NYN200110030,2001,11003,NYN,PIT,NYC17,0,3,3
NYN200110050,2001,11005,NYN,MON,NYC17,8,6,14
NYN200110060,2001,11006,NYN,MON,NYC17,0,4,4
NYN200110070,2001,11007,NYN,MON,NYC17,5,0,5
NYN200204010,2002,20401,NYN,PIT,NYC17,2,6,8
NYN200204030,2002,20403,NYN,PIT,NYC17,5,3,8
NYN200204040,2002,20404,NYN,PIT,NYC17,3,2,5
NYN200204120,2002,20412,NYN,MON,NYC17,1,2,3
NYN200204130,2002,20413,NYN,MON,NYC17,9,8,17
NYN200204140,2002,20414,NYN,MON,NYC17,4,6,10
NYN200204150,2002,20415,NYN,ATL,NYC17,6,7,13
NYN200204160,2002,20416,NYN,ATL,NYC17,1,3,4
NYN200204170,2002,20417,NYN,ATL,NYC17,2,1,3
NYN200204230,2002,20423,NYN,SLN,NYC17,3,4,7
NYN200204240,2002,20424,NYN,SLN,NYC17,4,2,6
NYN200204250,2002,20425,NYN,SLN,NYC17,6,7,13
NYN200204260,2002,20426,NYN,MIL,NYC17,0,1,1
NYN200204270,2002,20427,NYN,MIL,NYC17,1,2,3
NYN200204280,2002,20428,NYN,MIL,NYC17,6,9,15
NYN200205070,2002,20507,NYN,SFN,NYC17,5,1,6
NYN200205080,2002,20508,NYN,SFN,NYC17,8,2,10
NYN200205090,2002,20509,NYN,SFN,NYC17,4,3,7
NYN200205100,2002,20510,NYN,COL,NYC17,9,5,14
NYN200205110,2002,20511,NYN,COL,NYC17,3,4,7
NYN200205120,2002,20512,NYN,COL,NYC17,4,3,7
NYN200205240,2002,20524,NYN,FLO,NYC17,4,5,9
NYN200205250,2002,20525,NYN,FLO,NYC17,6,5,11
NYN200205260,2002,20526,NYN,FLO,NYC17,0,3,3
NYN200205270,2002,20527,NYN,FLO,NYC17,5,3,8
NYN200205280,2002,20528,NYN,PHI,NYC17,5,3,8
NYN200205290,2002,20529,NYN,PHI,NYC17,3,4,7
NYN200206140,2002,20614,NYN,NYA,NYC17,4,2,6
NYN200206150,2002,20615,NYN,NYA,NYC17,0,8,8
NYN200206160,2002,20616,NYN,NYA,NYC17,2,3,5
NYN200206180,2002,20618,NYN,MIN,NYC17,6,1,7
NYN200206190,2002,20619,NYN,MIN,NYC17,2,4,6
NYN200206200,2002,20620,NYN,MIN,NYC17,2,3,5
NYN200206210,2002,20621,NYN,KCA,NYC17,3,4,7
NYN200206220,2002,20622,NYN,KCA,NYC17,5,1,6
NYN200206230,2002,20623,NYN,KCA,NYC17,4,5,9
NYN200206240,2002,20624,NYN,ATL,NYC17,3,2,5
NYN200206250,2002,20625,NYN,ATL,NYC17,4,7,11
NYN200206260,2002,20626,NYN,ATL,NYC17,6,3,9
NYN200207110,2002,20711,NYN,PHI,NYC17,1,9,10
NYN200207120,2002,20712,NYN,PHI,NYC17,9,8,17
NYN200207130,2002,20713,NYN,PHI,NYC17,7,6,13
NYN200207140,2002,20714,NYN,PHI,NYC17,2,4,6
NYN200207150,2002,20715,NYN,FLO,NYC17,3,8,11
NYN200207160,2002,20716,NYN,FLO,NYC17,5,10,15
NYN200207220,2002,20722,NYN,MON,NYC17,2,5,7
NYN200207230,2002,20723,NYN,MON,NYC17,3,4,7
NYN200207240,2002,20724,NYN,MON,NYC17,2,1,3
NYN200207260,2002,20726,NYN,CIN,NYC17,2,3,5
NYN200207270,2002,20727,NYN,CIN,NYC17,2,1,3
NYN200207280,2002,20728,NYN,CIN,NYC17,5,6,11
NYN200207300,2002,20730,NYN,HOU,NYC17,16,3,19
NYN200207310,2002,20731,NYN,HOU,NYC17,0,10,10
NYN200208010,2002,20801,NYN,HOU,NYC17,3,1,4
NYN200208031,2002,20803,NYN,ARI,NYC17,8,5,13
NYN200208032,2002,20803,NYN,ARI,NYC17,9,2,11
NYN200208040,2002,20804,NYN,ARI,NYC17,12,7,19
NYN200208050,2002,20805,NYN,ARI,NYC17,2,0,2
NYN200208130,2002,20813,NYN,SDN,NYC17,7,2,9
NYN200208140,2002,20814,NYN,SDN,NYC17,6,2,8
NYN200208150,2002,20815,NYN,SDN,NYC17,5,3,8
NYN200208160,2002,20816,NYN,LAN,NYC17,3,2,5
NYN200208170,2002,20817,NYN,LAN,NYC17,10,4,14
NYN200208180,2002,20818,NYN,LAN,NYC17,2,1,3
NYN200208300,2002,20830,NYN,PHI,NYC17,7,5,12
NYN200208310,2002,20831,NYN,PHI,NYC17,1,0,1
NYN200209010,2002,20901,NYN,PHI,NYC17,9,5,14
NYN200209031,2002,20903,NYN,FLO,NYC17,3,2,5
NYN200209032,2002,20903,NYN,FLO,NYC17,5,11,16
NYN200209040,2002,20904,NYN,FLO,NYC17,3,11,14
NYN200209050,2002,20905,NYN,FLO,NYC17,1,4,5
NYN200209170,2002,20917,NYN,CHN,NYC17,1,3,4
NYN200209180,2002,20918,NYN,CHN,NYC17,1,2,3
NYN200209190,2002,20919,NYN,CHN,NYC17,2,3,5
NYN200209200,2002,20920,NYN,MON,NYC17,6,1,7
NYN200209210,2002,20921,NYN,MON,NYC17,3,6,9
NYN200209220,2002,20922,NYN,MON,NYC17,5,1,6
NYN200209271,2002,20927,NYN,ATL,NYC17,3,1,4
NYN200209272,2002,20927,NYN,ATL,NYC17,7,4,11
NYN200209280,2002,20928,NYN,ATL,NYC17,5,2,7
NYN200209290,2002,20929,NYN,ATL,NYC17,1,6,7
NYN200303310,2003,30331,NYN,CHN,NYC17,15,2,17
NYN200304020,2003,30402,NYN,CHN,NYC17,1,4,5
NYN200304030,2003,30403,NYN,CHN,NYC17,6,3,9
NYN200304040,2003,30404,NYN,MON,NYC17,0,4,4
NYN200304050,2003,30405,NYN,MON,NYC17,1,3,4
NYN200304060,2003,30406,NYN,MON,NYC17,8,5,13
NYN200304180,2003,30418,NYN,FLO,NYC17,3,6,9
NYN200304190,2003,30419,NYN,FLO,NYC17,6,5,11
NYN200304200,2003,30420,NYN,FLO,NYC17,4,7,11
NYN200304220,2003,30422,NYN,HOU,NYC17,6,2,8
NYN200304230,2003,30423,NYN,HOU,NYC17,2,4,6
NYN200304240,2003,30424,NYN,HOU,NYC17,4,7,11
NYN200304250,2003,30425,NYN,ARI,NYC17,3,4,7
NYN200304271,2003,30427,NYN,ARI,NYC17,6,1,7
NYN200304272,2003,30427,NYN,ARI,NYC17,7,3,10
NYN200305060,2003,30506,NYN,LAN,NYC17,2,3,5
NYN200305070,2003,30507,NYN,LAN,NYC17,2,1,3
NYN200305080,2003,30508,NYN,LAN,NYC17,6,1,7
NYN200305090,2003,30509,NYN,SDN,NYC17,5,4,9
NYN200305100,2003,30510,NYN,SDN,NYC17,2,4,6
NYN200305110,2003,30511,NYN,SDN,NYC17,2,3,5
NYN200305200,2003,30520,NYN,PHI,NYC17,11,7,18
NYN200305210,2003,30521,NYN,PHI,NYC17,4,5,9
NYN200305220,2003,30522,NYN,PHI,NYC17,3,6,9
NYN200305300,2003,30530,NYN,ATL,NYC17,5,2,7
NYN200305310,2003,30531,NYN,ATL,NYC17,2,4,6
NYN200306010,2003,30601,NYN,ATL,NYC17,4,10,14
NYN200306051,2003,30605,NYN,MIL,NYC17,8,7,15
NYN200306052,2003,30605,NYN,MIL,NYC17,5,3,8
NYN200306060,2003,30606,NYN,SEA,NYC17,2,3,5
NYN200306081,2003,30608,NYN,SEA,NYC17,13,1,14
NYN200306082,2003,30608,NYN,SEA,NYC17,7,0,7
NYN200306200,2003,30620,NYN,NYA,NYC17,5,0,5
NYN200306220,2003,30622,NYN,NYA,NYC17,7,3,10
NYN200306240,2003,30624,NYN,FLO,NYC17,8,4,12
NYN200306250,2003,30625,NYN,FLO,NYC17,3,6,9
NYN200306260,2003,30626,NYN,FLO,NYC17,6,1,7
NYN200306280,2003,30628,NYN,NYA,NYC17,9,8,17
NYN200306300,2003,30630,NYN,MON,NYC17,1,3,4
NYN200307010,2003,30701,NYN,MON,NYC17,6,7,13
NYN200307020,2003,30702,NYN,MON,NYC17,11,4,15
NYN200307070,2003,30707,NYN,ATL,NYC17,7,3,10
NYN200307080,2003,30708,NYN,ATL,NYC17,5,3,8
NYN200307090,2003,30709,NYN,ATL,NYC17,6,3,9
NYN200307100,2003,30710,NYN,PHI,NYC17,7,2,9
NYN200307110,2003,30711,NYN,PHI,NYC17,10,3,13
NYN200307120,2003,30712,NYN,PHI,NYC17,4,2,6
NYN200307130,2003,30713,NYN,PHI,NYC17,3,4,7
NYN200307250,2003,30725,NYN,CIN,NYC17,1,3,4
NYN200307260,2003,30726,NYN,CIN,NYC17,8,3,11
NYN200307270,2003,30727,NYN,CIN,NYC17,8,5,13
NYN200307280,2003,30728,NYN,MIL,NYC17,4,2,6
NYN200307290,2003,30729,NYN,MIL,NYC17,6,3,9
NYN200307300,2003,30730,NYN,MIL,NYC17,0,2,2
NYN200307310,2003,30731,NYN,MIL,NYC17,4,3,7
NYN200308010,2003,30801,NYN,SLN,NYC17,8,2,10
NYN200308020,2003,30802,NYN,SLN,NYC17,10,9,19
NYN200308030,2003,30803,NYN,SLN,NYC17,5,13,18
NYN200308120,2003,30812,NYN,SFN,NYC17,4,5,9
NYN200308130,2003,30813,NYN,SFN,NYC17,2,9,11
NYN200308150,2003,30815,NYN,COL,NYC17,0,5,5
NYN200308160,2003,30816,NYN,COL,NYC17,4,13,17
NYN200308170,2003,30817,NYN,COL,NYC17,4,6,10
NYN200308180,2003,30818,NYN,COL,NYC17,0,8,8
NYN200308290,2003,30829,NYN,PHI,NYC17,7,0,7
NYN200308300,2003,30830,NYN,PHI,NYC17,4,2,6
NYN200308310,2003,30831,NYN,PHI,NYC17,4,1,5
NYN200309010,2003,30901,NYN,ATL,NYC17,2,3,5
NYN200309020,2003,30902,NYN,ATL,NYC17,1,3,4
NYN200309030,2003,30903,NYN,ATL,NYC17,3,9,12
NYN200309080,2003,30908,NYN,FLO,NYC17,5,0,5
NYN200309090,2003,30909,NYN,FLO,NYC17,3,1,4
NYN200309100,2003,30910,NYN,FLO,NYC17,7,3,10
NYN200309180,2003,30918,NYN,MON,NYC17,1,0,1
NYN200309190,2003,30919,NYN,MON,NYC17,7,1,8
NYN200309200,2003,30920,NYN,MON,NYC17,4,3,7
NYN200309210,2003,30921,NYN,MON,NYC17,4,2,6
NYN200309230,2003,30923,NYN,PIT,NYC17,0,1,1
NYN200309240,2003,30924,NYN,PIT,NYC17,3,5,8
NYN200309250,2003,30925,NYN,PIT,NYC17,3,1,4
NYN200404120,2004,40412,NYN,ATL,NYC17,6,10,16
NYN200404140,2004,40414,NYN,ATL,NYC17,6,1,7
NYN200404150,2004,40415,NYN,ATL,NYC17,0,4,4
NYN200404160,2004,40416,NYN,PIT,NYC17,7,6,13
NYN200404170,2004,40417,NYN,PIT,NYC17,2,1,3
NYN200404180,2004,40418,NYN,PIT,NYC17,8,1,9
NYN200404190,2004,40419,NYN,MON,NYC17,1,4,5
NYN200404200,2004,40420,NYN,MON,NYC17,2,1,3
NYN200404210,2004,40421,NYN,MON,NYC17,2,1,3
NYN200404220,2004,40422,NYN,MON,NYC17,2,3,5
NYN200405040,2004,40504,NYN,SFN,NYC17,2,6,8
NYN200405050,2004,40505,NYN,SFN,NYC17,2,8,10
NYN200405060,2004,40506,NYN,SFN,NYC17,1,2,3
NYN200405070,2004,40507,NYN,MIL,NYC17,7,5,12
NYN200405080,2004,40508,NYN,MIL,NYC17,6,4,10
NYN200405090,2004,40509,NYN,MIL,NYC17,5,6,11
NYN200405180,2004,40518,NYN,SLN,NYC17,4,5,9
NYN200405190,2004,40519,NYN,SLN,NYC17,1,0,1
NYN200405200,2004,40520,NYN,SLN,NYC17,11,4,15
NYN200405210,2004,40521,NYN,COL,NYC17,7,9,16
NYN200405220,2004,40522,NYN,COL,NYC17,4,5,9
NYN200405230,2004,40523,NYN,COL,NYC17,0,4,4
NYN200405250,2004,40525,NYN,PHI,NYC17,0,5,5
NYN200405260,2004,40526,NYN,PHI,NYC17,7,4,11
NYN200406030,2004,40603,NYN,FLO,NYC17,1,4,5
NYN200406040,2004,40604,NYN,FLO,NYC17,5,1,6
NYN200406050,2004,40605,NYN,FLO,NYC17,7,6,13
NYN200406060,2004,40606,NYN,FLO,NYC17,2,5,7
NYN200406150,2004,40615,NYN,CLE,NYC17,2,7,9
NYN200406160,2004,40616,NYN,CLE,NYC17,9,1,10
NYN200406170,2004,40617,NYN,CLE,NYC17,2,6,8
NYN200406180,2004,40618,NYN,DET,NYC17,2,3,5
NYN200406190,2004,40619,NYN,DET,NYC17,3,4,7
NYN200406200,2004,40620,NYN,DET,NYC17,1,6,7
NYN200406220,2004,40622,NYN,CIN,NYC17,4,7,11
NYN200406230,2004,40623,NYN,CIN,NYC17,6,4,10
NYN200406240,2004,40624,NYN,CIN,NYC17,6,2,8
NYN200407020,2004,40702,NYN,NYA,NYC17,2,11,13
NYN200407030,2004,40703,NYN,NYA,NYC17,9,10,19
NYN200407040,2004,40704,NYN,NYA,NYC17,5,6,11
NYN200407150,2004,40715,NYN,PHI,NYC17,2,3,5
NYN200407160,2004,40716,NYN,PHI,NYC17,5,1,6
NYN200407170,2004,40717,NYN,PHI,NYC17,8,2,10
NYN200407180,2004,40718,NYN,PHI,NYC17,1,6,7
NYN200407190,2004,40719,NYN,FLO,NYC17,6,5,11
NYN200407200,2004,40720,NYN,FLO,NYC17,9,7,16
NYN200407210,2004,40721,NYN,MON,NYC17,4,5,9
NYN200407220,2004,40722,NYN,MON,NYC17,4,1,5
NYN200407240,2004,40724,NYN,ATL,NYC17,5,2,7
NYN200407250,2004,40725,NYN,ATL,NYC17,4,3,7
NYN200408100,2004,40810,NYN,HOU,NYC17,3,7,10
NYN200408110,2004,40811,NYN,HOU,NYC17,5,4,9
NYN200408120,2004,40812,NYN,HOU,NYC17,1,2,3
NYN200408130,2004,40813,NYN,ARI,NYC17,6,10,16
NYN200408140,2004,40814,NYN,ARI,NYC17,3,4,7
NYN200408150,2004,40815,NYN,ARI,NYC17,2,0,2
NYN200408230,2004,40823,NYN,SDN,NYC17,9,4,13
NYN200408240,2004,40824,NYN,SDN,NYC17,3,1,4
NYN200408250,2004,40825,NYN,SDN,NYC17,4,0,4
NYN200408260,2004,40826,NYN,SDN,NYC17,10,3,13
NYN200408270,2004,40827,NYN,LAN,NYC17,2,9,11
NYN200408280,2004,40828,NYN,LAN,NYC17,4,2,6
NYN200408290,2004,40829,NYN,LAN,NYC17,10,2,12
NYN200408300,2004,40830,NYN,FLO,NYC17,6,4,10
NYN200408310,2004,40831,NYN,FLO,NYC17,5,0,5
NYN200409010,2004,40901,NYN,FLO,NYC17,5,4,9
NYN200409020,2004,40902,NYN,FLO,NYC17,9,6,15
NYN200409100,2004,40910,NYN,PHI,NYC17,9,5,14
NYN200409110,2004,40911,NYN,PHI,NYC17,11,9,20
NYN200409120,2004,40912,NYN,PHI,NYC17,4,2,6
NYN200409131,2004,40913,NYN,ATL,NYC17,7,9,16
NYN200409132,2004,40913,NYN,ATL,NYC17,7,1,8
NYN200409140,2004,40914,NYN,ATL,NYC17,0,7,7
NYN200409150,2004,40915,NYN,ATL,NYC17,2,0,2
NYN200409160,2004,40916,NYN,ATL,NYC17,4,9,13
NYN200409240,2004,40924,NYN,CHN,NYC17,2,1,3
NYN200409250,2004,40925,NYN,CHN,NYC17,3,4,7
NYN200409260,2004,40926,NYN,CHN,NYC17,2,3,5
NYN200410010,2004,41001,NYN,MON,NYC17,4,2,6
NYN200410020,2004,41002,NYN,MON,NYC17,6,3,9
NYN200410030,2004,41003,NYN,MON,NYC17,1,8,9
NYN200504110,2005,50411,NYN,HOU,NYC17,4,8,12
NYN200504130,2005,50413,NYN,HOU,NYC17,0,1,1
NYN200504140,2005,50414,NYN,HOU,NYC17,3,4,7
NYN200504150,2005,50415,NYN,FLO,NYC17,0,4,4
NYN200504160,2005,50416,NYN,FLO,NYC17,3,4,7
NYN200504170,2005,50417,NYN,FLO,NYC17,5,2,7
NYN200504220,2005,50422,NYN,WAS,NYC17,1,3,4
NYN200504230,2005,50423,NYN,WAS,NYC17,5,10,15
NYN200504240,2005,50424,NYN,WAS,NYC17,11,4,15
NYN200504250,2005,50425,NYN,ATL,NYC17,4,5,9
NYN200504260,2005,50426,NYN,ATL,NYC17,4,3,7
NYN200504270,2005,50427,NYN,ATL,NYC17,8,4,12
NYN200505020,2005,50502,NYN,PHI,NYC17,1,5,6
NYN200505030,2005,50503,NYN,PHI,NYC17,10,3,13
NYN200505040,2005,50504,NYN,PHI,NYC17,2,3,5
NYN200505050,2005,50505,NYN,PHI,NYC17,5,7,12
NYN200505130,2005,50513,NYN,SLN,NYC17,0,2,2
NYN200505140,2005,50514,NYN,SLN,NYC17,7,6,13
NYN200505150,2005,50515,NYN,SLN,NYC17,4,2,6
NYN200505160,2005,50516,NYN,CIN,NYC17,2,9,11
NYN200505170,2005,50517,NYN,CIN,NYC17,1,2,3
NYN200505180,2005,50518,NYN,CIN,NYC17,6,10,16
NYN200505200,2005,50520,NYN,NYA,NYC17,5,2,7
NYN200505210,2005,50521,NYN,NYA,NYC17,1,7,8
NYN200505220,2005,50522,NYN,NYA,NYC17,5,3,8
NYN200505310,2005,50531,NYN,ARI,NYC17,7,0,7
NYN200506010,2005,50601,NYN,ARI,NYC17,1,2,3
NYN200506020,2005,50602,NYN,ARI,NYC17,1,6,7
NYN200506040,2005,50604,NYN,SFN,NYC17,1,5,6
NYN200506051,2005,50605,NYN,SFN,NYC17,6,3,9
NYN200506052,2005,50605,NYN,SFN,NYC17,1,12,13
NYN200506070,2005,50607,NYN,HOU,NYC17,1,3,4
NYN200506080,2005,50608,NYN,HOU,NYC17,4,1,5
NYN200506090,2005,50609,NYN,HOU,NYC17,6,3,9
NYN200506100,2005,50610,NYN,ANA,NYC17,12,2,14
NYN200506110,2005,50611,NYN,ANA,NYC17,3,5,8
NYN200506120,2005,50612,NYN,ANA,NYC17,4,3,7
NYN200506280,2005,50628,NYN,PHI,NYC17,3,8,11
NYN200506290,2005,50629,NYN,PHI,NYC17,6,3,9
NYN200506300,2005,50630,NYN,PHI,NYC17,3,5,8
NYN200507010,2005,50701,NYN,FLO,NYC17,6,7,13
NYN200507020,2005,50702,NYN,FLO,NYC17,7,3,10
NYN200507030,2005,50703,NYN,FLO,NYC17,3,0,3
NYN200507140,2005,50714,NYN,ATL,NYC17,3,6,9
NYN200507150,2005,50715,NYN,ATL,NYC17,2,1,3
NYN200507160,2005,50716,NYN,ATL,NYC17,3,0,3
NYN200507170,2005,50717,NYN,ATL,NYC17,1,8,9
NYN200507190,2005,50719,NYN,SDN,NYC17,1,3,4
NYN200507200,2005,50720,NYN,SDN,NYC17,3,7,10
NYN200507210,2005,50721,NYN,SDN,NYC17,0,12,12
NYN200507220,2005,50722,NYN,LAN,NYC17,6,5,11
NYN200507230,2005,50723,NYN,LAN,NYC17,5,7,12
NYN200507240,2005,50724,NYN,LAN,NYC17,0,6,6
NYN200508020,2005,50802,NYN,MIL,NYC17,8,9,17
NYN200508030,2005,50803,NYN,MIL,NYC17,6,4,10
NYN200508040,2005,50804,NYN,MIL,NYC17,12,9,21
NYN200508050,2005,50805,NYN,CHN,NYC17,5,9,14
NYN200508060,2005,50806,NYN,CHN,NYC17,0,2,2
NYN200508070,2005,50807,NYN,CHN,NYC17,1,6,7
NYN200508160,2005,50816,NYN,PIT,NYC17,2,6,8
NYN200508170,2005,50817,NYN,PIT,NYC17,1,5,6
NYN200508180,2005,50818,NYN,PIT,NYC17,5,0,5
NYN200508190,2005,50819,NYN,WAS,NYC17,0,1,1
NYN200508200,2005,50820,NYN,WAS,NYC17,8,9,17
NYN200508210,2005,50821,NYN,WAS,NYC17,7,4,11
NYN200508300,2005,50830,NYN,PHI,NYC17,4,6,10
NYN200508310,2005,50831,NYN,PHI,NYC17,8,2,10
NYN200509010,2005,50901,NYN,PHI,NYC17,3,1,4
NYN200509130,2005,50913,NYN,WAS,NYC17,4,2,6
NYN200509140,2005,50914,NYN,WAS,NYC17,6,3,9
NYN200509150,2005,50915,NYN,WAS,NYC17,6,5,11
NYN200509160,2005,50916,NYN,ATL,NYC17,0,4,4
NYN200509170,2005,50917,NYN,ATL,NYC17,7,4,11
NYN200509180,2005,50918,NYN,ATL,NYC17,1,4,5
NYN200509200,2005,50920,NYN,FLO,NYC17,2,3,5
NYN200509210,2005,50921,NYN,FLO,NYC17,4,5,9
NYN200509220,2005,50922,NYN,FLO,NYC17,2,1,3
NYN200509290,2005,50929,NYN,COL,NYC17,0,11,11
NYN200509300,2005,50930,NYN,COL,NYC17,2,3,5
NYN200510010,2005,51001,NYN,COL,NYC17,1,3,4
NYN200510020,2005,51002,NYN,COL,NYC17,11,3,14
NYN200604030,2006,60403,NYN,WAS,NYC17,2,3,5
NYN200604050,2006,60405,NYN,WAS,NYC17,9,5,14
NYN200604060,2006,60406,NYN,WAS,NYC17,5,10,15
NYN200604070,2006,60407,NYN,FLO,NYC17,3,9,12
NYN200604090,2006,60409,NYN,FLO,NYC17,2,3,5
NYN200604140,2006,60414,NYN,MIL,NYC17,3,4,7
NYN200604150,2006,60415,NYN,MIL,NYC17,8,2,10
NYN200604160,2006,60416,NYN,MIL,NYC17,3,9,12
NYN200604170,2006,60417,NYN,ATL,NYC17,3,4,7
NYN200604180,2006,60418,NYN,ATL,NYC17,7,1,8
NYN200604190,2006,60419,NYN,ATL,NYC17,2,1,3
NYN200605010,2006,60501,NYN,WAS,NYC17,1,2,3
NYN200605020,2006,60502,NYN,WAS,NYC17,6,2,8
NYN200605030,2006,60503,NYN,PIT,NYC17,3,4,7
NYN200605040,2006,60504,NYN,PIT,NYC17,0,6,6
NYN200605050,2006,60505,NYN,ATL,NYC17,7,8,15
NYN200605060,2006,60506,NYN,ATL,NYC17,5,6,11
NYN200605070,2006,60507,NYN,ATL,NYC17,13,3,16
NYN200605190,2006,60519,NYN,NYA,NYC17,6,7,13
NYN200605200,2006,60520,NYN,NYA,NYC17,5,4,9
NYN200605210,2006,60521,NYN,NYA,NYC17,3,4,7
NYN200605230,2006,60523,NYN,PHI,NYC17,8,9,17
NYN200605240,2006,60524,NYN,PHI,NYC17,4,5,9
NYN200605250,2006,60525,NYN,PHI,NYC17,5,3,8
NYN200605290,2006,60529,NYN,ARI,NYC17,7,8,15
NYN200605300,2006,60530,NYN,ARI,NYC17,7,2,9
NYN200605310,2006,60531,NYN,ARI,NYC17,0,1,1
NYN200606031,2006,60603,NYN,SFN,NYC17,6,4,10
NYN200606032,2006,60603,NYN,SFN,NYC17,2,3,5
NYN200606040,2006,60604,NYN,SFN,NYC17,7,6,13
NYN200606160,2006,60616,NYN,BAL,NYC17,6,3,9
NYN200606170,2006,60617,NYN,BAL,NYC17,4,2,6
NYN200606180,2006,60618,NYN,BAL,NYC17,4,9,13
NYN200606190,2006,60619,NYN,CIN,NYC17,4,2,6
NYN200606200,2006,60620,NYN,CIN,NYC17,2,9,11
NYN200606210,2006,60621,NYN,CIN,NYC17,6,5,11
NYN200606220,2006,60622,NYN,CIN,NYC17,2,6,8
NYN200607030,2006,60703,NYN,PIT,NYC17,11,1,12
NYN200607040,2006,60704,NYN,PIT,NYC17,6,7,13
NYN200607050,2006,60705,NYN,PIT,NYC17,0,5,5
NYN200607060,2006,60706,NYN,PIT,NYC17,5,7,12
NYN200607070,2006,60707,NYN,FLO,NYC17,7,3,10
NYN200607081,2006,60708,NYN,FLO,NYC17,3,2,5
NYN200607082,2006,60708,NYN,FLO,NYC17,3,17,20
NYN200607090,2006,60709,NYN,FLO,NYC17,6,7,13
NYN200607210,2006,60721,NYN,HOU,NYC17,0,7,7
NYN200607220,2006,60722,NYN,HOU,NYC17,3,4,7
NYN200607230,2006,60723,NYN,HOU,NYC17,8,4,12
NYN200607240,2006,60724,NYN,CHN,NYC17,8,7,15
NYN200607250,2006,60725,NYN,CHN,NYC17,8,6,14
NYN200607260,2006,60726,NYN,CHN,NYC17,0,1,1
NYN200608040,2006,60804,NYN,PHI,NYC17,5,3,8
NYN200608050,2006,60805,NYN,PHI,NYC17,3,4,7
NYN200608060,2006,60806,NYN,PHI,NYC17,1,8,9
NYN200608080,2006,60808,NYN,SDN,NYC17,2,3,5
NYN200608090,2006,60809,NYN,SDN,NYC17,3,4,7
NYN200608100,2006,60810,NYN,SDN,NYC17,3,7,10
NYN200608180,2006,60818,NYN,COL,NYC17,3,6,9
NYN200608190,2006,60819,NYN,COL,NYC17,4,7,11
NYN200608200,2006,60820,NYN,COL,NYC17,0,2,2
NYN200608220,2006,60822,NYN,SLN,NYC17,7,8,15
NYN200608230,2006,60823,NYN,SLN,NYC17,8,10,18
NYN200608240,2006,60824,NYN,SLN,NYC17,2,6,8
NYN200608250,2006,60825,NYN,PHI,NYC17,4,3,7
NYN200608260,2006,60826,NYN,PHI,NYC17,5,11,16
NYN200608280,2006,60828,NYN,PHI,NYC17,3,8,11
NYN200609040,2006,60904,NYN,ATL,NYC17,5,0,5
NYN200609061,2006,60906,NYN,ATL,NYC17,1,4,5
NYN200609062,2006,60906,NYN,ATL,NYC17,0,8,8
NYN200609070,2006,60907,NYN,LAN,NYC17,0,7,7
NYN200609080,2006,60908,NYN,LAN,NYC17,5,0,5
NYN200609090,2006,60909,NYN,LAN,NYC17,2,3,5
NYN200609100,2006,60910,NYN,LAN,NYC17,9,1,10
NYN200609180,2006,60918,NYN,FLO,NYC17,0,4,4
NYN200609190,2006,60919,NYN,FLO,NYC17,2,3,5
NYN200609200,2006,60920,NYN,FLO,NYC17,6,3,9
NYN200609210,2006,60921,NYN,FLO,NYC17,5,2,7
NYN200609220,2006,60922,NYN,WAS,NYC17,3,2,5
NYN200609230,2006,60923,NYN,WAS,NYC17,6,12,18
NYN200609240,2006,60924,NYN,WAS,NYC17,5,1,6
NYN200609250,2006,60925,NYN,WAS,NYC17,7,3,10
NYN200610040,2006,61004,NYN,LAN,NYC17,5,6,11
NYN200610050,2006,61005,NYN,LAN,NYC17,1,4,5
NYN200610120,2006,61012,NYN,SLN,NYC17,0,2,2
NYN200610130,2006,61013,NYN,SLN,NYC17,9,6,15
NYN200610180,2006,61018,NYN,SLN,NYC17,2,4,6
NYN200610190,2006,61019,NYN,SLN,NYC17,3,1,4
NYN200704090,2007,70409,NYN,PHI,NYC17,5,11,16
NYN200704110,2007,70411,NYN,PHI,NYC17,5,2,7
NYN200704120,2007,70412,NYN,PHI,NYC17,3,5,8
NYN200704130,2007,70413,NYN,WAS,NYC17,2,3,5
NYN200704140,2007,70414,NYN,WAS,NYC17,6,2,8
NYN200704200,2007,70420,NYN,ATL,NYC17,7,3,10
NYN200704210,2007,70421,NYN,ATL,NYC17,2,7,9
NYN200704220,2007,70422,NYN,ATL,NYC17,9,6,15
NYN200704230,2007,70423,NYN,COL,NYC17,1,6,7
NYN200704240,2007,70424,NYN,COL,NYC17,1,2,3
NYN200704250,2007,70425,NYN,COL,NYC17,11,5,16
NYN200704300,2007,70430,NYN,FLO,NYC17,9,6,15
NYN200705010,2007,70501,NYN,FLO,NYC17,5,2,7
NYN200705020,2007,70502,NYN,FLO,NYC17,3,6,9
NYN200705110,2007,70511,NYN,MIL,NYC17,4,5,9
NYN200705120,2007,70512,NYN,MIL,NYC17,12,3,15
NYN200705130,2007,70513,NYN,MIL,NYC17,1,9,10
NYN200705140,2007,70514,NYN,CHN,NYC17,4,5,9
NYN200705150,2007,70515,NYN,CHN,NYC17,10,1,11
NYN200705160,2007,70516,NYN,CHN,NYC17,1,8,9
NYN200705170,2007,70517,NYN,CHN,NYC17,5,6,11
NYN200705180,2007,70518,NYN,NYA,NYC17,2,3,5
NYN200705190,2007,70519,NYN,NYA,NYC17,7,10,17
NYN200705200,2007,70520,NYN,NYA,NYC17,6,2,8
NYN200705290,2007,70529,NYN,SFN,NYC17,4,5,9
NYN200705300,2007,70530,NYN,SFN,NYC17,3,0,3
NYN200705310,2007,70531,NYN,SFN,NYC17,2,4,6
NYN200706010,2007,70601,NYN,ARI,NYC17,5,1,6
NYN200706020,2007,70602,NYN,ARI,NYC17,1,7,8
NYN200706030,2007,70603,NYN,ARI,NYC17,4,1,5
NYN200706050,2007,70605,NYN,PHI,NYC17,4,2,6
NYN200706060,2007,70606,NYN,PHI,NYC17,4,2,6
NYN200706070,2007,70607,NYN,PHI,NYC17,6,3,9
NYN200706180,2007,70618,NYN,MIN,NYC17,1,8,9
NYN200706190,2007,70619,NYN,MIN,NYC17,9,0,9
NYN200706200,2007,70620,NYN,MIN,NYC17,6,2,8
NYN200706220,2007,70622,NYN,OAK,NYC17,1,9,10
NYN200706230,2007,70623,NYN,OAK,NYC17,0,1,1
NYN200706240,2007,70624,NYN,OAK,NYC17,2,10,12
NYN200706250,2007,70625,NYN,SLN,NYC17,1,2,3
NYN200706260,2007,70626,NYN,SLN,NYC17,5,3,8
NYN200706270,2007,70627,NYN,SLN,NYC17,0,2,2
NYN200707120,2007,70712,NYN,CIN,NYC17,2,3,5
NYN200707130,2007,70713,NYN,CIN,NYC17,8,4,12
NYN200707140,2007,70714,NYN,CIN,NYC17,1,2,3
NYN200707150,2007,70715,NYN,CIN,NYC17,2,5,7
NYN200707240,2007,70724,NYN,PIT,NYC17,4,8,12
NYN200707250,2007,70725,NYN,PIT,NYC17,3,6,9
NYN200707260,2007,70726,NYN,PIT,NYC17,8,4,12
NYN200707270,2007,70727,NYN,WAS,NYC17,6,2,8
NYN200707281,2007,70728,NYN,WAS,NYC17,1,3,4
NYN200707282,2007,70728,NYN,WAS,NYC17,6,5,11
NYN200707290,2007,70729,NYN,WAS,NYC17,0,5,5
NYN200708070,2007,70807,NYN,ATL,NYC17,7,3,10
NYN200708080,2007,70808,NYN,ATL,NYC17,3,4,7
NYN200708090,2007,70809,NYN,ATL,NYC17,7,6,13
NYN200708100,2007,70810,NYN,FLO,NYC17,4,3,7
NYN200708110,2007,70811,NYN,FLO,NYC17,7,5,12
NYN200708120,2007,70812,NYN,FLO,NYC17,4,10,14
NYN200708210,2007,70821,NYN,SDN,NYC17,6,7,13
NYN200708220,2007,70822,NYN,SDN,NYC17,7,5,12
NYN200708230,2007,70823,NYN,SDN,NYC17,9,8,17
NYN200708240,2007,70824,NYN,LAN,NYC17,2,5,7
NYN200708250,2007,70825,NYN,LAN,NYC17,3,4,7
NYN200708260,2007,70826,NYN,LAN,NYC17,6,2,8
NYN200709070,2007,70907,NYN,HOU,NYC17,3,11,14
NYN200709080,2007,70908,NYN,HOU,NYC17,1,3,4
NYN200709090,2007,70909,NYN,HOU,NYC17,1,4,5
NYN200709100,2007,70910,NYN,ATL,NYC17,2,3,5
NYN200709110,2007,70911,NYN,ATL,NYC17,13,5,18
NYN200709120,2007,70912,NYN,ATL,NYC17,3,4,7
NYN200709140,2007,70914,NYN,PHI,NYC17,3,2,5
NYN200709150,2007,70915,NYN,PHI,NYC17,5,3,8
NYN200709160,2007,70916,NYN,PHI,NYC17,10,6,16
NYN200709240,2007,70924,NYN,WAS,NYC17,13,4,17
NYN200709250,2007,70925,NYN,WAS,NYC17,10,9,19
NYN200709260,2007,70926,NYN,WAS,NYC17,9,6,15
NYN200709270,2007,70927,NYN,SLN,NYC17,3,0,3
NYN200709280,2007,70928,NYN,FLO,NYC17,7,4,11
NYN200709290,2007,70929,NYN,FLO,NYC17,0,13,13
NYN200709300,2007,70930,NYN,FLO,NYC17,8,1,9
NYN200804080,2008,80408,NYN,PHI,NYC17,5,2,7
NYN200804090,2008,80409,NYN,PHI,NYC17,2,8,10
NYN200804100,2008,80410,NYN,PHI,NYC17,3,4,7
NYN200804110,2008,80411,NYN,MIL,NYC17,2,4,6
NYN200804120,2008,80412,NYN,MIL,NYC17,5,3,8
NYN200804130,2008,80413,NYN,MIL,NYC17,9,7,16
NYN200804150,2008,80415,NYN,WAS,NYC17,0,6,6
NYN200804160,2008,80416,NYN,WAS,NYC17,2,5,7
NYN200804170,2008,80417,NYN,WAS,NYC17,2,3,5
NYN200804250,2008,80425,NYN,ATL,NYC17,6,3,9
NYN200804260,2008,80426,NYN,ATL,NYC17,3,4,7
NYN200804270,2008,80427,NYN,ATL,NYC17,3,6,9
NYN200804290,2008,80429,NYN,PIT,NYC17,4,5,9
NYN200804300,2008,80430,NYN,PIT,NYC17,13,1,14
NYN200805101,2008,80510,NYN,CIN,NYC17,6,12,18
NYN200805102,2008,80510,NYN,CIN,NYC17,7,1,8
NYN200805110,2008,80511,NYN,CIN,NYC17,3,8,11
NYN200805120,2008,80512,NYN,WAS,NYC17,10,4,14
NYN200805130,2008,80513,NYN,WAS,NYC17,3,6,9
NYN200805140,2008,80514,NYN,WAS,NYC17,5,3,8
NYN200805150,2008,80515,NYN,WAS,NYC17,1,0,1
NYN200805260,2008,80526,NYN,FLO,NYC17,7,3,10
NYN200805270,2008,80527,NYN,FLO,NYC17,3,5,8
NYN200805280,2008,80528,NYN,FLO,NYC17,6,7,13
NYN200805290,2008,80529,NYN,LAN,NYC17,4,8,12
NYN200805300,2008,80530,NYN,LAN,NYC17,9,5,14
NYN200805310,2008,80531,NYN,LAN,NYC17,2,3,5
NYN200806010,2008,80601,NYN,LAN,NYC17,1,6,7
NYN200806100,2008,80610,NYN,ARI,NYC17,9,5,14
NYN200806110,2008,80611,NYN,ARI,NYC17,3,5,8
NYN200806120,2008,80612,NYN,ARI,NYC17,5,4,9
NYN200806130,2008,80613,NYN,TEX,NYC17,1,7,8
NYN200806151,2008,80615,NYN,TEX,NYC17,8,7,15
NYN200806152,2008,80615,NYN,TEX,NYC17,2,4,6
NYN200806230,2008,80623,NYN,SEA,NYC17,5,2,7
NYN200806240,2008,80624,NYN,SEA,NYC17,11,0,11
NYN200806250,2008,80625,NYN,SEA,NYC17,2,8,10
NYN200806270,2008,80627,NYN,NYA,NYC17,9,0,9
NYN200806280,2008,80628,NYN,NYA,NYC17,3,2,5
NYN200806290,2008,80629,NYN,NYA,NYC17,1,3,4
NYN200807080,2008,80708,NYN,SFN,NYC17,0,7,7
NYN200807090,2008,80709,NYN,SFN,NYC17,0,5,5
NYN200807100,2008,80710,NYN,SFN,NYC17,3,7,10
NYN200807110,2008,80711,NYN,COL,NYC17,1,2,3
NYN200807120,2008,80712,NYN,COL,NYC17,0,3,3
NYN200807130,2008,80713,NYN,COL,NYC17,0,7,7
NYN200807220,2008,80722,NYN,PHI,NYC17,8,6,14
NYN200807230,2008,80723,NYN,PHI,NYC17,3,6,9
NYN200807240,2008,80724,NYN,PHI,NYC17,1,3,4
NYN200807250,2008,80725,NYN,SLN,NYC17,2,7,9
NYN200807260,2008,80726,NYN,SLN,NYC17,10,8,18
NYN200807270,2008,80727,NYN,SLN,NYC17,1,9,10
NYN200808050,2008,80805,NYN,SDN,NYC17,5,6,11
NYN200808060,2008,80806,NYN,SDN,NYC17,4,2,6
NYN200808070,2008,80807,NYN,SDN,NYC17,3,5,8
NYN200808080,2008,80808,NYN,FLO,NYC17,0,3,3
NYN200808090,2008,80809,NYN,FLO,NYC17,6,8,14
NYN200808100,2008,80810,NYN,FLO,NYC17,8,2,10
NYN200808110,2008,80811,NYN,PIT,NYC17,7,5,12
NYN200808190,2008,80819,NYN,ATL,NYC17,3,7,10
NYN200808200,2008,80820,NYN,ATL,NYC17,3,6,9
NYN200808210,2008,80821,NYN,ATL,NYC17,4,5,9
NYN200808220,2008,80822,NYN,HOU,NYC17,0,3,3
NYN200808230,2008,80823,NYN,HOU,NYC17,8,3,11
NYN200808240,2008,80824,NYN,HOU,NYC17,6,4,10
NYN200808250,2008,80825,NYN,HOU,NYC17,1,9,10
NYN200809050,2008,80905,NYN,PHI,NYC17,3,0,3
NYN200809071,2008,80907,NYN,PHI,NYC17,6,2,8
NYN200809072,2008,80907,NYN,PHI,NYC17,3,6,9
NYN200809090,2008,80909,NYN,WAS,NYC17,8,10,18
NYN200809100,2008,80910,NYN,WAS,NYC17,10,13,23
NYN200809131,2008,80913,NYN,ATL,NYC17,3,2,5
NYN200809132,2008,80913,NYN,ATL,NYC17,0,5,5
NYN200809140,2008,80914,NYN,ATL,NYC17,7,4,11
NYN200809220,2008,80922,NYN,CHN,NYC17,9,5,14
NYN200809230,2008,80923,NYN,CHN,NYC17,2,6,8
NYN200809240,2008,80924,NYN,CHN,NYC17,9,6,15
NYN200809250,2008,80925,NYN,CHN,NYC17,6,7,13
NYN200809260,2008,80926,NYN,FLO,NYC17,6,1,7
NYN200809270,2008,80927,NYN,FLO,NYC17,0,2,2
NYN200809280,2008,80928,NYN,FLO,NYC17,4,2,6
NYN200904130,2009,90413,NYN,SDN,NYC20,6,5,11
NYN200904150,2009,90415,NYN,SDN,NYC20,2,7,9
NYN200904160,2009,90416,NYN,SDN,NYC20,6,5,11
NYN200904170,2009,90417,NYN,MIL,NYC20,4,5,9
NYN200904180,2009,90418,NYN,MIL,NYC20,0,1,1
NYN200904190,2009,90419,NYN,MIL,NYC20,4,2,6
NYN200904240,2009,90424,NYN,WAS,NYC20,3,4,7
NYN200904250,2009,90425,NYN,WAS,NYC20,2,8,10
NYN200904260,2009,90426,NYN,WAS,NYC20,8,1,9
NYN200904270,2009,90427,NYN,FLO,NYC20,1,7,8
NYN200904280,2009,90428,NYN,FLO,NYC20,7,4,11
NYN200904290,2009,90429,NYN,FLO,NYC20,4,3,7
NYN200905060,2009,90506,NYN,PHI,NYC20,0,1,1
NYN200905070,2009,90507,NYN,PHI,NYC20,5,7,12
NYN200905080,2009,90508,NYN,PIT,NYC20,3,7,10
NYN200905090,2009,90509,NYN,PIT,NYC20,1,10,11
NYN200905100,2009,90510,NYN,PIT,NYC20,4,8,12
NYN200905110,2009,90511,NYN,ATL,NYC20,8,3,11
NYN200905120,2009,90512,NYN,ATL,NYC20,3,4,7
NYN200905130,2009,90513,NYN,ATL,NYC20,8,7,15
NYN200905250,2009,90525,NYN,WAS,NYC20,2,5,7
NYN200905260,2009,90526,NYN,WAS,NYC20,1,6,7
NYN200905270,2009,90527,NYN,WAS,NYC20,4,7,11
NYN200905290,2009,90529,NYN,FLO,NYC20,1,2,3
NYN200905300,2009,90530,NYN,FLO,NYC20,7,3,10
NYN200905310,2009,90531,NYN,FLO,NYC20,2,3,5
NYN200906090,2009,90609,NYN,PHI,NYC20,5,6,11
NYN200906100,2009,90610,NYN,PHI,NYC20,5,4,9
NYN200906110,2009,90611,NYN,PHI,NYC20,6,3,9
NYN200906190,2009,90619,NYN,TBA,NYC20,3,5,8
NYN200906200,2009,90620,NYN,TBA,NYC20,3,1,4
NYN200906210,2009,90621,NYN,TBA,NYC20,10,6,16
NYN200906220,2009,90622,NYN,SLN,NYC20,4,6,10
NYN200906230,2009,90623,NYN,SLN,NYC20,3,0,3
NYN200906240,2009,90624,NYN,SLN,NYC20,0,11,11
NYN200906250,2009,90625,NYN,SLN,NYC20,2,3,5
NYN200906260,2009,90626,NYN,NYA,NYC20,9,1,10
NYN200906270,2009,90627,NYN,NYA,NYC20,5,0,5
NYN200906280,2009,90628,NYN,NYA,NYC20,4,2,6
NYN200907070,2009,90707,NYN,LAN,NYC20,8,0,8
NYN200907080,2009,90708,NYN,LAN,NYC20,4,5,9
NYN200907090,2009,90709,NYN,LAN,NYC20,11,2,13
NYN200907100,2009,90710,NYN,CIN,NYC20,3,0,3
NYN200907110,2009,90711,NYN,CIN,NYC20,0,4,4
NYN200907120,2009,90712,NYN,CIN,NYC20,7,9,16
NYN200907270,2009,90727,NYN,COL,NYC20,3,7,10
NYN200907280,2009,90728,NYN,COL,NYC20,0,4,4
NYN200907301,2009,90730,NYN,COL,NYC20,0,7,7
NYN200907302,2009,90730,NYN,COL,NYC20,4,2,6
NYN200907310,2009,90731,NYN,ARI,NYC20,3,2,5
NYN200908010,2009,90801,NYN,ARI,NYC20,6,9,15
NYN200908020,2009,90802,NYN,ARI,NYC20,5,2,7
NYN200908030,2009,90803,NYN,ARI,NYC20,6,5,11
NYN200908040,2009,90804,NYN,SLN,NYC20,12,7,19
NYN200908050,2009,90805,NYN,SLN,NYC20,0,9,9
NYN200908140,2009,90814,NYN,SFN,NYC20,0,3,3
NYN200908150,2009,90815,NYN,SFN,NYC20,5,4,9
NYN200908160,2009,90816,NYN,SFN,NYC20,2,3,5
NYN200908170,2009,90817,NYN,SFN,NYC20,10,1,11
NYN200908180,2009,90818,NYN,ATL,NYC20,4,9,13
NYN200908190,2009,90819,NYN,ATL,NYC20,15,2,17
NYN200908200,2009,90820,NYN,ATL,NYC20,3,2,5
NYN200908210,2009,90821,NYN,PHI,NYC20,2,4,6
NYN200908220,2009,90822,NYN,PHI,NYC20,4,1,5
NYN200908230,2009,90823,NYN,PHI,NYC20,9,7,16
NYN200908240,2009,90824,NYN,PHI,NYC20,6,2,8
NYN200909040,2009,90904,NYN,CHN,NYC20,2,6,8
NYN200909050,2009,90905,NYN,CHN,NYC20,5,3,8
NYN200909060,2009,90906,NYN,CHN,NYC20,2,4,6
NYN200909080,2009,90908,NYN,FLO,NYC20,4,2,6
NYN200909090,2009,90909,NYN,FLO,NYC20,6,3,9
NYN200909100,2009,90910,NYN,FLO,NYC20,13,4,17
NYN200909180,2009,90918,NYN,WAS,NYC20,6,5,11
NYN200909190,2009,90919,NYN,WAS,NYC20,2,3,5
NYN200909200,2009,90920,NYN,WAS,NYC20,2,6,8
NYN200909210,2009,90921,NYN,ATL,NYC20,11,3,14
NYN200909220,2009,90922,NYN,ATL,NYC20,3,1,4
NYN200909230,2009,90923,NYN,ATL,NYC20,5,2,7
NYN200910020,2009,91002,NYN,HOU,NYC20,1,7,8
NYN200910030,2009,91003,NYN,HOU,NYC20,1,5,6
NYN200910040,2009,91004,NYN,HOU,NYC20,0,4,4
OAK200004030,2000,403,OAK,DET,OAK01,7,4,11
OAK200004040,2000,404,OAK,DET,OAK01,1,3,4
OAK200004050,2000,405,OAK,DET,OAK01,2,8,10
OAK200004070,2000,407,OAK,CHA,OAK01,7,6,13
OAK200004080,2000,408,OAK,CHA,OAK01,7,3,10
OAK200004090,2000,409,OAK,CHA,OAK01,2,14,16
OAK200004100,2000,410,OAK,CLE,OAK01,9,4,13
OAK200004110,2000,411,OAK,CLE,OAK01,5,1,6
OAK200004120,2000,412,OAK,CLE,OAK01,5,0,5
OAK200004210,2000,421,OAK,BAL,OAK01,11,9,20
OAK200004220,2000,422,OAK,BAL,OAK01,4,3,7
OAK200004230,2000,423,OAK,BAL,OAK01,2,3,5
OAK200004240,2000,424,OAK,TOR,OAK01,3,2,5
OAK200004250,2000,425,OAK,TOR,OAK01,2,11,13
OAK200004260,2000,426,OAK,TOR,OAK01,4,2,6
OAK200005110,2000,511,OAK,SEA,OAK01,6,7,13
OAK200005120,2000,512,OAK,SEA,OAK01,7,9,16
OAK200005130,2000,513,OAK,SEA,OAK01,6,4,10
OAK200005140,2000,514,OAK,SEA,OAK01,2,7,9
OAK200005150,2000,515,OAK,KCA,OAK01,3,6,9
OAK200005160,2000,516,OAK,KCA,OAK01,8,7,15
OAK200005170,2000,517,OAK,KCA,OAK01,4,3,7
OAK200005180,2000,518,OAK,MIN,OAK01,10,5,15
OAK200005190,2000,519,OAK,MIN,OAK01,3,2,5
OAK200005200,2000,520,OAK,MIN,OAK01,3,0,3
OAK200005210,2000,521,OAK,MIN,OAK01,4,13,17
OAK200006020,2000,602,OAK,SFN,OAK01,4,5,9
OAK200006030,2000,603,OAK,SFN,OAK01,7,9,16
OAK200006040,2000,604,OAK,SFN,OAK01,18,2,20
OAK200006050,2000,605,OAK,SDN,OAK01,2,3,5
OAK200006060,2000,606,OAK,SDN,OAK01,4,5,9
OAK200006070,2000,607,OAK,SDN,OAK01,4,10,14
OAK200006190,2000,619,OAK,BAL,OAK01,12,13,25
OAK200006200,2000,620,OAK,BAL,OAK01,5,8,13
OAK200006210,2000,621,OAK,BAL,OAK01,3,10,13
OAK200006230,2000,623,OAK,KCA,OAK01,6,10,16
OAK200006240,2000,624,OAK,KCA,OAK01,8,3,11
OAK200006250,2000,625,OAK,KCA,OAK01,3,4,7
OAK200006270,2000,627,OAK,TEX,OAK01,6,7,13
OAK200006280,2000,628,OAK,TEX,OAK01,5,3,8
OAK200006290,2000,629,OAK,TEX,OAK01,3,1,4
OAK200007070,2000,707,OAK,ARI,OAK01,4,5,9
OAK200007080,2000,708,OAK,ARI,OAK01,7,8,15
OAK200007090,2000,709,OAK,ARI,OAK01,4,2,6
OAK200007190,2000,719,OAK,SEA,OAK01,6,3,9
OAK200007200,2000,720,OAK,SEA,OAK01,4,5,9
OAK200007210,2000,721,OAK,ANA,OAK01,12,3,15
OAK200007220,2000,722,OAK,ANA,OAK01,3,10,13
OAK200007230,2000,723,OAK,ANA,OAK01,0,5,5
OAK200007270,2000,727,OAK,BOS,OAK01,5,4,9
OAK200007280,2000,728,OAK,BOS,OAK01,4,1,5
OAK200007290,2000,729,OAK,BOS,OAK01,1,12,13
OAK200007300,2000,730,OAK,BOS,OAK01,2,5,7
OAK200007310,2000,731,OAK,TOR,OAK01,1,6,7
OAK200008010,2000,801,OAK,TOR,OAK01,1,3,4
OAK200008020,2000,802,OAK,TOR,OAK01,4,5,9
OAK200008110,2000,811,OAK,DET,OAK01,11,4,15
OAK200008120,2000,812,OAK,DET,OAK01,5,9,14
OAK200008130,2000,813,OAK,DET,OAK01,5,3,8
OAK200008140,2000,814,OAK,CLE,OAK01,1,8,9
OAK200008150,2000,815,OAK,CLE,OAK01,3,5,8
OAK200008160,2000,816,OAK,CLE,OAK01,6,7,13
OAK200008250,2000,825,OAK,NYA,OAK01,1,8,9
OAK200008260,2000,826,OAK,NYA,OAK01,10,6,16
OAK200008270,2000,827,OAK,NYA,OAK01,7,5,12
OAK200008280,2000,828,OAK,CHA,OAK01,0,3,3
OAK200008290,2000,829,OAK,CHA,OAK01,3,0,3
OAK200008300,2000,830,OAK,CHA,OAK01,8,3,11
OAK200009080,2000,908,OAK,TBA,OAK01,4,0,4
OAK200009090,2000,909,OAK,TBA,OAK01,0,10,10
OAK200009100,2000,910,OAK,TBA,OAK01,0,11,11
OAK200009110,2000,911,OAK,TBA,OAK01,1,5,6
OAK200009120,2000,912,OAK,MIN,OAK01,3,5,8
OAK200009130,2000,913,OAK,MIN,OAK01,7,6,13
OAK200009250,2000,925,OAK,ANA,OAK01,5,7,12
OAK200009260,2000,926,OAK,ANA,OAK01,3,10,13
OAK200009270,2000,927,OAK,ANA,OAK01,7,9,16
OAK200009280,2000,928,OAK,ANA,OAK01,6,3,9
OAK200009290,2000,929,OAK,TEX,OAK01,5,7,12
OAK200009300,2000,930,OAK,TEX,OAK01,2,23,25
OAK200010010,2000,1001,OAK,TEX,OAK01,0,3,3
OAK200010030,2000,1003,OAK,NYA,OAK01,3,5,8
OAK200010040,2000,1004,OAK,NYA,OAK01,4,0,4
OAK200010080,2000,1008,OAK,NYA,OAK01,7,5,12
OAK200104060,2001,10406,OAK,ANA,OAK01,5,4,9
OAK200104070,2001,10407,OAK,ANA,OAK01,2,4,6
OAK200104080,2001,10408,OAK,ANA,OAK01,6,4,10
OAK200104100,2001,10410,OAK,SEA,OAK01,5,1,6
OAK200104110,2001,10411,OAK,SEA,OAK01,3,0,3
OAK200104120,2001,10412,OAK,SEA,OAK01,7,3,10
OAK200104130,2001,10413,OAK,TEX,OAK01,13,1,14
OAK200104140,2001,10414,OAK,TEX,OAK01,9,8,17
OAK200104150,2001,10415,OAK,TEX,OAK01,10,8,18
OAK200105010,2001,10501,OAK,TOR,OAK01,5,4,9
OAK200105020,2001,10502,OAK,TOR,OAK01,0,6,6
OAK200105030,2001,10503,OAK,TOR,OAK01,2,3,5
OAK200105040,2001,10504,OAK,BOS,OAK01,3,7,10
OAK200105050,2001,10505,OAK,BOS,OAK01,7,1,8
OAK200105060,2001,10506,OAK,BOS,OAK01,5,4,9
OAK200105150,2001,10515,OAK,NYA,OAK01,2,3,5
OAK200105160,2001,10516,OAK,NYA,OAK01,3,4,7
OAK200105170,2001,10517,OAK,NYA,OAK01,3,8,11
OAK200105180,2001,10518,OAK,CHA,OAK01,2,3,5
OAK200105190,2001,10519,OAK,CHA,OAK01,3,4,7
OAK200105200,2001,10520,OAK,CHA,OAK01,2,6,8
OAK200105290,2001,10529,OAK,TBA,OAK01,5,1,6
OAK200105300,2001,10530,OAK,TBA,OAK01,2,15,17
OAK200105310,2001,10531,OAK,TBA,OAK01,1,10,11
OAK200106010,2001,10601,OAK,BAL,OAK01,8,4,12
OAK200106020,2001,10602,OAK,BAL,OAK01,7,0,7
OAK200106030,2001,10603,OAK,BAL,OAK01,1,5,6
OAK200106080,2001,10608,OAK,SFN,OAK01,2,4,6
OAK200106090,2001,10609,OAK,SFN,OAK01,4,3,7
OAK200106100,2001,10610,OAK,SFN,OAK01,2,6,8
OAK200106180,2001,10618,OAK,SEA,OAK01,3,4,7
OAK200106190,2001,10619,OAK,SEA,OAK01,8,7,15
OAK200106200,2001,10620,OAK,SEA,OAK01,4,6,10
OAK200106210,2001,10621,OAK,SEA,OAK01,12,10,22
OAK200106220,2001,10622,OAK,TEX,OAK01,2,1,3
OAK200106230,2001,10623,OAK,TEX,OAK01,4,5,9
OAK200106240,2001,10624,OAK,TEX,OAK01,9,5,14
OAK200107020,2001,10702,OAK,ANA,OAK01,0,1,1
OAK200107030,2001,10703,OAK,ANA,OAK01,2,5,7
OAK200107040,2001,10704,OAK,ANA,OAK01,0,2,2
OAK200107050,2001,10705,OAK,ANA,OAK01,5,2,7
OAK200107120,2001,10712,OAK,LAN,OAK01,0,6,6
OAK200107130,2001,10713,OAK,LAN,OAK01,7,11,18
OAK200107140,2001,10714,OAK,LAN,OAK01,5,3,8
OAK200107150,2001,10715,OAK,COL,OAK01,3,6,9
OAK200107160,2001,10716,OAK,COL,OAK01,1,5,6
OAK200107170,2001,10717,OAK,COL,OAK01,2,3,5
OAK200107240,2001,10724,OAK,MIN,OAK01,6,7,13
OAK200107250,2001,10725,OAK,MIN,OAK01,3,1,4
OAK200107260,2001,10726,OAK,MIN,OAK01,7,4,11
OAK200107270,2001,10727,OAK,KCA,OAK01,0,5,5
OAK200107280,2001,10728,OAK,KCA,OAK01,9,3,12
OAK200107290,2001,10729,OAK,KCA,OAK01,4,6,10
OAK200108070,2001,10807,OAK,BOS,OAK01,2,5,7
OAK200108080,2001,10808,OAK,BOS,OAK01,1,6,7
OAK200108090,2001,10809,OAK,BOS,OAK01,0,6,6
OAK200108100,2001,10810,OAK,NYA,OAK01,1,8,9
OAK200108110,2001,10811,OAK,NYA,OAK01,6,8,14
OAK200108120,2001,10812,OAK,NYA,OAK01,2,4,6
OAK200108200,2001,10820,OAK,CLE,OAK01,0,9,9
OAK200108210,2001,10821,OAK,CLE,OAK01,2,1,3
OAK200108220,2001,10822,OAK,CLE,OAK01,5,4,9
OAK200108230,2001,10823,OAK,CLE,OAK01,9,7,16
OAK200108240,2001,10824,OAK,DET,OAK01,8,4,12
OAK200108250,2001,10825,OAK,DET,OAK01,1,6,7
OAK200108260,2001,10826,OAK,DET,OAK01,6,7,13
OAK200109030,2001,10903,OAK,BAL,OAK01,2,4,6
OAK200109040,2001,10904,OAK,BAL,OAK01,2,5,7
OAK200109050,2001,10905,OAK,BAL,OAK01,6,12,18
OAK200109070,2001,10907,OAK,TBA,OAK01,3,9,12
OAK200109080,2001,10908,OAK,TBA,OAK01,4,10,14
OAK200109090,2001,10909,OAK,TBA,OAK01,3,4,7
OAK200109100,2001,10910,OAK,TEX,OAK01,1,7,8
OAK200109210,2001,10921,OAK,SEA,OAK01,1,5,6
OAK200109220,2001,10922,OAK,SEA,OAK01,2,11,13
OAK200109230,2001,10923,OAK,SEA,OAK01,4,7,11
OAK200109250,2001,10925,OAK,ANA,OAK01,3,9,12
OAK200109260,2001,10926,OAK,ANA,OAK01,1,3,4
OAK200109270,2001,10927,OAK,ANA,OAK01,2,6,8
OAK200110020,2001,11002,OAK,TEX,OAK01,4,9,13
OAK200110030,2001,11003,OAK,TEX,OAK01,4,5,9
OAK200110130,2001,11013,OAK,NYA,OAK01,1,0,1
OAK200110140,2001,11014,OAK,NYA,OAK01,9,2,11
OAK200204010,2002,20401,OAK,TEX,OAK01,3,8,11
OAK200204020,2002,20402,OAK,TEX,OAK01,2,3,5
OAK200204030,2002,20403,OAK,TEX,OAK01,6,9,15
OAK200204040,2002,20404,OAK,TEX,OAK01,7,5,12
OAK200204160,2002,20416,OAK,SEA,OAK01,6,2,8
OAK200204170,2002,20417,OAK,SEA,OAK01,7,4,11
OAK200204180,2002,20418,OAK,ANA,OAK01,2,4,6
OAK200204190,2002,20419,OAK,ANA,OAK01,9,7,16
OAK200204200,2002,20420,OAK,ANA,OAK01,7,8,15
OAK200204210,2002,20421,OAK,ANA,OAK01,5,6,11
OAK200204230,2002,20423,OAK,NYA,OAK01,2,1,3
OAK200204240,2002,20424,OAK,NYA,OAK01,8,5,13
OAK200204250,2002,20425,OAK,NYA,OAK01,2,6,8
OAK200204260,2002,20426,OAK,CHA,OAK01,4,6,10
OAK200204270,2002,20427,OAK,CHA,OAK01,1,16,17
OAK200204280,2002,20428,OAK,CHA,OAK01,0,10,10
OAK200205070,2002,20507,OAK,BOS,OAK01,9,7,16
OAK200205080,2002,20508,OAK,BOS,OAK01,12,6,18
OAK200205090,2002,20509,OAK,BOS,OAK01,5,1,6
OAK200205100,2002,20510,OAK,TOR,OAK01,6,2,8
OAK200205110,2002,20511,OAK,TOR,OAK01,4,7,11
OAK200205120,2002,20512,OAK,TOR,OAK01,11,4,15
OAK200205210,2002,20521,OAK,BAL,OAK01,6,4,10
OAK200205220,2002,20522,OAK,BAL,OAK01,6,7,13
OAK200205230,2002,20523,OAK,BAL,OAK01,11,3,14
OAK200205240,2002,20524,OAK,TBA,OAK01,8,9,17
OAK200205250,2002,20525,OAK,TBA,OAK01,0,6,6
OAK200205260,2002,20526,OAK,TBA,OAK01,0,7,7
OAK200206030,2002,20603,OAK,SEA,OAK01,4,1,5
OAK200206040,2002,20604,OAK,SEA,OAK01,2,3,5
OAK200206050,2002,20605,OAK,SEA,OAK01,5,0,5
OAK200206060,2002,20606,OAK,SEA,OAK01,4,10,14
OAK200206070,2002,20607,OAK,HOU,OAK01,3,5,8
OAK200206080,2002,20608,OAK,HOU,OAK01,1,5,6
OAK200206090,2002,20609,OAK,HOU,OAK01,6,7,13
OAK200206100,2002,20610,OAK,MIL,OAK01,6,8,14
OAK200206110,2002,20611,OAK,MIL,OAK01,2,11,13
OAK200206120,2002,20612,OAK,MIL,OAK01,0,8,8
OAK200206280,2002,20628,OAK,SFN,OAK01,6,10,16
OAK200206290,2002,20629,OAK,SFN,OAK01,5,3,8
OAK200206300,2002,20630,OAK,SFN,OAK01,0,7,7
OAK200207010,2002,20701,OAK,MIN,OAK01,5,4,9
OAK200207020,2002,20702,OAK,MIN,OAK01,3,4,7
OAK200207030,2002,20703,OAK,MIN,OAK01,2,1,3
OAK200207040,2002,20704,OAK,KCA,OAK01,2,3,5
OAK200207050,2002,20705,OAK,KCA,OAK01,3,4,7
OAK200207060,2002,20706,OAK,KCA,OAK01,4,3,7
OAK200207070,2002,20707,OAK,KCA,OAK01,2,3,5
OAK200207170,2002,20717,OAK,ANA,OAK01,10,4,14
OAK200207180,2002,20718,OAK,ANA,OAK01,0,2,2
OAK200207190,2002,20719,OAK,TEX,OAK01,0,10,10
OAK200207200,2002,20720,OAK,TEX,OAK01,5,6,11
OAK200207210,2002,20721,OAK,TEX,OAK01,7,3,10
OAK200207290,2002,20729,OAK,CLE,OAK01,8,6,14
OAK200207300,2002,20730,OAK,CLE,OAK01,5,4,9
OAK200207310,2002,20731,OAK,CLE,OAK01,4,6,10
OAK200208010,2002,20801,OAK,DET,OAK01,3,5,8
OAK200208020,2002,20802,OAK,DET,OAK01,3,1,4
OAK200208030,2002,20803,OAK,DET,OAK01,4,8,12
OAK200208040,2002,20804,OAK,DET,OAK01,0,4,4
OAK200208120,2002,20812,OAK,TOR,OAK01,2,1,3
OAK200208130,2002,20813,OAK,TOR,OAK01,4,5,9
OAK200208140,2002,20814,OAK,TOR,OAK01,2,4,6
OAK200208160,2002,20816,OAK,CHA,OAK01,0,1,1
OAK200208170,2002,20817,OAK,CHA,OAK01,2,9,11
OAK200208180,2002,20818,OAK,CHA,OAK01,4,7,11
OAK200208300,2002,20830,OAK,MIN,OAK01,2,4,6
OAK200208310,2002,20831,OAK,MIN,OAK01,3,6,9
OAK200209010,2002,20901,OAK,MIN,OAK01,5,7,12
OAK200209020,2002,20902,OAK,KCA,OAK01,6,7,13
OAK200209040,2002,20904,OAK,KCA,OAK01,11,12,23
OAK200209130,2002,20913,OAK,SEA,OAK01,0,5,5
OAK200209140,2002,20914,OAK,SEA,OAK01,0,1,1
OAK200209150,2002,20915,OAK,SEA,OAK01,6,3,9
OAK200209160,2002,20916,OAK,ANA,OAK01,3,4,7
OAK200209170,2002,20917,OAK,ANA,OAK01,1,0,1
OAK200209180,2002,20918,OAK,ANA,OAK01,4,7,11
OAK200209190,2002,20919,OAK,ANA,OAK01,3,5,8
OAK200209200,2002,20920,OAK,TEX,OAK01,2,4,6
OAK200209210,2002,20921,OAK,TEX,OAK01,3,6,9
OAK200209220,2002,20922,OAK,TEX,OAK01,5,7,12
OAK200210010,2002,21001,OAK,MIN,OAK01,7,5,12
OAK200210020,2002,21002,OAK,MIN,OAK01,1,9,10
OAK200210060,2002,21006,OAK,MIN,OAK01,5,4,9
OAK200304010,2003,30401,OAK,SEA,OAK01,0,5,5
OAK200304020,2003,30402,OAK,SEA,OAK01,3,8,11
OAK200304030,2003,30403,OAK,SEA,OAK01,7,6,13
OAK200304040,2003,30404,OAK,ANA,OAK01,3,7,10
OAK200304050,2003,30405,OAK,ANA,OAK01,2,4,6
OAK200304060,2003,30406,OAK,ANA,OAK01,6,7,13
OAK200304180,2003,30418,OAK,TEX,OAK01,0,9,9
OAK200304190,2003,30419,OAK,TEX,OAK01,2,12,14
OAK200304200,2003,30420,OAK,TEX,OAK01,2,1,3
OAK200304220,2003,30422,OAK,DET,OAK01,5,6,11
OAK200304230,2003,30423,OAK,DET,OAK01,4,1,5
OAK200304240,2003,30424,OAK,DET,OAK01,0,2,2
OAK200304250,2003,30425,OAK,CLE,OAK01,2,5,7
OAK200304260,2003,30426,OAK,CLE,OAK01,3,6,9
OAK200304270,2003,30427,OAK,CLE,OAK01,3,4,7
OAK200305060,2003,30506,OAK,CHA,OAK01,0,6,6
OAK200305070,2003,30507,OAK,CHA,OAK01,8,4,12
OAK200305080,2003,30508,OAK,CHA,OAK01,5,8,13
OAK200305090,2003,30509,OAK,NYA,OAK01,2,7,9
OAK200305100,2003,30510,OAK,NYA,OAK01,5,2,7
OAK200305110,2003,30511,OAK,NYA,OAK01,2,5,7
OAK200305200,2003,30520,OAK,MIN,OAK01,1,4,5
OAK200305210,2003,30521,OAK,MIN,OAK01,4,3,7
OAK200305220,2003,30522,OAK,MIN,OAK01,6,5,11
OAK200305230,2003,30523,OAK,KCA,OAK01,1,4,5
OAK200305240,2003,30524,OAK,KCA,OAK01,3,1,4
OAK200305250,2003,30525,OAK,KCA,OAK01,3,4,7
OAK200306100,2003,30610,OAK,ATL,OAK01,3,4,7
OAK200306110,2003,30611,OAK,ATL,OAK01,11,6,17
OAK200306120,2003,30612,OAK,ATL,OAK01,4,2,6
OAK200306130,2003,30613,OAK,MON,OAK01,4,8,12
OAK200306140,2003,30614,OAK,MON,OAK01,4,5,9
OAK200306150,2003,30615,OAK,MON,OAK01,1,9,10
OAK200306170,2003,30617,OAK,TEX,OAK01,3,4,7
OAK200306180,2003,30618,OAK,TEX,OAK01,3,4,7
OAK200306190,2003,30619,OAK,TEX,OAK01,2,9,11
OAK200306200,2003,30620,OAK,SFN,OAK01,3,5,8
OAK200306210,2003,30621,OAK,SFN,OAK01,6,4,10
OAK200306220,2003,30622,OAK,SFN,OAK01,5,6,11
OAK200306300,2003,30630,OAK,SEA,OAK01,3,1,4
OAK200307010,2003,30701,OAK,SEA,OAK01,2,3,5
OAK200307020,2003,30702,OAK,SEA,OAK01,13,0,13
OAK200307030,2003,30703,OAK,SEA,OAK01,2,5,7
OAK200307040,2003,30704,OAK,ANA,OAK01,1,0,1
OAK200307050,2003,30705,OAK,ANA,OAK01,6,3,9
OAK200307060,2003,30706,OAK,ANA,OAK01,5,6,11
OAK200307080,2003,30708,OAK,TBA,OAK01,9,3,12
OAK200307090,2003,30709,OAK,TBA,OAK01,3,6,9
OAK200307100,2003,30710,OAK,TBA,OAK01,2,5,7
OAK200307110,2003,30711,OAK,BAL,OAK01,0,2,2
OAK200307120,2003,30712,OAK,BAL,OAK01,3,5,8
OAK200307130,2003,30713,OAK,BAL,OAK01,0,1,1
OAK200307290,2003,30729,OAK,CLE,OAK01,2,6,8
OAK200307300,2003,30730,OAK,CLE,OAK01,4,2,6
OAK200307310,2003,30731,OAK,CLE,OAK01,1,3,4
OAK200308010,2003,30801,OAK,NYA,OAK01,2,3,5
OAK200308020,2003,30802,OAK,NYA,OAK01,10,7,17
OAK200308030,2003,30803,OAK,NYA,OAK01,1,2,3
OAK200308110,2003,30811,OAK,BOS,OAK01,0,4,4
OAK200308120,2003,30812,OAK,BOS,OAK01,3,5,8
OAK200308130,2003,30813,OAK,BOS,OAK01,7,3,10
OAK200308140,2003,30814,OAK,BOS,OAK01,4,2,6
OAK200308150,2003,30815,OAK,TOR,OAK01,8,5,13
OAK200308160,2003,30816,OAK,TOR,OAK01,4,6,10
OAK200308170,2003,30817,OAK,TOR,OAK01,3,7,10
OAK200308260,2003,30826,OAK,BAL,OAK01,1,2,3
OAK200308270,2003,30827,OAK,BAL,OAK01,2,6,8
OAK200308280,2003,30828,OAK,BAL,OAK01,4,6,10
OAK200308290,2003,30829,OAK,TBA,OAK01,2,5,7
OAK200308300,2003,30830,OAK,TBA,OAK01,2,4,6
OAK200308310,2003,30831,OAK,TBA,OAK01,3,4,7
OAK200309080,2003,30908,OAK,ANA,OAK01,3,1,4
OAK200309090,2003,30909,OAK,ANA,OAK01,1,8,9
OAK200309100,2003,30910,OAK,ANA,OAK01,0,3,3
OAK200309110,2003,30911,OAK,ANA,OAK01,4,14,18
OAK200309190,2003,30919,OAK,SEA,OAK01,6,1,7
OAK200309200,2003,30920,OAK,SEA,OAK01,9,3,12
OAK200309210,2003,30921,OAK,SEA,OAK01,0,12,12
OAK200309220,2003,30922,OAK,TEX,OAK01,3,7,10
OAK200309230,2003,30923,OAK,TEX,OAK01,3,4,7
OAK200309240,2003,30924,OAK,TEX,OAK01,3,5,8
OAK200310010,2003,31001,OAK,BOS,OAK01,4,5,9
OAK200310020,2003,31002,OAK,BOS,OAK01,1,5,6
OAK200310060,2003,31006,OAK,BOS,OAK01,4,3,7
OAK200404050,2004,40405,OAK,TEX,OAK01,4,5,9
OAK200404060,2004,40406,OAK,TEX,OAK01,1,3,4
OAK200404070,2004,40407,OAK,TEX,OAK01,2,1,3
OAK200404090,2004,40409,OAK,SEA,OAK01,6,8,14
OAK200404100,2004,40410,OAK,SEA,OAK01,1,2,3
OAK200404110,2004,40411,OAK,SEA,OAK01,9,4,13
OAK200404230,2004,40423,OAK,ANA,OAK01,12,2,14
OAK200404240,2004,40424,OAK,ANA,OAK01,6,3,9
OAK200404250,2004,40425,OAK,ANA,OAK01,4,3,7
OAK200405040,2004,40504,OAK,NYA,OAK01,10,8,18
OAK200405050,2004,40505,OAK,NYA,OAK01,4,3,7
OAK200405060,2004,40506,OAK,NYA,OAK01,4,7,11
OAK200405070,2004,40507,OAK,MIN,OAK01,9,11,20
OAK200405080,2004,40508,OAK,MIN,OAK01,3,2,5
OAK200405090,2004,40509,OAK,MIN,OAK01,4,8,12
OAK200405180,2004,40518,OAK,DET,OAK01,5,1,6
OAK200405190,2004,40519,OAK,DET,OAK01,2,6,8
OAK200405200,2004,40520,OAK,DET,OAK01,2,3,5
OAK200405210,2004,40521,OAK,KCA,OAK01,0,7,7
OAK200405220,2004,40522,OAK,KCA,OAK01,4,5,9
OAK200405230,2004,40523,OAK,KCA,OAK01,2,3,5
OAK200406010,2004,40601,OAK,CHA,OAK01,4,6,10
OAK200406020,2004,40602,OAK,CHA,OAK01,2,3,5
OAK200406030,2004,40603,OAK,TOR,OAK01,1,2,3
OAK200406040,2004,40604,OAK,TOR,OAK01,6,1,7
OAK200406050,2004,40605,OAK,TOR,OAK01,0,4,4
OAK200406060,2004,40606,OAK,TOR,OAK01,3,8,11
OAK200406070,2004,40607,OAK,CIN,OAK01,2,13,15
OAK200406080,2004,40608,OAK,CIN,OAK01,6,10,16
OAK200406090,2004,40609,OAK,CIN,OAK01,8,17,25
OAK200406110,2004,40611,OAK,PIT,OAK01,1,6,7
OAK200406120,2004,40612,OAK,PIT,OAK01,11,12,23
OAK200406130,2004,40613,OAK,PIT,OAK01,3,13,16
OAK200406250,2004,40625,OAK,SFN,OAK01,6,4,10
OAK200406260,2004,40626,OAK,SFN,OAK01,7,8,15
OAK200406270,2004,40627,OAK,SFN,OAK01,5,2,7
OAK200406290,2004,40629,OAK,ANA,OAK01,4,5,9
OAK200406300,2004,40630,OAK,ANA,OAK01,2,4,6
OAK200407010,2004,40701,OAK,ANA,OAK01,3,7,10
OAK200407150,2004,40715,OAK,CHA,OAK01,2,4,6
OAK200407160,2004,40716,OAK,CHA,OAK01,1,5,6
OAK200407170,2004,40717,OAK,CHA,OAK01,5,2,7
OAK200407180,2004,40718,OAK,CHA,OAK01,3,5,8
OAK200407190,2004,40719,OAK,TOR,OAK01,5,3,8
OAK200407200,2004,40720,OAK,TOR,OAK01,0,1,1
OAK200407230,2004,40723,OAK,TEX,OAK01,8,3,11
OAK200407240,2004,40724,OAK,TEX,OAK01,2,6,8
OAK200407250,2004,40725,OAK,TEX,OAK01,2,9,11
OAK200407260,2004,40726,OAK,SEA,OAK01,5,14,19
OAK200407270,2004,40727,OAK,SEA,OAK01,3,5,8
OAK200407280,2004,40728,OAK,SEA,OAK01,2,3,5
OAK200408100,2004,40810,OAK,DET,OAK01,4,5,9
OAK200408110,2004,40811,OAK,DET,OAK01,11,3,14
OAK200408120,2004,40812,OAK,DET,OAK01,5,3,8
OAK200408130,2004,40813,OAK,KCA,OAK01,10,3,13
OAK200408140,2004,40814,OAK,KCA,OAK01,1,6,7
OAK200408150,2004,40815,OAK,KCA,OAK01,6,1,7
OAK200408230,2004,40823,OAK,BAL,OAK01,3,4,7
OAK200408240,2004,40824,OAK,BAL,OAK01,2,6,8
OAK200408250,2004,40825,OAK,BAL,OAK01,0,3,3
OAK200408260,2004,40826,OAK,BAL,OAK01,4,9,13
OAK200408270,2004,40827,OAK,TBA,OAK01,7,8,15
OAK200408280,2004,40828,OAK,TBA,OAK01,4,5,9
OAK200408290,2004,40829,OAK,TBA,OAK01,6,9,15
OAK200409060,2004,40906,OAK,BOS,OAK01,8,3,11
OAK200409070,2004,40907,OAK,BOS,OAK01,7,1,8
OAK200409080,2004,40908,OAK,BOS,OAK01,8,3,11
OAK200409100,2004,40910,OAK,CLE,OAK01,4,3,7
OAK200409110,2004,40911,OAK,CLE,OAK01,4,5,9
OAK200409120,2004,40912,OAK,CLE,OAK01,0,1,1
OAK200409130,2004,40913,OAK,TEX,OAK01,6,7,13
OAK200409140,2004,40914,OAK,TEX,OAK01,12,9,21
OAK200409150,2004,40915,OAK,TEX,OAK01,10,3,13
OAK200409160,2004,40916,OAK,TEX,OAK01,4,5,9
OAK200409270,2004,40927,OAK,SEA,OAK01,5,6,11
OAK200409280,2004,40928,OAK,SEA,OAK01,7,2,9
OAK200409290,2004,40929,OAK,SEA,OAK01,4,2,6
OAK200409300,2004,40930,OAK,SEA,OAK01,2,3,5
OAK200410010,2004,41001,OAK,ANA,OAK01,10,0,10
OAK200410020,2004,41002,OAK,ANA,OAK01,5,4,9
OAK200410030,2004,41003,OAK,ANA,OAK01,2,3,5
OAK200504110,2005,50411,OAK,TOR,OAK01,10,3,13
OAK200504120,2005,50412,OAK,TOR,OAK01,5,2,7
OAK200504130,2005,50413,OAK,TOR,OAK01,3,6,9
OAK200504150,2005,50415,OAK,ANA,OAK01,6,1,7
OAK200504160,2005,50416,OAK,ANA,OAK01,0,1,1
OAK200504170,2005,50417,OAK,ANA,OAK01,6,7,13
OAK200504250,2005,50425,OAK,CHA,OAK01,6,0,6
OAK200504260,2005,50426,OAK,CHA,OAK01,7,9,16
OAK200504270,2005,50427,OAK,CHA,OAK01,1,2,3
OAK200504290,2005,50429,OAK,SEA,OAK01,4,2,6
OAK200504300,2005,50430,OAK,SEA,OAK01,5,6,11
OAK200505010,2005,50501,OAK,SEA,OAK01,2,3,5
OAK200505020,2005,50502,OAK,TEX,OAK01,3,2,5
OAK200505030,2005,50503,OAK,TEX,OAK01,6,1,7
OAK200505040,2005,50504,OAK,TEX,OAK01,16,7,23
OAK200505130,2005,50513,OAK,NYA,OAK01,9,4,13
OAK200505140,2005,50514,OAK,NYA,OAK01,15,6,21
OAK200505150,2005,50515,OAK,NYA,OAK01,6,4,10
OAK200505160,2005,50516,OAK,BOS,OAK01,4,6,10
OAK200505170,2005,50517,OAK,BOS,OAK01,7,5,12
OAK200505180,2005,50518,OAK,BOS,OAK01,6,13,19
OAK200505300,2005,50530,OAK,TBA,OAK01,4,5,9
OAK200505310,2005,50531,OAK,TBA,OAK01,1,10,11
OAK200506010,2005,50601,OAK,TBA,OAK01,2,11,13
OAK200506020,2005,50602,OAK,TOR,OAK01,3,5,8
OAK200506030,2005,50603,OAK,TOR,OAK01,6,2,8
OAK200506040,2005,50604,OAK,TOR,OAK01,2,5,7
OAK200506050,2005,50605,OAK,TOR,OAK01,4,12,16
OAK200506140,2005,50614,OAK,NYN,OAK01,0,5,5
OAK200506150,2005,50615,OAK,NYN,OAK01,2,3,5
OAK200506160,2005,50616,OAK,NYN,OAK01,9,6,15
OAK200506170,2005,50617,OAK,PHI,OAK01,6,1,7
OAK200506180,2005,50618,OAK,PHI,OAK01,1,2,3
OAK200506190,2005,50619,OAK,PHI,OAK01,2,5,7
OAK200506240,2005,50624,OAK,SFN,OAK01,3,4,7
OAK200506250,2005,50625,OAK,SFN,OAK01,3,6,9
OAK200506260,2005,50626,OAK,SFN,OAK01,0,16,16
OAK200506280,2005,50628,OAK,SEA,OAK01,1,8,9
OAK200506290,2005,50629,OAK,SEA,OAK01,2,6,8
OAK200506300,2005,50630,OAK,SEA,OAK01,2,6,8
OAK200507010,2005,50701,OAK,CHA,OAK01,2,6,8
OAK200507020,2005,50702,OAK,CHA,OAK01,5,3,8
OAK200507030,2005,50703,OAK,CHA,OAK01,2,7,9
OAK200507140,2005,50714,OAK,TEX,OAK01,0,6,6
OAK200507150,2005,50715,OAK,TEX,OAK01,2,7,9
OAK200507160,2005,50716,OAK,TEX,OAK01,10,8,18
OAK200507170,2005,50717,OAK,TEX,OAK01,4,5,9
OAK200507250,2005,50725,OAK,CLE,OAK01,4,13,17
OAK200507260,2005,50726,OAK,CLE,OAK01,2,0,2
OAK200507270,2005,50727,OAK,CLE,OAK01,4,5,9
OAK200507290,2005,50729,OAK,DET,OAK01,4,8,12
OAK200507300,2005,50730,OAK,DET,OAK01,5,9,14
OAK200507310,2005,50731,OAK,DET,OAK01,2,5,7
OAK200508090,2005,50809,OAK,ANA,OAK01,9,2,11
OAK200508100,2005,50810,OAK,ANA,OAK01,3,4,7
OAK200508110,2005,50811,OAK,ANA,OAK01,4,5,9
OAK200508120,2005,50812,OAK,MIN,OAK01,1,0,1
OAK200508130,2005,50813,OAK,MIN,OAK01,2,5,7
OAK200508140,2005,50814,OAK,MIN,OAK01,2,1,3
OAK200508150,2005,50815,OAK,BAL,OAK01,6,2,8
OAK200508160,2005,50816,OAK,BAL,OAK01,4,3,7
OAK200508170,2005,50817,OAK,BAL,OAK01,5,3,8
OAK200508190,2005,50819,OAK,KCA,OAK01,0,4,4
OAK200508200,2005,50820,OAK,KCA,OAK01,2,1,3
OAK200508210,2005,50821,OAK,KCA,OAK01,5,4,9
OAK200509020,2005,50902,OAK,NYA,OAK01,0,12,12
OAK200509030,2005,50903,OAK,NYA,OAK01,7,0,7
OAK200509040,2005,50904,OAK,NYA,OAK01,7,3,10
OAK200509050,2005,50905,OAK,SEA,OAK01,2,0,2
OAK200509060,2005,50906,OAK,SEA,OAK01,3,2,5
OAK200509070,2005,50907,OAK,SEA,OAK01,7,8,15
OAK200509190,2005,50919,OAK,MIN,OAK01,6,7,13
OAK200509200,2005,50920,OAK,MIN,OAK01,3,8,11
OAK200509210,2005,50921,OAK,MIN,OAK01,10,4,14
OAK200509230,2005,50923,OAK,TEX,OAK01,3,1,4
OAK200509240,2005,50924,OAK,TEX,OAK01,6,7,13
OAK200509250,2005,50925,OAK,TEX,OAK01,6,2,8
OAK200509260,2005,50926,OAK,ANA,OAK01,4,3,7
OAK200509270,2005,50927,OAK,ANA,OAK01,4,3,7
OAK200509280,2005,50928,OAK,ANA,OAK01,1,6,7
OAK200509290,2005,50929,OAK,ANA,OAK01,7,1,8
OAK200604030,2006,60403,OAK,NYA,OAK01,15,2,17
OAK200604040,2006,60404,OAK,NYA,OAK01,3,4,7
OAK200604050,2006,60405,OAK,NYA,OAK01,4,9,13
OAK200604140,2006,60414,OAK,TEX,OAK01,6,3,9
OAK200604150,2006,60415,OAK,TEX,OAK01,4,5,9
OAK200604160,2006,60416,OAK,TEX,OAK01,5,3,8
OAK200604180,2006,60418,OAK,DET,OAK01,3,4,7
OAK200604190,2006,60419,OAK,DET,OAK01,11,4,15
OAK200604200,2006,60420,OAK,DET,OAK01,4,3,7
OAK200604210,2006,60421,OAK,ANA,OAK01,3,5,8
OAK200604220,2006,60422,OAK,ANA,OAK01,5,4,9
OAK200604230,2006,60423,OAK,ANA,OAK01,4,3,7
OAK200605030,2006,60503,OAK,CLE,OAK01,14,3,17
OAK200605040,2006,60504,OAK,CLE,OAK01,4,12,16
OAK200605050,2006,60505,OAK,TBA,OAK01,3,1,4
OAK200605060,2006,60506,OAK,TBA,OAK01,2,3,5
OAK200605070,2006,60507,OAK,TBA,OAK01,3,2,5
OAK200605160,2006,60516,OAK,SEA,OAK01,6,12,18
OAK200605170,2006,60517,OAK,SEA,OAK01,2,7,9
OAK200605180,2006,60518,OAK,SEA,OAK01,3,6,9
OAK200605190,2006,60519,OAK,SFN,OAK01,0,1,1
OAK200605200,2006,60520,OAK,SFN,OAK01,4,2,6
OAK200605210,2006,60521,OAK,SFN,OAK01,6,0,6
OAK200605290,2006,60529,OAK,KCA,OAK01,6,4,10
OAK200605300,2006,60530,OAK,KCA,OAK01,8,7,15
OAK200605310,2006,60531,OAK,KCA,OAK01,0,7,7
OAK200606010,2006,60601,OAK,MIN,OAK01,0,4,4
OAK200606020,2006,60602,OAK,MIN,OAK01,2,1,3
OAK200606030,2006,60603,OAK,MIN,OAK01,1,2,3
OAK200606040,2006,60604,OAK,MIN,OAK01,1,5,6
OAK200606130,2006,60613,OAK,SEA,OAK01,0,2,2
OAK200606140,2006,60614,OAK,SEA,OAK01,2,7,9
OAK200606150,2006,60615,OAK,SEA,OAK01,6,9,15
OAK200606160,2006,60616,OAK,LAN,OAK01,3,7,10
OAK200606170,2006,60617,OAK,LAN,OAK01,4,5,9
OAK200606180,2006,60618,OAK,LAN,OAK01,2,5,7
OAK200606300,2006,60630,OAK,ARI,OAK01,6,4,10
OAK200607010,2006,60701,OAK,ARI,OAK01,7,2,9
OAK200607020,2006,60702,OAK,ARI,OAK01,3,1,4
OAK200607030,2006,60703,OAK,DET,OAK01,3,5,8
OAK200607040,2006,60704,OAK,DET,OAK01,1,2,3
OAK200607050,2006,60705,OAK,DET,OAK01,10,4,14
OAK200607060,2006,60706,OAK,ANA,OAK01,5,7,12
OAK200607070,2006,60707,OAK,ANA,OAK01,3,0,3
OAK200607080,2006,60708,OAK,ANA,OAK01,6,4,10
OAK200607090,2006,60709,OAK,ANA,OAK01,4,2,6
OAK200607240,2006,60724,OAK,BOS,OAK01,7,3,10
OAK200607250,2006,60725,OAK,BOS,OAK01,13,5,18
OAK200607260,2006,60726,OAK,BOS,OAK01,1,5,6
OAK200607270,2006,60727,OAK,TOR,OAK01,2,5,7
OAK200607280,2006,60728,OAK,TOR,OAK01,4,3,7
OAK200607290,2006,60729,OAK,TOR,OAK01,4,7,11
OAK200607300,2006,60730,OAK,TOR,OAK01,5,6,11
OAK200608070,2006,60807,OAK,TEX,OAK01,4,7,11
OAK200608080,2006,60808,OAK,TEX,OAK01,6,7,13
OAK200608090,2006,60809,OAK,TEX,OAK01,14,0,14
OAK200608110,2006,60811,OAK,TBA,OAK01,2,5,7
OAK200608120,2006,60812,OAK,TBA,OAK01,3,6,9
OAK200608130,2006,60813,OAK,TBA,OAK01,1,3,4
OAK200608140,2006,60814,OAK,SEA,OAK01,4,5,9
OAK200608150,2006,60815,OAK,SEA,OAK01,2,11,13
OAK200608160,2006,60816,OAK,SEA,OAK01,0,4,4
OAK200608280,2006,60828,OAK,BOS,OAK01,0,9,9
OAK200608290,2006,60829,OAK,BOS,OAK01,1,2,3
OAK200608300,2006,60830,OAK,BOS,OAK01,2,7,9
OAK200609010,2006,60901,OAK,BAL,OAK01,4,5,9
OAK200609020,2006,60902,OAK,BAL,OAK01,6,5,11
OAK200609030,2006,60903,OAK,BAL,OAK01,1,10,11
OAK200609040,2006,60904,OAK,TEX,OAK01,8,1,9
OAK200609050,2006,60905,OAK,TEX,OAK01,5,4,9
OAK200609060,2006,60906,OAK,TEX,OAK01,6,9,15
OAK200609150,2006,60915,OAK,CHA,OAK01,2,4,6
OAK200609160,2006,60916,OAK,CHA,OAK01,4,7,11
OAK200609170,2006,60917,OAK,CHA,OAK01,4,5,9
OAK200609180,2006,60918,OAK,CLE,OAK01,7,2,9
OAK200609190,2006,60919,OAK,CLE,OAK01,3,7,10
OAK200609200,2006,60920,OAK,CLE,OAK01,3,4,7
OAK200609210,2006,60921,OAK,CLE,OAK01,4,7,11
OAK200609220,2006,60922,OAK,ANA,OAK01,4,5,9
OAK200609230,2006,60923,OAK,ANA,OAK01,6,2,8
OAK200609240,2006,60924,OAK,ANA,OAK01,7,1,8
OAK200610060,2006,61006,OAK,MIN,OAK01,3,8,11
OAK200610100,2006,61010,OAK,DET,OAK01,5,1,6
OAK200610110,2006,61011,OAK,DET,OAK01,8,5,13
OAK200704090,2007,70409,OAK,CHA,OAK01,4,1,5
OAK200704100,2007,70410,OAK,CHA,OAK01,1,2,3
OAK200704110,2007,70411,OAK,CHA,OAK01,6,3,9
OAK200704130,2007,70413,OAK,NYA,OAK01,4,5,9
OAK200704140,2007,70414,OAK,NYA,OAK01,4,3,7
OAK200704150,2007,70415,OAK,NYA,OAK01,4,5,9
OAK200704170,2007,70417,OAK,ANA,OAK01,1,4,5
OAK200704180,2007,70418,OAK,ANA,OAK01,0,3,3
OAK200704250,2007,70425,OAK,SEA,OAK01,2,0,2
OAK200704260,2007,70426,OAK,SEA,OAK01,4,2,6
OAK200704270,2007,70427,OAK,TBA,OAK01,4,1,5
OAK200704280,2007,70428,OAK,TBA,OAK01,5,12,17
OAK200704290,2007,70429,OAK,TBA,OAK01,5,3,8
OAK200705110,2007,70511,OAK,CLE,OAK01,2,8,10
OAK200705120,2007,70512,OAK,CLE,OAK01,6,3,9
OAK200705130,2007,70513,OAK,CLE,OAK01,7,10,17
OAK200705140,2007,70514,OAK,KCA,OAK01,2,1,3
OAK200705150,2007,70515,OAK,KCA,OAK01,4,5,9
OAK200705160,2007,70516,OAK,KCA,OAK01,4,3,7
OAK200705170,2007,70517,OAK,KCA,OAK01,7,4,11
OAK200705180,2007,70518,OAK,SFN,OAK01,3,15,18
OAK200705190,2007,70519,OAK,SFN,OAK01,2,4,6
OAK200705200,2007,70520,OAK,SFN,OAK01,4,1,5
OAK200705280,2007,70528,OAK,TEX,OAK01,3,5,8
OAK200705290,2007,70529,OAK,TEX,OAK01,4,0,4
OAK200705300,2007,70530,OAK,TEX,OAK01,1,6,7
OAK200706010,2007,70601,OAK,MIN,OAK01,3,2,5
OAK200706020,2007,70602,OAK,MIN,OAK01,0,1,1
OAK200706030,2007,70603,OAK,MIN,OAK01,2,4,6
OAK200706040,2007,70604,OAK,BOS,OAK01,4,5,9
OAK200706050,2007,70605,OAK,BOS,OAK01,0,2,2
OAK200706060,2007,70606,OAK,BOS,OAK01,2,3,5
OAK200706070,2007,70607,OAK,BOS,OAK01,1,0,1
OAK200706150,2007,70615,OAK,SLN,OAK01,3,14,17
OAK200706160,2007,70616,OAK,SLN,OAK01,15,6,21
OAK200706170,2007,70617,OAK,SLN,OAK01,10,6,16
OAK200706180,2007,70618,OAK,CIN,OAK01,1,6,7
OAK200706190,2007,70619,OAK,CIN,OAK01,5,2,7
OAK200706200,2007,70620,OAK,CIN,OAK01,3,5,8
OAK200707020,2007,70702,OAK,TOR,OAK01,11,7,18
OAK200707030,2007,70703,OAK,TOR,OAK01,1,3,4
OAK200707040,2007,70704,OAK,TOR,OAK01,10,3,13
OAK200707050,2007,70705,OAK,SEA,OAK01,2,3,5
OAK200707060,2007,70706,OAK,SEA,OAK01,7,1,8
OAK200707070,2007,70707,OAK,SEA,OAK01,4,0,4
OAK200707080,2007,70708,OAK,SEA,OAK01,7,3,10
OAK200707160,2007,70716,OAK,TEX,OAK01,4,1,5
OAK200707170,2007,70717,OAK,TEX,OAK01,11,4,15
OAK200707180,2007,70718,OAK,TEX,OAK01,0,6,6
OAK200707200,2007,70720,OAK,BAL,OAK01,6,1,7
OAK200707210,2007,70721,OAK,BAL,OAK01,3,4,7
OAK200707220,2007,70722,OAK,BAL,OAK01,2,0,2
OAK200707300,2007,70730,OAK,DET,OAK01,5,2,7
OAK200707310,2007,70731,OAK,DET,OAK01,3,7,10
OAK200708010,2007,70801,OAK,DET,OAK01,2,3,5
OAK200708020,2007,70802,OAK,ANA,OAK01,6,4,10
OAK200708030,2007,70803,OAK,ANA,OAK01,4,8,12
OAK200708040,2007,70804,OAK,ANA,OAK01,1,2,3
OAK200708050,2007,70805,OAK,ANA,OAK01,4,3,7
OAK200708140,2007,70814,OAK,CHA,OAK01,3,4,7
OAK200708150,2007,70815,OAK,CHA,OAK01,2,3,5
OAK200708160,2007,70816,OAK,CHA,OAK01,5,8,13
OAK200708170,2007,70817,OAK,KCA,OAK01,9,2,11
OAK200708180,2007,70818,OAK,KCA,OAK01,7,3,10
OAK200708190,2007,70819,OAK,KCA,OAK01,1,6,7
OAK200708270,2007,70827,OAK,TOR,OAK01,6,2,8
OAK200708280,2007,70828,OAK,TOR,OAK01,5,4,9
OAK200708290,2007,70829,OAK,TOR,OAK01,4,5,9
OAK200708310,2007,70831,OAK,DET,OAK01,4,5,9
OAK200709010,2007,70901,OAK,DET,OAK01,6,1,7
OAK200709020,2007,70902,OAK,DET,OAK01,7,8,15
OAK200709130,2007,70913,OAK,TEX,OAK01,5,6,11
OAK200709140,2007,70914,OAK,TEX,OAK01,9,11,20
OAK200709150,2007,70915,OAK,TEX,OAK01,3,7,10
OAK200709160,2007,70916,OAK,TEX,OAK01,11,9,20
OAK200709170,2007,70917,OAK,SEA,OAK01,4,0,4
OAK200709180,2007,70918,OAK,SEA,OAK01,8,7,15
OAK200709190,2007,70919,OAK,SEA,OAK01,9,5,14
OAK200709280,2007,70928,OAK,ANA,OAK01,2,0,2
OAK200709290,2007,70929,OAK,ANA,OAK01,3,2,5
OAK200709300,2007,70930,OAK,ANA,OAK01,2,3,5
OAK200803250,2008,80325,OAK,BOS,TOK01,6,5,11
OAK200803260,2008,80326,OAK,BOS,TOK01,1,5,6
OAK200804010,2008,80401,OAK,BOS,OAK01,2,1,3
OAK200804020,2008,80402,OAK,BOS,OAK01,5,0,5
OAK200804040,2008,80404,OAK,CLE,OAK01,3,6,9
OAK200804050,2008,80405,OAK,CLE,OAK01,1,6,7
OAK200804060,2008,80406,OAK,CLE,OAK01,2,1,3
OAK200804160,2008,80416,OAK,SEA,OAK01,4,2,6
OAK200804170,2008,80417,OAK,SEA,OAK01,8,1,9
OAK200804180,2008,80418,OAK,KCA,OAK01,2,13,15
OAK200804190,2008,80419,OAK,KCA,OAK01,5,6,11
OAK200804200,2008,80420,OAK,KCA,OAK01,1,7,8
OAK200804220,2008,80422,OAK,MIN,OAK01,5,4,9
OAK200804230,2008,80423,OAK,MIN,OAK01,0,3,3
OAK200804240,2008,80424,OAK,MIN,OAK01,2,11,13
OAK200805020,2008,80502,OAK,TEX,OAK01,4,3,7
OAK200805030,2008,80503,OAK,TEX,OAK01,6,3,9
OAK200805040,2008,80504,OAK,TEX,OAK01,1,3,4
OAK200805050,2008,80505,OAK,BAL,OAK01,1,2,3
OAK200805060,2008,80506,OAK,BAL,OAK01,2,4,6
OAK200805070,2008,80507,OAK,BAL,OAK01,5,6,11
OAK200805190,2008,80519,OAK,TBA,OAK01,7,6,13
OAK200805200,2008,80520,OAK,TBA,OAK01,3,2,5
OAK200805210,2008,80521,OAK,TBA,OAK01,1,9,10
OAK200805230,2008,80523,OAK,BOS,OAK01,3,8,11
OAK200805240,2008,80524,OAK,BOS,OAK01,0,3,3
OAK200805250,2008,80525,OAK,BOS,OAK01,3,6,9
OAK200805270,2008,80527,OAK,TOR,OAK01,1,3,4
OAK200805280,2008,80528,OAK,TOR,OAK01,2,1,3
OAK200805290,2008,80529,OAK,TOR,OAK01,12,0,12
OAK200806020,2008,80602,OAK,DET,OAK01,2,3,5
OAK200806030,2008,80603,OAK,DET,OAK01,4,5,9
OAK200806040,2008,80604,OAK,DET,OAK01,2,10,12
OAK200806060,2008,80606,OAK,ANA,OAK01,3,1,4
OAK200806070,2008,80607,OAK,ANA,OAK01,5,3,8
OAK200806080,2008,80608,OAK,ANA,OAK01,3,7,10
OAK200806100,2008,80610,OAK,NYA,OAK01,3,1,4
OAK200806110,2008,80611,OAK,NYA,OAK01,4,8,12
OAK200806120,2008,80612,OAK,NYA,OAK01,4,1,5
OAK200806200,2008,80620,OAK,FLO,OAK01,6,7,13
OAK200806210,2008,80621,OAK,FLO,OAK01,6,4,10
OAK200806220,2008,80622,OAK,FLO,OAK01,1,7,8
OAK200806240,2008,80624,OAK,PHI,OAK01,2,5,7
OAK200806250,2008,80625,OAK,PHI,OAK01,4,0,4
OAK200806260,2008,80626,OAK,PHI,OAK01,0,5,5
OAK200806270,2008,80627,OAK,SFN,OAK01,1,4,5
OAK200806280,2008,80628,OAK,SFN,OAK01,1,0,1
OAK200806290,2008,80629,OAK,SFN,OAK01,11,1,12
OAK200807070,2008,80707,OAK,SEA,OAK01,3,4,7
OAK200807080,2008,80708,OAK,SEA,OAK01,0,2,2
OAK200807090,2008,80709,OAK,SEA,OAK01,6,4,10
OAK200807100,2008,80710,OAK,SEA,OAK01,2,3,5
OAK200807110,2008,80711,OAK,ANA,OAK01,2,9,11
OAK200807120,2008,80712,OAK,ANA,OAK01,4,1,5
OAK200807130,2008,80713,OAK,ANA,OAK01,4,3,7
OAK200807250,2008,80725,OAK,TEX,OAK01,14,6,20
OAK200807260,2008,80726,OAK,TEX,OAK01,9,4,13
OAK200807270,2008,80727,OAK,TEX,OAK01,5,6,11
OAK200807280,2008,80728,OAK,KCA,OAK01,4,2,6
OAK200807290,2008,80729,OAK,KCA,OAK01,5,2,7
OAK200807300,2008,80730,OAK,KCA,OAK01,4,3,7
OAK200808120,2008,80812,OAK,TBA,OAK01,1,2,3
OAK200808130,2008,80813,OAK,TBA,OAK01,3,2,5
OAK200808140,2008,80814,OAK,TBA,OAK01,7,6,13
OAK200808150,2008,80815,OAK,CHA,OAK01,4,6,10
OAK200808160,2008,80816,OAK,CHA,OAK01,2,1,3
OAK200808170,2008,80817,OAK,CHA,OAK01,13,1,14
OAK200808280,2008,80828,OAK,MIN,OAK01,2,3,5
OAK200808290,2008,80829,OAK,MIN,OAK01,12,2,14
OAK200808300,2008,80830,OAK,MIN,OAK01,2,3,5
OAK200808310,2008,80831,OAK,MIN,OAK01,12,4,16
OAK200809110,2008,80911,OAK,TEX,OAK01,6,1,7
OAK200809120,2008,80912,OAK,TEX,OAK01,7,0,7
OAK200809130,2008,80913,OAK,TEX,OAK01,1,7,8
OAK200809140,2008,80914,OAK,TEX,OAK01,4,7,11
OAK200809160,2008,80916,OAK,ANA,OAK01,1,8,9
OAK200809170,2008,80917,OAK,ANA,OAK01,2,3,5
OAK200809180,2008,80918,OAK,ANA,OAK01,6,4,10
OAK200809190,2008,80919,OAK,SEA,OAK01,0,2,2
OAK200809200,2008,80920,OAK,SEA,OAK01,7,8,15
OAK200809210,2008,80921,OAK,SEA,OAK01,3,5,8
OAK200904100,2009,90410,OAK,SEA,OAK01,5,4,9
OAK200904110,2009,90411,OAK,SEA,OAK01,8,5,13
OAK200904120,2009,90412,OAK,SEA,OAK01,1,0,1
OAK200904130,2009,90413,OAK,BOS,OAK01,2,8,10
OAK200904140,2009,90414,OAK,BOS,OAK01,5,6,11
OAK200904150,2009,90415,OAK,BOS,OAK01,8,2,10
OAK200904240,2009,90424,OAK,TBA,OAK01,8,2,10
OAK200904250,2009,90425,OAK,TBA,OAK01,2,5,7
OAK200904260,2009,90426,OAK,TBA,OAK01,1,7,8
OAK200905040,2009,90504,OAK,ANA,OAK01,5,2,7
OAK200905050,2009,90505,OAK,ANA,OAK01,5,3,8
OAK200905060,2009,90506,OAK,TEX,OAK01,3,2,5
OAK200905070,2009,90507,OAK,TEX,OAK01,4,9,13
OAK200905080,2009,90508,OAK,TOR,OAK01,3,5,8
OAK200905090,2009,90509,OAK,TOR,OAK01,6,4,10
OAK200905100,2009,90510,OAK,TOR,OAK01,5,0,5
OAK200905120,2009,90512,OAK,KCA,OAK01,3,12,15
OAK200905130,2009,90513,OAK,KCA,OAK01,2,7,9
OAK200905220,2009,90522,OAK,ARI,OAK01,2,1,3
OAK200905230,2009,90523,OAK,ARI,OAK01,8,7,15
OAK200905240,2009,90524,OAK,ARI,OAK01,2,6,8
OAK200905250,2009,90525,OAK,SEA,OAK01,1,6,7
OAK200905260,2009,90526,OAK,SEA,OAK01,3,4,7
OAK200905270,2009,90527,OAK,SEA,OAK01,6,1,7
OAK200906050,2009,90605,OAK,BAL,OAK01,1,9,10
OAK200906060,2009,90606,OAK,BAL,OAK01,4,9,13
OAK200906070,2009,90607,OAK,BAL,OAK01,0,3,3
OAK200906080,2009,90608,OAK,MIN,OAK01,3,4,7
OAK200906090,2009,90609,OAK,MIN,OAK01,10,5,15
OAK200906100,2009,90610,OAK,MIN,OAK01,6,3,9
OAK200906110,2009,90611,OAK,MIN,OAK01,3,4,7
OAK200906220,2009,90622,OAK,SFN,OAK01,1,5,6
OAK200906230,2009,90623,OAK,SFN,OAK01,4,1,5
OAK200906240,2009,90624,OAK,SFN,OAK01,6,3,9
OAK200906260,2009,90626,OAK,COL,OAK01,4,2,6
OAK200906270,2009,90627,OAK,COL,OAK01,11,9,20
OAK200906280,2009,90628,OAK,COL,OAK01,3,1,4
OAK200906290,2009,90629,OAK,DET,OAK01,1,7,8
OAK200906300,2009,90630,OAK,DET,OAK01,5,3,8
OAK200907010,2009,90701,OAK,DET,OAK01,1,5,6
OAK200907160,2009,90716,OAK,ANA,OAK01,6,2,8
OAK200907170,2009,90717,OAK,ANA,OAK01,3,7,10
OAK200907180,2009,90718,OAK,ANA,OAK01,11,6,17
OAK200907190,2009,90719,OAK,ANA,OAK01,1,0,1
OAK200907200,2009,90720,OAK,MIN,OAK01,13,14,27
OAK200907210,2009,90721,OAK,MIN,OAK01,3,2,5
OAK200907220,2009,90722,OAK,MIN,OAK01,1,16,17
OAK200907310,2009,90731,OAK,TOR,OAK01,5,8,13
OAK200908010,2009,90801,OAK,TOR,OAK01,6,5,11
OAK200908020,2009,90802,OAK,TOR,OAK01,7,2,9
OAK200908030,2009,90803,OAK,TEX,OAK01,2,3,5
OAK200908040,2009,90804,OAK,TEX,OAK01,0,6,6
OAK200908050,2009,90805,OAK,TEX,OAK01,5,7,12
OAK200908060,2009,90806,OAK,TEX,OAK01,6,4,10
OAK200908140,2009,90814,OAK,CHA,OAK01,8,7,15
OAK200908150,2009,90815,OAK,CHA,OAK01,8,1,9
OAK200908160,2009,90816,OAK,CHA,OAK01,2,3,5
OAK200908170,2009,90817,OAK,NYA,OAK01,0,3,3
OAK200908180,2009,90818,OAK,NYA,OAK01,7,2,9
OAK200908190,2009,90819,OAK,NYA,OAK01,3,2,5
OAK200908210,2009,90821,OAK,DET,OAK01,3,2,5
OAK200908220,2009,90822,OAK,DET,OAK01,2,3,5
OAK200908230,2009,90823,OAK,DET,OAK01,4,9,13
OAK200908310,2009,90831,OAK,KCA,OAK01,5,8,13
OAK200909010,2009,90901,OAK,KCA,OAK01,4,3,7
OAK200909020,2009,90902,OAK,KCA,OAK01,4,10,14
OAK200909030,2009,90903,OAK,SEA,OAK01,7,4,11
OAK200909040,2009,90904,OAK,SEA,OAK01,6,3,9
OAK200909050,2009,90905,OAK,SEA,OAK01,5,9,14
OAK200909060,2009,90906,OAK,SEA,OAK01,2,5,7
OAK200909170,2009,90917,OAK,CLE,OAK01,2,5,7
OAK200909180,2009,90918,OAK,CLE,OAK01,1,2,3
OAK200909190,2009,90919,OAK,CLE,OAK01,4,8,12
OAK200909200,2009,90920,OAK,CLE,OAK01,4,11,15
OAK200909210,2009,90921,OAK,TEX,OAK01,10,3,13
OAK200909220,2009,90922,OAK,TEX,OAK01,1,9,10
OAK200909230,2009,90923,OAK,TEX,OAK01,9,8,17
OAK200909240,2009,90924,OAK,TEX,OAK01,3,12,15
OAK200910020,2009,91002,OAK,ANA,OAK01,5,2,7
OAK200910030,2009,91003,OAK,ANA,OAK01,4,2,6
OAK200910040,2009,91004,OAK,ANA,OAK01,5,3,8
PHI200004100,2000,410,PHI,NYN,PHI12,7,9,16
PHI200004120,2000,412,PHI,NYN,PHI12,5,8,13
PHI200004130,2000,413,PHI,NYN,PHI12,2,1,3
PHI200004140,2000,414,PHI,MON,PHI12,4,0,4
PHI200004160,2000,416,PHI,MON,PHI12,4,5,9
PHI200004250,2000,425,PHI,ARI,PHI12,10,2,12
PHI200004260,2000,426,PHI,ARI,PHI12,10,4,14
PHI200004270,2000,427,PHI,ARI,PHI12,4,5,9
PHI200004280,2000,428,PHI,SLN,PHI12,7,4,11
PHI200004290,2000,429,PHI,SLN,PHI12,7,6,13
PHI200004300,2000,430,PHI,SLN,PHI12,4,3,7
PHI200005020,2000,502,PHI,CIN,PHI12,7,0,7
PHI200005030,2000,503,PHI,CIN,PHI12,2,5,7
PHI200005040,2000,504,PHI,CIN,PHI12,1,14,15
PHI200005120,2000,512,PHI,ATL,PHI12,8,7,15
PHI200005130,2000,513,PHI,ATL,PHI12,3,2,5
PHI200005140,2000,514,PHI,ATL,PHI12,11,2,13
PHI200005160,2000,516,PHI,SLN,PHI12,8,2,10
PHI200005170,2000,517,PHI,SLN,PHI12,4,5,9
PHI200005180,2000,518,PHI,SLN,PHI12,7,2,9
PHI200005190,2000,519,PHI,COL,PHI12,10,2,12
PHI200005200,2000,520,PHI,COL,PHI12,4,3,7
PHI200005210,2000,521,PHI,COL,PHI12,3,4,7
PHI200006020,2000,602,PHI,BOS,PHI12,1,2,3
PHI200006030,2000,603,PHI,BOS,PHI12,3,9,12
PHI200006040,2000,604,PHI,BOS,PHI12,5,6,11
PHI200006050,2000,605,PHI,TBA,PHI12,5,3,8
PHI200006060,2000,606,PHI,TBA,PHI12,5,3,8
PHI200006070,2000,607,PHI,TBA,PHI12,4,5,9
PHI200006120,2000,612,PHI,FLO,PHI12,5,2,7
PHI200006130,2000,613,PHI,FLO,PHI12,3,4,7
PHI200006140,2000,614,PHI,FLO,PHI12,8,1,9
PHI200006160,2000,616,PHI,ATL,PHI12,1,2,3
PHI200006170,2000,617,PHI,ATL,PHI12,3,9,12
PHI200006180,2000,618,PHI,ATL,PHI12,5,3,8
PHI200006190,2000,619,PHI,ATL,PHI12,2,5,7
PHI200006270,2000,627,PHI,MIL,PHI12,0,7,7
PHI200006280,2000,628,PHI,MIL,PHI12,7,9,16
PHI200006290,2000,629,PHI,MIL,PHI12,8,6,14
PHI200006300,2000,630,PHI,PIT,PHI12,8,3,11
PHI200007010,2000,701,PHI,PIT,PHI12,3,4,7
PHI200007020,2000,702,PHI,PIT,PHI12,1,9,10
PHI200007070,2000,707,PHI,BAL,PHI12,2,1,3
PHI200007080,2000,708,PHI,BAL,PHI12,4,13,17
PHI200007090,2000,709,PHI,BAL,PHI12,5,4,9
PHI200007250,2000,725,PHI,CHN,PHI12,8,7,15
PHI200007260,2000,726,PHI,CHN,PHI12,14,9,23
PHI200007270,2000,727,PHI,CHN,PHI12,4,1,5
PHI200007280,2000,728,PHI,LAN,PHI12,2,0,2
PHI200007290,2000,729,PHI,LAN,PHI12,0,3,3
PHI200007300,2000,730,PHI,LAN,PHI12,2,3,5
PHI200008070,2000,807,PHI,SDN,PHI12,6,4,10
PHI200008080,2000,808,PHI,SDN,PHI12,4,10,14
PHI200008090,2000,809,PHI,SDN,PHI12,2,3,5
PHI200008100,2000,810,PHI,SDN,PHI12,15,3,18
PHI200008110,2000,811,PHI,HOU,PHI12,7,2,9
PHI200008120,2000,812,PHI,HOU,PHI12,2,3,5
PHI200008130,2000,813,PHI,HOU,PHI12,14,7,21
PHI200008140,2000,814,PHI,ARI,PHI12,4,3,7
PHI200008150,2000,815,PHI,ARI,PHI12,11,6,17
PHI200008160,2000,816,PHI,ARI,PHI12,5,1,6
PHI200008250,2000,825,PHI,SFN,PHI12,16,3,19
PHI200008260,2000,826,PHI,SFN,PHI12,2,5,7
PHI200008270,2000,827,PHI,SFN,PHI12,1,2,3
PHI200008280,2000,828,PHI,COL,PHI12,2,3,5
PHI200008290,2000,829,PHI,COL,PHI12,2,1,3
PHI200008300,2000,830,PHI,COL,PHI12,5,4,9
PHI200009111,2000,911,PHI,MON,PHI12,2,5,7
PHI200009112,2000,911,PHI,MON,PHI12,7,6,13
PHI200009120,2000,912,PHI,MON,PHI12,1,0,1
PHI200009130,2000,913,PHI,MON,PHI12,5,15,20
PHI200009150,2000,915,PHI,FLO,PHI12,4,7,11
PHI200009160,2000,916,PHI,FLO,PHI12,3,2,5
PHI200009170,2000,917,PHI,FLO,PHI12,5,6,11
PHI200009180,2000,918,PHI,PIT,PHI12,6,5,11
PHI200009190,2000,919,PHI,PIT,PHI12,12,8,20
PHI200009200,2000,920,PHI,PIT,PHI12,7,6,13
PHI200009210,2000,921,PHI,NYN,PHI12,5,6,11
PHI200009220,2000,922,PHI,NYN,PHI12,9,6,15
PHI200009230,2000,923,PHI,NYN,PHI12,7,3,10
PHI200009240,2000,924,PHI,NYN,PHI12,3,2,5
PHI200104060,2001,10406,PHI,CHN,PHI12,3,2,5
PHI200104070,2001,10407,PHI,CHN,PHI12,8,4,12
PHI200104080,2001,10408,PHI,CHN,PHI12,1,3,4
PHI200104090,2001,10409,PHI,FLO,PHI12,4,5,9
PHI200104100,2001,10410,PHI,FLO,PHI12,6,7,13
PHI200104200,2001,10420,PHI,ATL,PHI12,3,8,11
PHI200104210,2001,10421,PHI,ATL,PHI12,1,4,5
PHI200104220,2001,10422,PHI,ATL,PHI12,2,3,5
PHI200105010,2001,10501,PHI,COL,PHI12,1,7,8
PHI200105020,2001,10502,PHI,COL,PHI12,6,2,8
PHI200105030,2001,10503,PHI,COL,PHI12,5,7,12
PHI200105040,2001,10504,PHI,SFN,PHI12,4,2,6
PHI200105050,2001,10505,PHI,SFN,PHI12,2,4,6
PHI200105060,2001,10506,PHI,SFN,PHI12,8,10,18
PHI200105150,2001,10515,PHI,MIL,PHI12,14,10,24
PHI200105160,2001,10516,PHI,MIL,PHI12,6,1,7
PHI200105170,2001,10517,PHI,MIL,PHI12,1,2,3
PHI200105180,2001,10518,PHI,SLN,PHI12,4,5,9
PHI200105190,2001,10519,PHI,SLN,PHI12,2,3,5
PHI200105200,2001,10520,PHI,SLN,PHI12,3,1,4
PHI200105231,2001,10523,PHI,PIT,PHI12,0,4,4
PHI200105232,2001,10523,PHI,PIT,PHI12,2,5,7
PHI200105240,2001,10524,PHI,PIT,PHI12,5,6,11
PHI200105250,2001,10525,PHI,MON,PHI12,8,10,18
PHI200105271,2001,10527,PHI,MON,PHI12,5,7,12
PHI200105272,2001,10527,PHI,MON,PHI12,7,3,10
PHI200106050,2001,10605,PHI,NYN,PHI12,9,0,9
PHI200106060,2001,10606,PHI,NYN,PHI12,1,6,7
PHI200106070,2001,10607,PHI,NYN,PHI12,6,5,11
PHI200106150,2001,10615,PHI,BAL,PHI12,7,15,22
PHI200106160,2001,10616,PHI,BAL,PHI12,6,14,20
PHI200106170,2001,10617,PHI,BAL,PHI12,10,7,17
PHI200106250,2001,10625,PHI,ATL,PHI12,9,4,13
PHI200106260,2001,10626,PHI,ATL,PHI12,4,1,5
PHI200106270,2001,10627,PHI,ATL,PHI12,10,4,14
PHI200106281,2001,10628,PHI,FLO,PHI12,5,6,11
PHI200106282,2001,10628,PHI,FLO,PHI12,7,8,15
PHI200106290,2001,10629,PHI,FLO,PHI12,0,5,5
PHI200106300,2001,10630,PHI,FLO,PHI12,4,6,10
PHI200107010,2001,10701,PHI,FLO,PHI12,1,8,9
PHI200107120,2001,10712,PHI,TOR,PHI12,2,1,3
PHI200107130,2001,10713,PHI,TOR,PHI12,2,5,7
PHI200107140,2001,10714,PHI,TOR,PHI12,4,2,6
PHI200107150,2001,10715,PHI,NYA,PHI12,3,9,12
PHI200107160,2001,10716,PHI,NYA,PHI12,6,3,9
PHI200107170,2001,10717,PHI,NYA,PHI12,4,1,5
PHI200107200,2001,10720,PHI,NYN,PHI12,1,10,11
PHI200107210,2001,10721,PHI,NYN,PHI12,6,3,9
PHI200107220,2001,10722,PHI,NYN,PHI12,2,3,5
PHI200107230,2001,10723,PHI,MON,PHI12,3,0,3
PHI200107240,2001,10724,PHI,MON,PHI12,2,10,12
PHI200107250,2001,10725,PHI,MON,PHI12,4,8,12
PHI200108070,2001,10807,PHI,SDN,PHI12,3,7,10
PHI200108080,2001,10808,PHI,SDN,PHI12,3,4,7
PHI200108090,2001,10809,PHI,SDN,PHI12,6,2,8
PHI200108100,2001,10810,PHI,LAN,PHI12,5,10,15
PHI200108110,2001,10811,PHI,LAN,PHI12,3,7,10
PHI200108120,2001,10812,PHI,LAN,PHI12,2,3,5
PHI200108210,2001,10821,PHI,HOU,PHI12,8,2,10
PHI200108220,2001,10822,PHI,HOU,PHI12,1,2,3
PHI200108230,2001,10823,PHI,HOU,PHI12,2,1,3
PHI200108240,2001,10824,PHI,ARI,PHI12,5,6,11
PHI200108250,2001,10825,PHI,ARI,PHI12,4,3,7
PHI200108260,2001,10826,PHI,ARI,PHI12,4,3,7
PHI200108270,2001,10827,PHI,ARI,PHI12,1,3,4
PHI200108310,2001,10831,PHI,MON,PHI12,5,1,6
PHI200109010,2001,10901,PHI,MON,PHI12,1,4,5
PHI200109020,2001,10902,PHI,MON,PHI12,6,2,8
PHI200109030,2001,10903,PHI,NYN,PHI12,10,7,17
PHI200109040,2001,10904,PHI,NYN,PHI12,5,3,8
PHI200109050,2001,10905,PHI,NYN,PHI12,7,4,11
PHI200109170,2001,10917,PHI,ATL,PHI12,2,5,7
PHI200109180,2001,10918,PHI,ATL,PHI12,3,4,7
PHI200109190,2001,10919,PHI,ATL,PHI12,2,5,7
PHI200109200,2001,10920,PHI,ATL,PHI12,5,1,6
PHI200109210,2001,10921,PHI,FLO,PHI12,0,1,1
PHI200109220,2001,10922,PHI,FLO,PHI12,3,2,5
PHI200109230,2001,10923,PHI,FLO,PHI12,4,5,9
PHI200109250,2001,10925,PHI,CIN,PHI12,8,1,9
PHI200109260,2001,10926,PHI,CIN,PHI12,0,8,8
PHI200109270,2001,10927,PHI,CIN,PHI12,2,1,3
PHI200204050,2002,20405,PHI,FLO,PHI12,2,6,8
PHI200204060,2002,20406,PHI,FLO,PHI12,7,3,10
PHI200204070,2002,20407,PHI,FLO,PHI12,2,3,5
PHI200204080,2002,20408,PHI,ATL,PHI12,2,1,3
PHI200204090,2002,20409,PHI,ATL,PHI12,4,7,11
PHI200204100,2002,20410,PHI,ATL,PHI12,5,7,12
PHI200204110,2002,20411,PHI,ATL,PHI12,6,2,8
PHI200204120,2002,20412,PHI,CIN,PHI12,8,5,13
PHI200204130,2002,20413,PHI,CIN,PHI12,5,2,7
PHI200204140,2002,20414,PHI,CIN,PHI12,1,3,4
PHI200204230,2002,20423,PHI,SDN,PHI12,5,8,13
PHI200204240,2002,20424,PHI,SDN,PHI12,7,2,9
PHI200204250,2002,20425,PHI,SDN,PHI12,6,4,10
PHI200205030,2002,20503,PHI,COL,PHI12,2,3,5
PHI200205040,2002,20504,PHI,COL,PHI12,5,6,11
PHI200205050,2002,20505,PHI,COL,PHI12,4,7,11
PHI200205070,2002,20507,PHI,HOU,PHI12,4,7,11
PHI200205080,2002,20508,PHI,HOU,PHI12,3,5,8
PHI200205090,2002,20509,PHI,HOU,PHI12,1,3,4
PHI200205100,2002,20510,PHI,ARI,PHI12,0,4,4
PHI200205110,2002,20511,PHI,ARI,PHI12,6,5,11
PHI200205120,2002,20512,PHI,ARI,PHI12,1,3,4
PHI200205210,2002,20521,PHI,NYN,PHI12,0,4,4
PHI200205220,2002,20522,PHI,NYN,PHI12,2,5,7
PHI200205230,2002,20523,PHI,NYN,PHI12,1,0,1
PHI200205310,2002,20531,PHI,MON,PHI12,8,7,15
PHI200206010,2002,20601,PHI,MON,PHI12,4,8,12
PHI200206020,2002,20602,PHI,MON,PHI12,3,18,21
PHI200206040,2002,20604,PHI,FLO,PHI12,5,0,5
PHI200206050,2002,20605,PHI,FLO,PHI12,2,1,3
PHI200206140,2002,20614,PHI,BAL,PHI12,7,3,10
PHI200206150,2002,20615,PHI,BAL,PHI12,3,4,7
PHI200206160,2002,20616,PHI,BAL,PHI12,4,2,6
PHI200206180,2002,20618,PHI,CHA,PHI12,6,3,9
PHI200206190,2002,20619,PHI,CHA,PHI12,3,4,7
PHI200206200,2002,20620,PHI,CHA,PHI12,6,1,7
PHI200206210,2002,20621,PHI,MIN,PHI12,0,3,3
PHI200206220,2002,20622,PHI,MIN,PHI12,4,1,5
PHI200206230,2002,20623,PHI,MIN,PHI12,5,1,6
PHI200207010,2002,20701,PHI,NYN,PHI12,3,6,9
PHI200207020,2002,20702,PHI,NYN,PHI12,12,6,18
PHI200207030,2002,20703,PHI,NYN,PHI12,7,8,15
PHI200207040,2002,20704,PHI,MON,PHI12,2,1,3
PHI200207050,2002,20705,PHI,MON,PHI12,8,3,11
PHI200207060,2002,20706,PHI,MON,PHI12,5,3,8
PHI200207070,2002,20707,PHI,MON,PHI12,8,10,18
PHI200207170,2002,20717,PHI,CHN,PHI12,3,4,7
PHI200207180,2002,20718,PHI,CHN,PHI12,6,4,10
PHI200207190,2002,20719,PHI,ATL,PHI12,4,1,5
PHI200207200,2002,20720,PHI,ATL,PHI12,4,3,7
PHI200207210,2002,20721,PHI,ATL,PHI12,2,1,3
PHI200207300,2002,20730,PHI,SFN,PHI12,10,3,13
PHI200207310,2002,20731,PHI,SFN,PHI12,6,8,14
PHI200208010,2002,20801,PHI,SFN,PHI12,1,2,3
PHI200208020,2002,20802,PHI,LAN,PHI12,1,3,4
PHI200208030,2002,20803,PHI,LAN,PHI12,8,6,14
PHI200208040,2002,20804,PHI,LAN,PHI12,4,3,7
PHI200208050,2002,20805,PHI,LAN,PHI12,5,7,12
PHI200208130,2002,20813,PHI,MIL,PHI12,1,3,4
PHI200208140,2002,20814,PHI,MIL,PHI12,1,4,5
PHI200208150,2002,20815,PHI,MIL,PHI12,0,5,5
PHI200208160,2002,20816,PHI,SLN,PHI12,0,4,4
PHI200208170,2002,20817,PHI,SLN,PHI12,5,1,6
PHI200208180,2002,20818,PHI,SLN,PHI12,5,1,6
PHI200208270,2002,20827,PHI,MON,PHI12,2,4,6
PHI200208280,2002,20828,PHI,MON,PHI12,6,3,9
PHI200208290,2002,20829,PHI,MON,PHI12,1,2,3
PHI200209060,2002,20906,PHI,NYN,PHI12,7,2,9
PHI200209070,2002,20907,PHI,NYN,PHI12,5,4,9
PHI200209080,2002,20908,PHI,NYN,PHI12,11,3,14
PHI200209090,2002,20909,PHI,NYN,PHI12,6,4,10
PHI200209101,2002,20910,PHI,FLO,PHI12,6,4,10
PHI200209102,2002,20910,PHI,FLO,PHI12,2,1,3
PHI200209110,2002,20911,PHI,FLO,PHI12,2,9,11
PHI200209120,2002,20912,PHI,FLO,PHI12,1,6,7
PHI200209130,2002,20913,PHI,PIT,PHI12,5,3,8
PHI200209140,2002,20914,PHI,PIT,PHI12,1,4,5
PHI200209150,2002,20915,PHI,PIT,PHI12,0,1,1
PHI200209240,2002,20924,PHI,ATL,PHI12,3,5,8
PHI200209250,2002,20925,PHI,ATL,PHI12,7,1,8
PHI200304040,2003,30404,PHI,PIT,PHI12,9,1,10
PHI200304050,2003,30405,PHI,PIT,PHI12,1,16,17
PHI200304060,2003,30406,PHI,PIT,PHI12,2,0,2
PHI200304080,2003,30408,PHI,ATL,PHI12,3,4,7
PHI200304090,2003,30409,PHI,ATL,PHI12,2,16,18
PHI200304100,2003,30410,PHI,ATL,PHI12,6,2,8
PHI200304140,2003,30414,PHI,FLO,PHI12,2,5,7
PHI200304150,2003,30415,PHI,FLO,PHI12,3,4,7
PHI200304160,2003,30416,PHI,FLO,PHI12,3,1,4
PHI200304170,2003,30417,PHI,FLO,PHI12,7,3,10
PHI200304220,2003,30422,PHI,COL,PHI12,2,5,7
PHI200304230,2003,30423,PHI,COL,PHI12,4,6,10
PHI200304240,2003,30424,PHI,COL,PHI12,1,9,10
PHI200304250,2003,30425,PHI,SFN,PHI12,7,4,11
PHI200304260,2003,30426,PHI,SFN,PHI12,2,10,12
PHI200304270,2003,30427,PHI,SFN,PHI12,0,1,1
PHI200305090,2003,30509,PHI,HOU,PHI12,3,5,8
PHI200305100,2003,30510,PHI,HOU,PHI12,0,2,2
PHI200305110,2003,30511,PHI,HOU,PHI12,10,7,17
PHI200305130,2003,30513,PHI,ARI,PHI12,6,1,7
PHI200305140,2003,30514,PHI,ARI,PHI12,2,0,2
PHI200305150,2003,30515,PHI,ARI,PHI12,4,6,10
PHI200305270,2003,30527,PHI,NYN,PHI12,4,2,6
PHI200305280,2003,30528,PHI,NYN,PHI12,3,11,14
PHI200305290,2003,30529,PHI,NYN,PHI12,5,0,5
PHI200305300,2003,30530,PHI,MON,PHI12,5,12,17
PHI200306011,2003,30601,PHI,MON,PHI12,3,4,7
PHI200306012,2003,30601,PHI,MON,PHI12,1,4,5
PHI200306030,2003,30603,PHI,SEA,PHI12,4,0,4
PHI200306040,2003,30604,PHI,SEA,PHI12,7,2,9
PHI200306050,2003,30605,PHI,SEA,PHI12,5,4,9
PHI200306060,2003,30606,PHI,OAK,PHI12,7,4,11
PHI200306081,2003,30608,PHI,OAK,PHI12,1,7,8
PHI200306082,2003,30608,PHI,OAK,PHI12,3,8,11
PHI200306170,2003,30617,PHI,ATL,PHI12,4,5,9
PHI200306180,2003,30618,PHI,ATL,PHI12,6,1,7
PHI200306190,2003,30619,PHI,ATL,PHI12,2,3,5
PHI200306210,2003,30621,PHI,BOS,PHI12,5,6,11
PHI200306220,2003,30622,PHI,BOS,PHI12,0,5,5
PHI200306300,2003,30630,PHI,CHN,PHI12,3,4,7
PHI200307010,2003,30701,PHI,CHN,PHI12,3,4,7
PHI200307020,2003,30702,PHI,CHN,PHI12,1,0,1
PHI200307030,2003,30703,PHI,CHN,PHI12,2,12,14
PHI200307040,2003,30704,PHI,FLO,PHI12,2,1,3
PHI200307050,2003,30705,PHI,FLO,PHI12,5,4,9
PHI200307060,2003,30706,PHI,FLO,PHI12,6,3,9
PHI200307170,2003,30717,PHI,MON,PHI12,2,5,7
PHI200307180,2003,30718,PHI,MON,PHI12,3,1,4
PHI200307190,2003,30719,PHI,MON,PHI12,3,4,7
PHI200307200,2003,30720,PHI,MON,PHI12,2,3,5
PHI200307210,2003,30721,PHI,NYN,PHI12,8,6,14
PHI200307220,2003,30722,PHI,NYN,PHI12,7,5,12
PHI200307290,2003,30729,PHI,LAN,PHI12,0,2,2
PHI200307300,2003,30730,PHI,LAN,PHI12,2,4,6
PHI200307310,2003,30731,PHI,LAN,PHI12,3,7,10
PHI200308010,2003,30801,PHI,SDN,PHI12,0,6,6
PHI200308021,2003,30802,PHI,SDN,PHI12,6,4,10
PHI200308022,2003,30802,PHI,SDN,PHI12,4,10,14
PHI200308030,2003,30803,PHI,SDN,PHI12,5,2,7
PHI200308120,2003,30812,PHI,MIL,PHI12,6,3,9
PHI200308130,2003,30813,PHI,MIL,PHI12,4,11,15
PHI200308140,2003,30814,PHI,MIL,PHI12,3,4,7
PHI200308150,2003,30815,PHI,SLN,PHI12,4,7,11
PHI200308160,2003,30816,PHI,SLN,PHI12,4,5,9
PHI200308170,2003,30817,PHI,SLN,PHI12,4,6,10
PHI200309010,2003,30901,PHI,BOS,PHI12,13,9,22
PHI200309020,2003,30902,PHI,MON,PHI12,3,5,8
PHI200309030,2003,30903,PHI,MON,PHI12,3,8,11
PHI200309040,2003,30904,PHI,NYN,PHI12,5,6,11
PHI200309050,2003,30905,PHI,NYN,PHI12,0,1,1
PHI200309060,2003,30906,PHI,NYN,PHI12,6,9,15
PHI200309070,2003,30907,PHI,NYN,PHI12,4,5,9
PHI200309160,2003,30916,PHI,FLO,PHI12,0,14,14
PHI200309170,2003,30917,PHI,FLO,PHI12,11,4,15
PHI200309180,2003,30918,PHI,FLO,PHI12,4,5,9
PHI200309190,2003,30919,PHI,CIN,PHI12,3,7,10
PHI200309200,2003,30920,PHI,CIN,PHI12,2,0,2
PHI200309210,2003,30921,PHI,CIN,PHI12,4,3,7
PHI200309260,2003,30926,PHI,ATL,PHI12,6,0,6
PHI200309270,2003,30927,PHI,ATL,PHI12,6,7,13
PHI200309280,2003,30928,PHI,ATL,PHI12,5,2,7
PHI200404120,2004,40412,PHI,CIN,PHI13,4,1,5
PHI200404150,2004,40415,PHI,CIN,PHI13,4,6,10
PHI200404160,2004,40416,PHI,MON,PHI13,2,4,6
PHI200404170,2004,40417,PHI,MON,PHI13,3,6,9
PHI200404180,2004,40418,PHI,MON,PHI13,4,5,9
PHI200404200,2004,40420,PHI,FLO,PHI13,3,1,4
PHI200404210,2004,40421,PHI,FLO,PHI13,8,7,15
PHI200404220,2004,40422,PHI,FLO,PHI13,9,7,16
PHI200404300,2004,40430,PHI,ARI,PHI13,0,4,4
PHI200405010,2004,40501,PHI,ARI,PHI13,6,4,10
PHI200405020,2004,40502,PHI,ARI,PHI13,5,6,11
PHI200405040,2004,40504,PHI,SLN,PHI13,6,5,11
PHI200405050,2004,40505,PHI,SLN,PHI13,4,5,9
PHI200405060,2004,40506,PHI,SLN,PHI13,7,4,11
PHI200405180,2004,40518,PHI,LAN,PHI13,7,8,15
PHI200405190,2004,40519,PHI,LAN,PHI13,4,9,13
PHI200405200,2004,40520,PHI,LAN,PHI13,0,4,4
PHI200405210,2004,40521,PHI,SDN,PHI13,4,5,9
PHI200405220,2004,40522,PHI,SDN,PHI13,9,6,15
PHI200405230,2004,40523,PHI,SDN,PHI13,4,6,10
PHI200405270,2004,40527,PHI,ATL,PHI13,6,1,7
PHI200405280,2004,40528,PHI,ATL,PHI13,2,3,5
PHI200405290,2004,40529,PHI,ATL,PHI13,9,3,12
PHI200405300,2004,40530,PHI,ATL,PHI13,1,4,5
PHI200405310,2004,40531,PHI,NYN,PHI13,5,3,8
PHI200406010,2004,40601,PHI,NYN,PHI13,4,1,5
PHI200406020,2004,40602,PHI,NYN,PHI13,5,3,8
PHI200406140,2004,40614,PHI,CIN,PHI13,7,10,17
PHI200406150,2004,40615,PHI,DET,PHI13,10,3,13
PHI200406171,2004,40617,PHI,DET,PHI13,2,6,8
PHI200406172,2004,40617,PHI,DET,PHI13,5,4,9
PHI200406180,2004,40618,PHI,KCA,PHI13,10,4,14
PHI200406190,2004,40619,PHI,KCA,PHI13,2,4,6
PHI200406200,2004,40620,PHI,KCA,PHI13,2,8,10
PHI200406280,2004,40628,PHI,MON,PHI13,6,14,20
PHI200406290,2004,40629,PHI,MON,PHI13,7,17,24
PHI200406300,2004,40630,PHI,MON,PHI13,6,3,9
PHI200407010,2004,40701,PHI,MON,PHI13,5,10,15
PHI200407020,2004,40702,PHI,BAL,PHI13,7,6,13
PHI200407030,2004,40703,PHI,BAL,PHI13,6,7,13
PHI200407040,2004,40704,PHI,BAL,PHI13,2,5,7
PHI200407050,2004,40705,PHI,NYN,PHI13,5,6,11
PHI200407060,2004,40706,PHI,NYN,PHI13,4,1,5
PHI200407070,2004,40707,PHI,NYN,PHI13,10,1,11
PHI200407080,2004,40708,PHI,NYN,PHI13,4,5,9
PHI200407090,2004,40709,PHI,ATL,PHI13,6,7,13
PHI200407100,2004,40710,PHI,ATL,PHI13,4,0,4
PHI200407110,2004,40711,PHI,ATL,PHI13,6,4,10
PHI200407210,2004,40721,PHI,FLO,PHI13,1,2,3
PHI200407220,2004,40722,PHI,FLO,PHI13,10,8,18
PHI200407230,2004,40723,PHI,CHN,PHI13,5,1,6
PHI200407240,2004,40724,PHI,CHN,PHI13,3,4,7
PHI200407250,2004,40725,PHI,CHN,PHI13,2,3,5
PHI200408090,2004,40809,PHI,COL,PHI13,4,2,6
PHI200408100,2004,40810,PHI,COL,PHI13,5,4,9
PHI200408110,2004,40811,PHI,COL,PHI13,4,15,19
PHI200408120,2004,40812,PHI,COL,PHI13,3,1,4
PHI200408130,2004,40813,PHI,SFN,PHI13,16,6,22
PHI200408140,2004,40814,PHI,SFN,PHI13,7,6,13
PHI200408150,2004,40815,PHI,SFN,PHI13,3,1,4
PHI200408170,2004,40817,PHI,HOU,PHI13,5,0,5
PHI200408180,2004,40818,PHI,HOU,PHI13,9,8,17
PHI200408190,2004,40819,PHI,HOU,PHI13,12,10,22
PHI200408270,2004,40827,PHI,MIL,PHI13,1,6,7
PHI200408280,2004,40828,PHI,MIL,PHI13,3,4,7
PHI200408290,2004,40829,PHI,MIL,PHI13,0,10,10
PHI200408310,2004,40831,PHI,ATL,PHI13,5,3,8
PHI200409010,2004,40901,PHI,ATL,PHI13,7,2,9
PHI200409030,2004,40903,PHI,NYN,PHI13,1,8,9
PHI200409040,2004,40904,PHI,NYN,PHI13,0,7,7
PHI200409050,2004,40905,PHI,NYN,PHI13,2,4,6
PHI200409170,2004,40917,PHI,MON,PHI13,12,8,20
PHI200409180,2004,40918,PHI,MON,PHI13,6,5,11
PHI200409190,2004,40919,PHI,MON,PHI13,2,7,9
PHI200409270,2004,40927,PHI,PIT,PHI13,6,1,7
PHI200409291,2004,40929,PHI,PIT,PHI13,4,8,12
PHI200409292,2004,40929,PHI,PIT,PHI13,3,8,11
PHI200409300,2004,40930,PHI,FLO,PHI13,4,7,11
PHI200410010,2004,41001,PHI,FLO,PHI13,2,6,8
PHI200410020,2004,41002,PHI,FLO,PHI13,4,3,7
PHI200410030,2004,41003,PHI,FLO,PHI13,4,10,14
PHI200504040,2005,50404,PHI,WAS,PHI13,4,8,12
PHI200504060,2005,50406,PHI,WAS,PHI13,7,3,10
PHI200504070,2005,50407,PHI,WAS,PHI13,5,4,9
PHI200504150,2005,50415,PHI,ATL,PHI13,11,4,15
PHI200504160,2005,50416,PHI,ATL,PHI13,1,2,3
PHI200504170,2005,50417,PHI,ATL,PHI13,1,2,3
PHI200504180,2005,50418,PHI,NYN,PHI13,4,5,9
PHI200504190,2005,50419,PHI,NYN,PHI13,16,4,20
PHI200504200,2005,50420,PHI,COL,PHI13,7,4,11
PHI200504210,2005,50421,PHI,COL,PHI13,3,6,9
PHI200504290,2005,50429,PHI,FLO,PHI13,6,4,10
PHI200504300,2005,50430,PHI,FLO,PHI13,2,1,3
PHI200505010,2005,50501,PHI,FLO,PHI13,6,8,14
PHI200505120,2005,50512,PHI,CIN,PHI13,7,5,12
PHI200505130,2005,50513,PHI,CIN,PHI13,2,12,14
PHI200505140,2005,50514,PHI,CIN,PHI13,12,4,16
PHI200505150,2005,50515,PHI,CIN,PHI13,3,4,7
PHI200505170,2005,50517,PHI,SLN,PHI13,5,7,12
PHI200505180,2005,50518,PHI,SLN,PHI13,8,4,12
PHI200505190,2005,50519,PHI,SLN,PHI13,4,7,11
PHI200505310,2005,50531,PHI,SFN,PHI13,2,5,7
PHI200506010,2005,50601,PHI,SFN,PHI13,6,10,16
PHI200506020,2005,50602,PHI,SFN,PHI13,5,6,11
PHI200506041,2005,50604,PHI,ARI,PHI13,6,10,16
PHI200506042,2005,50604,PHI,ARI,PHI13,3,5,8
PHI200506050,2005,50605,PHI,ARI,PHI13,6,7,13
PHI200506060,2005,50606,PHI,ARI,PHI13,10,8,18
PHI200506070,2005,50607,PHI,TEX,PHI13,5,8,13
PHI200506080,2005,50608,PHI,TEX,PHI13,0,2,2
PHI200506090,2005,50609,PHI,TEX,PHI13,8,10,18
PHI200506100,2005,50610,PHI,MIL,PHI13,2,5,7
PHI200506110,2005,50611,PHI,MIL,PHI13,5,7,12
PHI200506120,2005,50612,PHI,MIL,PHI13,2,6,8
PHI200506210,2005,50621,PHI,NYN,PHI13,8,5,13
PHI200506220,2005,50622,PHI,NYN,PHI13,4,8,12
PHI200506230,2005,50623,PHI,NYN,PHI13,4,3,7
PHI200506240,2005,50624,PHI,BOS,PHI13,8,0,8
PHI200506250,2005,50625,PHI,BOS,PHI13,7,1,8
PHI200506260,2005,50626,PHI,BOS,PHI13,12,8,20
PHI200507010,2005,50701,PHI,ATL,PHI13,9,1,10
PHI200507020,2005,50702,PHI,ATL,PHI13,3,6,9
PHI200507030,2005,50703,PHI,ATL,PHI13,4,3,7
PHI200507080,2005,50708,PHI,WAS,PHI13,8,7,15
PHI200507090,2005,50709,PHI,WAS,PHI13,0,1,1
PHI200507100,2005,50710,PHI,WAS,PHI13,4,5,9
PHI200507140,2005,50714,PHI,FLO,PHI13,7,13,20
PHI200507150,2005,50715,PHI,FLO,PHI13,9,7,16
PHI200507160,2005,50716,PHI,FLO,PHI13,5,10,15
PHI200507170,2005,50717,PHI,FLO,PHI13,4,8,12
PHI200507190,2005,50719,PHI,LAN,PHI13,4,5,9
PHI200507200,2005,50720,PHI,LAN,PHI13,10,2,12
PHI200507210,2005,50721,PHI,LAN,PHI13,1,0,1
PHI200507220,2005,50722,PHI,SDN,PHI13,6,8,14
PHI200507230,2005,50723,PHI,SDN,PHI13,0,2,2
PHI200507240,2005,50724,PHI,SDN,PHI13,1,5,6
PHI200508020,2005,50802,PHI,CHN,PHI13,2,1,3
PHI200508030,2005,50803,PHI,CHN,PHI13,3,4,7
PHI200508040,2005,50804,PHI,CHN,PHI13,4,6,10
PHI200508050,2005,50805,PHI,MIL,PHI13,3,1,4
PHI200508060,2005,50806,PHI,MIL,PHI13,2,8,10
PHI200508070,2005,50807,PHI,MIL,PHI13,2,0,2
PHI200508150,2005,50815,PHI,WAS,PHI13,6,3,9
PHI200508170,2005,50817,PHI,WAS,PHI13,3,4,7
PHI200508181,2005,50818,PHI,WAS,PHI13,1,2,3
PHI200508182,2005,50818,PHI,WAS,PHI13,5,4,9
PHI200508190,2005,50819,PHI,PIT,PHI13,11,2,13
PHI200508200,2005,50820,PHI,PIT,PHI13,1,6,7
PHI200508210,2005,50821,PHI,PIT,PHI13,3,4,7
PHI200509050,2005,50905,PHI,HOU,PHI13,4,3,7
PHI200509060,2005,50906,PHI,HOU,PHI13,2,1,3
PHI200509070,2005,50907,PHI,HOU,PHI13,8,6,14
PHI200509090,2005,50909,PHI,FLO,PHI13,5,12,17
PHI200509100,2005,50910,PHI,FLO,PHI13,7,6,13
PHI200509110,2005,50911,PHI,FLO,PHI13,1,11,12
PHI200509120,2005,50912,PHI,ATL,PHI13,1,4,5
PHI200509130,2005,50913,PHI,ATL,PHI13,4,5,9
PHI200509140,2005,50914,PHI,ATL,PHI13,4,12,16
PHI200509150,2005,50915,PHI,ATL,PHI13,6,4,10
PHI200509260,2005,50926,PHI,NYN,PHI13,6,5,11
PHI200509270,2005,50927,PHI,NYN,PHI13,3,2,5
PHI200509280,2005,50928,PHI,NYN,PHI13,6,16,22
PHI200604030,2006,60403,PHI,SLN,PHI13,13,5,18
PHI200604050,2006,60405,PHI,SLN,PHI13,4,3,7
PHI200604060,2006,60406,PHI,SLN,PHI13,4,2,6
PHI200604070,2006,60407,PHI,LAN,PHI13,5,3,8
PHI200604091,2006,60409,PHI,LAN,PHI13,3,6,9
PHI200604092,2006,60409,PHI,LAN,PHI13,6,2,8
PHI200604180,2006,60418,PHI,WAS,PHI13,10,3,13
PHI200604190,2006,60419,PHI,WAS,PHI13,6,7,13
PHI200604200,2006,60420,PHI,WAS,PHI13,10,4,14
PHI200604210,2006,60421,PHI,FLO,PHI13,4,3,7
PHI200604230,2006,60423,PHI,FLO,PHI13,2,4,6
PHI200604240,2006,60424,PHI,COL,PHI13,5,6,11
PHI200604250,2006,60425,PHI,COL,PHI13,7,6,13
PHI200604260,2006,60426,PHI,COL,PHI13,5,9,14
PHI200604270,2006,60427,PHI,COL,PHI13,6,3,9
PHI200605030,2006,60503,PHI,ATL,PHI13,4,5,9
PHI200605040,2006,60504,PHI,ATL,PHI13,3,6,9
PHI200605050,2006,60505,PHI,SFN,PHI13,3,8,11
PHI200605060,2006,60506,PHI,SFN,PHI13,1,4,5
PHI200605070,2006,60507,PHI,SFN,PHI13,5,9,14
PHI200605090,2006,60509,PHI,NYN,PHI13,4,5,9
PHI200605100,2006,60510,PHI,NYN,PHI13,13,4,17
PHI200605110,2006,60511,PHI,NYN,PHI13,0,2,2
PHI200605190,2006,60519,PHI,BOS,PHI13,5,3,8
PHI200605200,2006,60520,PHI,BOS,PHI13,8,4,12
PHI200605210,2006,60521,PHI,BOS,PHI13,5,10,15
PHI200605260,2006,60526,PHI,MIL,PHI13,6,5,11
PHI200605270,2006,60527,PHI,MIL,PHI13,9,6,15
PHI200605280,2006,60528,PHI,MIL,PHI13,2,6,8
PHI200605290,2006,60529,PHI,WAS,PHI13,2,11,13
PHI200605300,2006,60530,PHI,WAS,PHI13,2,4,6
PHI200605310,2006,60531,PHI,WAS,PHI13,3,2,5
PHI200606130,2006,60613,PHI,NYN,PHI13,9,7,16
PHI200606140,2006,60614,PHI,NYN,PHI13,9,3,12
PHI200606150,2006,60615,PHI,NYN,PHI13,5,4,9
PHI200606160,2006,60616,PHI,TBA,PHI13,10,4,14
PHI200606170,2006,60617,PHI,TBA,PHI13,7,2,9
PHI200606180,2006,60618,PHI,TBA,PHI13,5,8,13
PHI200606190,2006,60619,PHI,NYA,PHI13,2,4,6
PHI200606200,2006,60620,PHI,NYA,PHI13,9,7,16
PHI200606210,2006,60621,PHI,NYA,PHI13,5,0,5
PHI200607040,2006,60704,PHI,SDN,PHI13,5,6,11
PHI200607050,2006,60705,PHI,SDN,PHI13,6,3,9
PHI200607060,2006,60706,PHI,SDN,PHI13,5,3,8
PHI200607070,2006,60707,PHI,PIT,PHI13,3,2,5
PHI200607080,2006,60708,PHI,PIT,PHI13,2,6,8
PHI200607090,2006,60709,PHI,PIT,PHI13,3,8,11
PHI200607210,2006,60721,PHI,ATL,PHI13,5,6,11
PHI200607230,2006,60723,PHI,ATL,PHI13,5,1,6
PHI200607240,2006,60724,PHI,ATL,PHI13,10,8,18
PHI200607250,2006,60725,PHI,ARI,PHI13,6,5,11
PHI200607260,2006,60726,PHI,ARI,PHI13,4,6,10
PHI200607270,2006,60727,PHI,ARI,PHI13,2,5,7
PHI200607280,2006,60728,PHI,FLO,PHI13,4,1,5
PHI200607290,2006,60729,PHI,FLO,PHI13,3,12,15
PHI200607301,2006,60730,PHI,FLO,PHI13,5,11,16
PHI200607302,2006,60730,PHI,FLO,PHI13,2,9,11
PHI200607310,2006,60731,PHI,FLO,PHI13,15,2,17
PHI200608110,2006,60811,PHI,CIN,PHI13,5,6,11
PHI200608120,2006,60812,PHI,CIN,PHI13,9,7,16
PHI200608130,2006,60813,PHI,CIN,PHI13,7,5,12
PHI200608140,2006,60814,PHI,NYN,PHI13,0,13,13
PHI200608150,2006,60815,PHI,NYN,PHI13,4,11,15
PHI200608160,2006,60816,PHI,NYN,PHI13,0,3,3
PHI200608170,2006,60817,PHI,NYN,PHI13,7,2,9
PHI200608180,2006,60818,PHI,WAS,PHI13,6,4,10
PHI200608190,2006,60819,PHI,WAS,PHI13,2,11,13
PHI200608200,2006,60820,PHI,WAS,PHI13,10,12,22
PHI200609021,2006,60902,PHI,ATL,PHI13,4,3,7
PHI200609022,2006,60902,PHI,ATL,PHI13,4,16,20
PHI200609031,2006,60903,PHI,ATL,PHI13,7,8,15
PHI200609032,2006,60903,PHI,ATL,PHI13,3,1,4
PHI200609040,2006,60904,PHI,HOU,PHI13,2,3,5
PHI200609060,2006,60906,PHI,HOU,PHI13,5,3,8
PHI200609180,2006,60918,PHI,CHN,PHI13,11,6,17
PHI200609190,2006,60919,PHI,CHN,PHI13,1,4,5
PHI200609200,2006,60920,PHI,CHN,PHI13,2,6,8
PHI200609220,2006,60922,PHI,FLO,PHI13,2,5,7
PHI200609230,2006,60923,PHI,FLO,PHI13,6,8,14
PHI200609240,2006,60924,PHI,FLO,PHI13,7,10,17
PHI200609250,2006,60925,PHI,HOU,PHI13,5,4,9
PHI200704020,2007,70402,PHI,ATL,PHI13,5,3,8
PHI200704040,2007,70404,PHI,ATL,PHI13,3,2,5
PHI200704050,2007,70405,PHI,ATL,PHI13,8,4,12
PHI200704130,2007,70413,PHI,HOU,PHI13,9,6,15
PHI200704140,2007,70414,PHI,HOU,PHI13,5,8,13
PHI200704170,2007,70417,PHI,NYN,PHI13,8,1,9
PHI200704230,2007,70423,PHI,HOU,PHI13,4,11,15
PHI200704240,2007,70424,PHI,WAS,PHI13,3,6,9
PHI200704250,2007,70425,PHI,WAS,PHI13,3,9,12
PHI200704260,2007,70426,PHI,WAS,PHI13,4,2,6
PHI200704270,2007,70427,PHI,FLO,PHI13,5,6,11
PHI200704280,2007,70428,PHI,FLO,PHI13,11,5,16
PHI200704290,2007,70429,PHI,FLO,PHI13,1,6,7
PHI200705110,2007,70511,PHI,CHN,PHI13,2,7,9
PHI200705120,2007,70512,PHI,CHN,PHI13,7,11,18
PHI200705130,2007,70513,PHI,CHN,PHI13,4,1,5
PHI200705140,2007,70514,PHI,MIL,PHI13,6,8,14
PHI200705150,2007,70515,PHI,MIL,PHI13,3,4,7
PHI200705160,2007,70516,PHI,MIL,PHI13,2,6,8
PHI200705170,2007,70517,PHI,MIL,PHI13,3,2,5
PHI200705180,2007,70518,PHI,TOR,PHI13,3,5,8
PHI200705190,2007,70519,PHI,TOR,PHI13,13,2,15
PHI200705200,2007,70520,PHI,TOR,PHI13,3,5,8
PHI200705280,2007,70528,PHI,ARI,PHI13,5,4,9
PHI200705290,2007,70529,PHI,ARI,PHI13,11,5,16
PHI200705300,2007,70530,PHI,ARI,PHI13,4,3,7
PHI200706010,2007,70601,PHI,SFN,PHI13,13,0,13
PHI200706020,2007,70602,PHI,SFN,PHI13,2,5,7
PHI200706030,2007,70603,PHI,SFN,PHI13,8,9,17
PHI200706040,2007,70604,PHI,SFN,PHI13,8,1,9
PHI200706110,2007,70611,PHI,CHA,PHI13,0,3,3
PHI200706120,2007,70612,PHI,CHA,PHI13,3,7,10
PHI200706130,2007,70613,PHI,CHA,PHI13,4,8,12
PHI200706150,2007,70615,PHI,DET,PHI13,12,8,20
PHI200706160,2007,70616,PHI,DET,PHI13,3,6,9
PHI200706170,2007,70617,PHI,DET,PHI13,7,4,11
PHI200706260,2007,70626,PHI,CIN,PHI13,4,11,15
PHI200706270,2007,70627,PHI,CIN,PHI13,9,6,15
PHI200706280,2007,70628,PHI,CIN,PHI13,7,8,15
PHI200706291,2007,70629,PHI,NYN,PHI13,6,5,11
PHI200706292,2007,70629,PHI,NYN,PHI13,5,2,7
PHI200706300,2007,70630,PHI,NYN,PHI13,8,3,11
PHI200707010,2007,70701,PHI,NYN,PHI13,3,5,8
PHI200707130,2007,70713,PHI,SLN,PHI13,3,13,16
PHI200707140,2007,70714,PHI,SLN,PHI13,4,10,14
PHI200707150,2007,70715,PHI,SLN,PHI13,10,2,12
PHI200707240,2007,70724,PHI,WAS,PHI13,3,4,7
PHI200707250,2007,70725,PHI,WAS,PHI13,5,7,12
PHI200707260,2007,70726,PHI,WAS,PHI13,7,6,13
PHI200707270,2007,70727,PHI,PIT,PHI13,1,8,9
PHI200707280,2007,70728,PHI,PIT,PHI13,5,10,15
PHI200707290,2007,70729,PHI,PIT,PHI13,1,5,6
PHI200708070,2007,70807,PHI,FLO,PHI13,1,11,12
PHI200708080,2007,70808,PHI,FLO,PHI13,4,6,10
PHI200708090,2007,70809,PHI,FLO,PHI13,4,2,6
PHI200708100,2007,70810,PHI,ATL,PHI13,4,5,9
PHI200708110,2007,70811,PHI,ATL,PHI13,7,5,12
PHI200708120,2007,70812,PHI,ATL,PHI13,3,5,8
PHI200708210,2007,70821,PHI,LAN,PHI13,4,5,9
PHI200708220,2007,70822,PHI,LAN,PHI13,15,3,18
PHI200708230,2007,70823,PHI,LAN,PHI13,5,2,7
PHI200708240,2007,70824,PHI,SDN,PHI13,14,3,17
PHI200708250,2007,70825,PHI,SDN,PHI13,4,3,7
PHI200708260,2007,70826,PHI,SDN,PHI13,2,14,16
PHI200708270,2007,70827,PHI,NYN,PHI13,2,9,11
PHI200708280,2007,70828,PHI,NYN,PHI13,2,4,6
PHI200708290,2007,70829,PHI,NYN,PHI13,2,3,5
PHI200708300,2007,70830,PHI,NYN,PHI13,10,11,21
PHI200709070,2007,70907,PHI,FLO,PHI13,6,3,9
PHI200709080,2007,70908,PHI,FLO,PHI13,1,9,10
PHI200709090,2007,70909,PHI,FLO,PHI13,5,8,13
PHI200709100,2007,70910,PHI,COL,PHI13,5,6,11
PHI200709110,2007,70911,PHI,COL,PHI13,8,2,10
PHI200709120,2007,70912,PHI,COL,PHI13,12,0,12
PHI200709130,2007,70913,PHI,COL,PHI13,4,12,16
PHI200709250,2007,70925,PHI,ATL,PHI13,10,6,16
PHI200709260,2007,70926,PHI,ATL,PHI13,2,5,7
PHI200709270,2007,70927,PHI,ATL,PHI13,4,6,10
PHI200709280,2007,70928,PHI,WAS,PHI13,0,6,6
PHI200709290,2007,70929,PHI,WAS,PHI13,4,2,6
PHI200709300,2007,70930,PHI,WAS,PHI13,1,6,7
PHI200710030,2007,71003,PHI,COL,PHI13,4,2,6
PHI200710040,2007,71004,PHI,COL,PHI13,10,5,15
PHI200803310,2008,80331,PHI,WAS,PHI13,11,6,17
PHI200804020,2008,80402,PHI,WAS,PHI13,1,0,1
PHI200804030,2008,80403,PHI,WAS,PHI13,7,8,15
PHI200804110,2008,80411,PHI,CHN,PHI13,3,5,8
PHI200804120,2008,80412,PHI,CHN,PHI13,1,7,8
PHI200804130,2008,80413,PHI,CHN,PHI13,6,5,11
PHI200804150,2008,80415,PHI,HOU,PHI13,3,4,7
PHI200804160,2008,80416,PHI,HOU,PHI13,2,1,3
PHI200804170,2008,80417,PHI,HOU,PHI13,2,10,12
PHI200804180,2008,80418,PHI,NYN,PHI13,6,4,10
PHI200804190,2008,80419,PHI,NYN,PHI13,4,2,6
PHI200804200,2008,80420,PHI,NYN,PHI13,4,5,9
PHI200804290,2008,80429,PHI,SDN,PHI13,4,7,11
PHI200804300,2008,80430,PHI,SDN,PHI13,4,2,6
PHI200805010,2008,80501,PHI,SDN,PHI13,2,3,5
PHI200805020,2008,80502,PHI,SFN,PHI13,5,6,11
PHI200805030,2008,80503,PHI,SFN,PHI13,3,2,5
PHI200805040,2008,80504,PHI,SFN,PHI13,5,6,11
PHI200805130,2008,80513,PHI,ATL,PHI13,4,5,9
PHI200805140,2008,80514,PHI,ATL,PHI13,8,6,14
PHI200805150,2008,80515,PHI,ATL,PHI13,0,5,5
PHI200805160,2008,80516,PHI,TOR,PHI13,3,10,13
PHI200805170,2008,80517,PHI,TOR,PHI13,6,3,9
PHI200805180,2008,80518,PHI,TOR,PHI13,6,5,11
PHI200805260,2008,80526,PHI,COL,PHI13,5,20,25
PHI200805270,2008,80527,PHI,COL,PHI13,4,7,11
PHI200805280,2008,80528,PHI,COL,PHI13,1,6,7
PHI200805300,2008,80530,PHI,FLO,PHI13,3,12,15
PHI200805310,2008,80531,PHI,FLO,PHI13,7,3,10
PHI200806010,2008,80601,PHI,FLO,PHI13,5,7,12
PHI200806020,2008,80602,PHI,CIN,PHI13,4,5,9
PHI200806030,2008,80603,PHI,CIN,PHI13,2,3,5
PHI200806040,2008,80604,PHI,CIN,PHI13,2,0,2
PHI200806050,2008,80605,PHI,CIN,PHI13,0,5,5
PHI200806160,2008,80616,PHI,BOS,PHI13,2,8,10
PHI200806170,2008,80617,PHI,BOS,PHI13,3,0,3
PHI200806180,2008,80618,PHI,BOS,PHI13,7,4,11
PHI200806200,2008,80620,PHI,ANA,PHI13,7,1,8
PHI200806210,2008,80621,PHI,ANA,PHI13,6,2,8
PHI200806220,2008,80622,PHI,ANA,PHI13,3,2,5
PHI200807040,2008,80704,PHI,NYN,PHI13,2,3,5
PHI200807050,2008,80705,PHI,NYN,PHI13,9,4,13
PHI200807060,2008,80706,PHI,NYN,PHI13,4,2,6
PHI200807070,2008,80707,PHI,NYN,PHI13,10,9,19
PHI200807080,2008,80708,PHI,SLN,PHI13,2,0,2
PHI200807090,2008,80709,PHI,SLN,PHI13,2,4,6
PHI200807100,2008,80710,PHI,SLN,PHI13,1,4,5
PHI200807110,2008,80711,PHI,ARI,PHI13,5,6,11
PHI200807120,2008,80712,PHI,ARI,PHI13,10,4,14
PHI200807130,2008,80713,PHI,ARI,PHI13,3,6,9
PHI200807250,2008,80725,PHI,ATL,PHI13,8,2,10
PHI200807260,2008,80726,PHI,ATL,PHI13,9,10,19
PHI200807270,2008,80727,PHI,ATL,PHI13,10,12,22
PHI200808050,2008,80805,PHI,FLO,PHI13,8,2,10
PHI200808060,2008,80806,PHI,FLO,PHI13,0,5,5
PHI200808070,2008,80807,PHI,FLO,PHI13,3,0,3
PHI200808080,2008,80808,PHI,PIT,PHI13,2,0,2
PHI200808090,2008,80809,PHI,PIT,PHI13,2,4,6
PHI200808100,2008,80810,PHI,PIT,PHI13,3,6,9
PHI200808190,2008,80819,PHI,WAS,PHI13,4,5,9
PHI200808200,2008,80820,PHI,WAS,PHI13,0,4,4
PHI200808210,2008,80821,PHI,WAS,PHI13,4,3,7
PHI200808220,2008,80822,PHI,LAN,PHI13,1,8,9
PHI200808230,2008,80823,PHI,LAN,PHI13,2,9,11
PHI200808240,2008,80824,PHI,LAN,PHI13,2,5,7
PHI200808250,2008,80825,PHI,LAN,PHI13,0,5,5
PHI200808260,2008,80826,PHI,NYN,PHI13,7,8,15
PHI200808270,2008,80827,PHI,NYN,PHI13,6,3,9
PHI200809080,2008,80908,PHI,FLO,PHI13,6,8,14
PHI200809090,2008,80909,PHI,FLO,PHI13,10,8,18
PHI200809100,2008,80910,PHI,FLO,PHI13,7,3,10
PHI200809110,2008,80911,PHI,MIL,PHI13,3,6,9
PHI200809130,2008,80913,PHI,MIL,PHI13,3,7,10
PHI200809141,2008,80914,PHI,MIL,PHI13,3,7,10
PHI200809142,2008,80914,PHI,MIL,PHI13,1,6,7
PHI200809220,2008,80922,PHI,ATL,PHI13,2,6,8
PHI200809230,2008,80923,PHI,ATL,PHI13,3,2,5
PHI200809240,2008,80924,PHI,ATL,PHI13,10,4,14
PHI200809260,2008,80926,PHI,WAS,PHI13,4,8,12
PHI200809270,2008,80927,PHI,WAS,PHI13,3,4,7
PHI200809280,2008,80928,PHI,WAS,PHI13,3,8,11
PHI200810010,2008,81001,PHI,MIL,PHI13,1,3,4
PHI200810020,2008,81002,PHI,MIL,PHI13,2,5,7
PHI200810090,2008,81009,PHI,LAN,PHI13,2,3,5
PHI200810100,2008,81010,PHI,LAN,PHI13,5,8,13
PHI200810250,2008,81025,PHI,TBA,PHI13,4,5,9
PHI200810260,2008,81026,PHI,TBA,PHI13,2,10,12
PHI200810270,2008,81027,PHI,TBA,PHI13,3,4,7
PHI200904050,2009,90405,PHI,ATL,PHI13,4,1,5
PHI200904070,2009,90407,PHI,ATL,PHI13,4,0,4
PHI200904080,2009,90408,PHI,ATL,PHI13,11,12,23
PHI200904170,2009,90417,PHI,SDN,PHI13,8,7,15
PHI200904180,2009,90418,PHI,SDN,PHI13,8,5,13
PHI200904190,2009,90419,PHI,SDN,PHI13,4,5,9
PHI200904210,2009,90421,PHI,MIL,PHI13,4,11,15
PHI200904220,2009,90422,PHI,MIL,PHI13,3,1,4
PHI200904230,2009,90423,PHI,MIL,PHI13,6,1,7
PHI200904270,2009,90427,PHI,WAS,PHI13,11,13,24
PHI200904280,2009,90428,PHI,WAS,PHI13,1,7,8
PHI200904290,2009,90429,PHI,WAS,PHI13,4,1,5
PHI200905010,2009,90501,PHI,NYN,PHI13,7,4,11
PHI200905020,2009,90502,PHI,NYN,PHI13,5,6,11
PHI200905080,2009,90508,PHI,ATL,PHI13,6,10,16
PHI200905090,2009,90509,PHI,ATL,PHI13,6,2,8
PHI200905100,2009,90510,PHI,ATL,PHI13,4,2,6
PHI200905120,2009,90512,PHI,LAN,PHI13,3,5,8
PHI200905130,2009,90513,PHI,LAN,PHI13,9,2,11
PHI200905140,2009,90514,PHI,LAN,PHI13,5,3,8
PHI200905250,2009,90525,PHI,FLO,PHI13,5,3,8
PHI200905260,2009,90526,PHI,FLO,PHI13,3,5,8
PHI200905270,2009,90527,PHI,FLO,PHI13,6,2,8
PHI200905290,2009,90529,PHI,WAS,PHI13,4,5,9
PHI200905300,2009,90530,PHI,WAS,PHI13,6,9,15
PHI200905310,2009,90531,PHI,WAS,PHI13,2,4,6
PHI200906120,2009,90612,PHI,BOS,PHI13,5,2,7
PHI200906130,2009,90613,PHI,BOS,PHI13,11,6,17
PHI200906140,2009,90614,PHI,BOS,PHI13,6,11,17
PHI200906160,2009,90616,PHI,TOR,PHI13,8,3,11
PHI200906170,2009,90617,PHI,TOR,PHI13,7,1,8
PHI200906180,2009,90618,PHI,TOR,PHI13,8,7,15
PHI200906190,2009,90619,PHI,BAL,PHI13,7,2,9
PHI200906200,2009,90620,PHI,BAL,PHI13,6,5,11
PHI200906210,2009,90621,PHI,BAL,PHI13,2,1,3
PHI200907030,2009,90703,PHI,NYN,PHI13,2,7,9
PHI200907040,2009,90704,PHI,NYN,PHI13,1,4,5
PHI200907050,2009,90705,PHI,NYN,PHI13,0,2,2
PHI200907060,2009,90706,PHI,CIN,PHI13,1,22,23
PHI200907070,2009,90707,PHI,CIN,PHI13,4,3,7
PHI200907080,2009,90708,PHI,CIN,PHI13,2,3,5
PHI200907090,2009,90709,PHI,CIN,PHI13,6,9,15
PHI200907100,2009,90710,PHI,PIT,PHI13,2,3,5
PHI200907110,2009,90711,PHI,PIT,PHI13,7,8,15
PHI200907120,2009,90712,PHI,PIT,PHI13,2,5,7
PHI200907200,2009,90720,PHI,CHN,PHI13,1,10,11
PHI200907210,2009,90721,PHI,CHN,PHI13,1,4,5
PHI200907220,2009,90722,PHI,CHN,PHI13,10,5,15
PHI200907230,2009,90723,PHI,SDN,PHI13,4,9,13
PHI200907240,2009,90724,PHI,SLN,PHI13,8,1,9
PHI200907250,2009,90725,PHI,SLN,PHI13,6,14,20
PHI200907260,2009,90726,PHI,SLN,PHI13,2,9,11
PHI200908040,2009,90804,PHI,COL,PHI13,8,3,11
PHI200908050,2009,90805,PHI,COL,PHI13,0,7,7
PHI200908060,2009,90806,PHI,COL,PHI13,1,3,4
PHI200908070,2009,90807,PHI,FLO,PHI13,3,2,5
PHI200908080,2009,90808,PHI,FLO,PHI13,6,4,10
PHI200908090,2009,90809,PHI,FLO,PHI13,12,3,15
PHI200908180,2009,90818,PHI,ARI,PHI13,1,5,6
PHI200908190,2009,90819,PHI,ARI,PHI13,1,8,9
PHI200908200,2009,90820,PHI,ARI,PHI13,3,12,15
PHI200908280,2009,90828,PHI,ATL,PHI13,2,4,6
PHI200908290,2009,90829,PHI,ATL,PHI13,9,1,10
PHI200908300,2009,90830,PHI,ATL,PHI13,2,3,5
PHI200909010,2009,90901,PHI,SFN,PHI13,0,1,1
PHI200909020,2009,90902,PHI,SFN,PHI13,4,0,4
PHI200909030,2009,90903,PHI,SFN,PHI13,1,2,3
PHI200909110,2009,90911,PHI,NYN,PHI13,2,4,6
PHI200909120,2009,90912,PHI,NYN,PHI13,10,9,19
PHI200909131,2009,90913,PHI,NYN,PHI13,4,5,9
PHI200909132,2009,90913,PHI,NYN,PHI13,0,1,1
PHI200909150,2009,90915,PHI,WAS,PHI13,0,5,5
PHI200909160,2009,90916,PHI,WAS,PHI13,1,6,7
PHI200909170,2009,90917,PHI,WAS,PHI13,2,4,6
PHI200909280,2009,90928,PHI,HOU,PHI13,8,2,10
PHI200909290,2009,90929,PHI,HOU,PHI13,4,7,11
PHI200909300,2009,90930,PHI,HOU,PHI13,3,10,13
PHI200910010,2009,91001,PHI,HOU,PHI13,5,3,8
PHI200910020,2009,91002,PHI,FLO,PHI13,7,2,9
PHI200910030,2009,91003,PHI,FLO,PHI13,4,3,7
PHI200910040,2009,91004,PHI,FLO,PHI13,6,7,13
PHI200910070,2009,91007,PHI,COL,PHI13,1,5,6
PHI200910080,2009,91008,PHI,COL,PHI13,5,4,9
PHI200910180,2009,91018,PHI,LAN,PHI13,0,11,11
PHI200910190,2009,91019,PHI,LAN,PHI13,4,5,9
PHI200910210,2009,91021,PHI,LAN,PHI13,4,10,14
PHI200910310,2009,91031,PHI,NYA,PHI13,8,5,13
PHI200911010,2009,91101,PHI,NYA,PHI13,7,4,11
PHI200911020,2009,91102,PHI,NYA,PHI13,6,8,14
PIT200004040,2000,404,PIT,HOU,PIT07,5,2,7
PIT200004050,2000,405,PIT,HOU,PIT07,11,2,13
PIT200004060,2000,406,PIT,HOU,PIT07,1,10,11
PIT200004110,2000,411,PIT,MON,PIT07,7,3,10
PIT200004120,2000,412,PIT,MON,PIT07,4,6,10
PIT200004130,2000,413,PIT,MON,PIT07,3,4,7
PIT200004140,2000,414,PIT,NYN,PIT07,8,5,13
PIT200004150,2000,415,PIT,NYN,PIT07,0,2,2
PIT200004160,2000,416,PIT,NYN,PIT07,12,9,21
PIT200004250,2000,425,PIT,SDN,PIT07,3,4,7
PIT200004260,2000,426,PIT,SDN,PIT07,8,9,17
PIT200004270,2000,427,PIT,SDN,PIT07,12,4,16
PIT200004280,2000,428,PIT,CIN,PIT07,1,2,3
PIT200004290,2000,429,PIT,CIN,PIT07,6,5,11
PIT200004300,2000,430,PIT,CIN,PIT07,6,2,8
PIT200005090,2000,509,PIT,NYN,PIT07,2,0,2
PIT200005100,2000,510,PIT,NYN,PIT07,9,13,22
PIT200005110,2000,511,PIT,NYN,PIT07,3,2,5
PIT200005120,2000,512,PIT,MIL,PIT07,6,1,7
PIT200005130,2000,513,PIT,MIL,PIT07,8,11,19
PIT200005140,2000,514,PIT,MIL,PIT07,0,3,3
PIT200005190,2000,519,PIT,SLN,PIT07,1,13,14
PIT200005200,2000,520,PIT,SLN,PIT07,19,4,23
PIT200005210,2000,521,PIT,SLN,PIT07,7,5,12
PIT200005290,2000,529,PIT,FLO,PIT07,4,10,14
PIT200005300,2000,530,PIT,FLO,PIT07,2,3,5
PIT200005310,2000,531,PIT,FLO,PIT07,2,5,7
PIT200006020,2000,602,PIT,KCA,PIT07,3,9,12
PIT200006030,2000,603,PIT,KCA,PIT07,16,3,19
PIT200006040,2000,604,PIT,KCA,PIT07,7,5,12
PIT200006050,2000,605,PIT,DET,PIT07,1,5,6
PIT200006060,2000,606,PIT,DET,PIT07,2,1,3
PIT200006070,2000,607,PIT,DET,PIT07,3,4,7
PIT200006120,2000,612,PIT,ATL,PIT07,10,8,18
PIT200006130,2000,613,PIT,ATL,PIT07,6,7,13
PIT200006140,2000,614,PIT,ATL,PIT07,8,4,12
PIT200006150,2000,615,PIT,ATL,PIT07,0,2,2
PIT200006160,2000,616,PIT,FLO,PIT07,8,3,11
PIT200006170,2000,617,PIT,FLO,PIT07,4,3,7
PIT200006180,2000,618,PIT,FLO,PIT07,5,4,9
PIT200006270,2000,627,PIT,CHN,PIT07,0,6,6
PIT200006280,2000,628,PIT,CHN,PIT07,5,4,9
PIT200006290,2000,629,PIT,CHN,PIT07,4,5,9
PIT200007070,2000,707,PIT,MIN,PIT07,6,8,14
PIT200007080,2000,708,PIT,MIN,PIT07,1,4,5
PIT200007090,2000,709,PIT,MIN,PIT07,3,2,5
PIT200007210,2000,721,PIT,PHI,PIT07,2,9,11
PIT200007220,2000,722,PIT,PHI,PIT07,1,2,3
PIT200007230,2000,723,PIT,PHI,PIT07,4,1,5
PIT200007250,2000,725,PIT,MIL,PIT07,4,1,5
PIT200007260,2000,726,PIT,MIL,PIT07,4,5,9
PIT200007270,2000,727,PIT,MIL,PIT07,4,3,7
PIT200007280,2000,728,PIT,SDN,PIT07,5,16,21
PIT200007290,2000,729,PIT,SDN,PIT07,2,10,12
PIT200007300,2000,730,PIT,SDN,PIT07,9,8,17
PIT200008011,2000,801,PIT,LAN,PIT07,0,6,6
PIT200008012,2000,801,PIT,LAN,PIT07,5,3,8
PIT200008020,2000,802,PIT,LAN,PIT07,11,5,16
PIT200008110,2000,811,PIT,ARI,PIT07,6,1,7
PIT200008120,2000,812,PIT,ARI,PIT07,6,9,15
PIT200008130,2000,813,PIT,ARI,PIT07,7,6,13
PIT200008250,2000,825,PIT,COL,PIT07,6,3,9
PIT200008260,2000,826,PIT,COL,PIT07,11,4,15
PIT200008270,2000,827,PIT,COL,PIT07,9,2,11
PIT200008280,2000,828,PIT,SFN,PIT07,5,4,9
PIT200008290,2000,829,PIT,SFN,PIT07,0,8,8
PIT200008300,2000,830,PIT,SFN,PIT07,2,0,2
PIT200008310,2000,831,PIT,SFN,PIT07,10,2,12
PIT200009081,2000,908,PIT,CIN,PIT07,3,7,10
PIT200009082,2000,908,PIT,CIN,PIT07,1,3,4
PIT200009090,2000,909,PIT,CIN,PIT07,6,4,10
PIT200009100,2000,910,PIT,CIN,PIT07,6,4,10
PIT200009110,2000,911,PIT,SLN,PIT07,8,4,12
PIT200009120,2000,912,PIT,SLN,PIT07,11,1,12
PIT200009130,2000,913,PIT,SLN,PIT07,9,5,14
PIT200009260,2000,926,PIT,HOU,PIT07,4,9,13
PIT200009270,2000,927,PIT,HOU,PIT07,10,1,11
PIT200009280,2000,928,PIT,HOU,PIT07,2,3,5
PIT200009290,2000,929,PIT,CHN,PIT07,4,8,12
PIT200009300,2000,930,PIT,CHN,PIT07,2,4,6
PIT200010010,2000,1001,PIT,CHN,PIT07,10,9,19
PIT200104090,2001,10409,PIT,CIN,PIT08,8,2,10
PIT200104110,2001,10411,PIT,CIN,PIT08,5,6,11
PIT200104120,2001,10412,PIT,CIN,PIT08,11,6,17
PIT200104160,2001,10416,PIT,HOU,PIT08,0,3,3
PIT200104180,2001,10418,PIT,HOU,PIT08,4,8,12
PIT200104200,2001,10420,PIT,CHN,PIT08,8,2,10
PIT200104210,2001,10421,PIT,CHN,PIT08,4,3,7
PIT200104220,2001,10422,PIT,CHN,PIT08,3,4,7
PIT200105010,2001,10501,PIT,SFN,PIT08,11,6,17
PIT200105020,2001,10502,PIT,SFN,PIT08,7,6,13
PIT200105030,2001,10503,PIT,SFN,PIT08,3,4,7
PIT200105040,2001,10504,PIT,COL,PIT08,9,3,12
PIT200105050,2001,10505,PIT,COL,PIT08,3,11,14
PIT200105060,2001,10506,PIT,COL,PIT08,3,4,7
PIT200105150,2001,10515,PIT,SLN,PIT08,8,3,11
PIT200105160,2001,10516,PIT,SLN,PIT08,3,0,3
PIT200105170,2001,10517,PIT,SLN,PIT08,12,2,14
PIT200105190,2001,10519,PIT,MIL,PIT08,1,6,7
PIT200105200,2001,10520,PIT,MIL,PIT08,7,8,15
PIT200105280,2001,10528,PIT,FLO,PIT08,5,8,13
PIT200105290,2001,10529,PIT,FLO,PIT08,5,0,5
PIT200105300,2001,10530,PIT,FLO,PIT08,9,7,16
PIT200106010,2001,10601,PIT,ATL,PIT08,5,1,6
PIT200106031,2001,10603,PIT,ATL,PIT08,11,7,18
PIT200106032,2001,10603,PIT,ATL,PIT08,8,3,11
PIT200106150,2001,10615,PIT,CLE,PIT08,3,6,9
PIT200106160,2001,10616,PIT,CLE,PIT08,4,6,10
PIT200106170,2001,10617,PIT,CLE,PIT08,0,1,1
PIT200106190,2001,10619,PIT,PHI,PIT08,5,8,13
PIT200106200,2001,10620,PIT,PHI,PIT08,9,5,14
PIT200106210,2001,10621,PIT,PHI,PIT08,6,3,9
PIT200106220,2001,10622,PIT,MON,PIT08,11,5,16
PIT200106230,2001,10623,PIT,MON,PIT08,4,7,11
PIT200106240,2001,10624,PIT,MON,PIT08,11,4,15
PIT200106250,2001,10625,PIT,MIL,PIT08,4,6,10
PIT200106260,2001,10626,PIT,MIL,PIT08,6,7,13
PIT200106270,2001,10627,PIT,MIL,PIT08,2,6,8
PIT200106280,2001,10628,PIT,MIL,PIT08,0,1,1
PIT200107120,2001,10712,PIT,KCA,PIT08,0,2,2
PIT200107130,2001,10713,PIT,KCA,PIT08,0,1,1
PIT200107140,2001,10714,PIT,KCA,PIT08,7,4,11
PIT200107150,2001,10715,PIT,LAN,PIT08,4,2,6
PIT200107160,2001,10716,PIT,LAN,PIT08,6,4,10
PIT200107170,2001,10717,PIT,LAN,PIT08,4,1,5
PIT200107180,2001,10718,PIT,CHN,PIT08,6,5,11
PIT200107190,2001,10719,PIT,CHN,PIT08,2,3,5
PIT200107260,2001,10726,PIT,HOU,PIT08,3,2,5
PIT200107270,2001,10727,PIT,HOU,PIT08,2,3,5
PIT200107281,2001,10728,PIT,HOU,PIT08,8,9,17
PIT200107282,2001,10728,PIT,HOU,PIT08,12,3,15
PIT200107290,2001,10729,PIT,HOU,PIT08,1,4,5
PIT200108070,2001,10807,PIT,LAN,PIT08,2,1,3
PIT200108080,2001,10808,PIT,LAN,PIT08,9,4,13
PIT200108090,2001,10809,PIT,LAN,PIT08,5,8,13
PIT200108100,2001,10810,PIT,SDN,PIT08,3,2,5
PIT200108110,2001,10811,PIT,SDN,PIT08,6,2,8
PIT200108120,2001,10812,PIT,SDN,PIT08,6,7,13
PIT200108210,2001,10821,PIT,ARI,PIT08,2,4,6
PIT200108220,2001,10822,PIT,ARI,PIT08,6,0,6
PIT200108230,2001,10823,PIT,ARI,PIT08,1,5,6
PIT200108240,2001,10824,PIT,HOU,PIT08,5,1,6
PIT200108250,2001,10825,PIT,HOU,PIT08,2,8,10
PIT200108260,2001,10826,PIT,HOU,PIT08,3,1,4
PIT200109031,2001,10903,PIT,MIL,PIT08,12,7,19
PIT200109032,2001,10903,PIT,MIL,PIT08,2,3,5
PIT200109040,2001,10904,PIT,MIL,PIT08,2,5,7
PIT200109050,2001,10905,PIT,MIL,PIT08,1,5,6
PIT200109060,2001,10906,PIT,CIN,PIT08,8,6,14
PIT200109070,2001,10907,PIT,CIN,PIT08,1,3,4
PIT200109080,2001,10908,PIT,CIN,PIT08,2,5,7
PIT200109090,2001,10909,PIT,CIN,PIT08,5,3,8
PIT200109170,2001,10917,PIT,NYN,PIT08,4,1,5
PIT200109180,2001,10918,PIT,NYN,PIT08,7,5,12
PIT200109190,2001,10919,PIT,NYN,PIT08,9,2,11
PIT200109200,2001,10920,PIT,SLN,PIT08,9,1,10
PIT200109210,2001,10921,PIT,SLN,PIT08,9,5,14
PIT200109220,2001,10922,PIT,SLN,PIT08,4,1,5
PIT200109230,2001,10923,PIT,SLN,PIT08,1,2,3
PIT200109240,2001,10924,PIT,CHN,PIT08,6,7,13
PIT200109250,2001,10925,PIT,CHN,PIT08,1,13,14
PIT200109260,2001,10926,PIT,CHN,PIT08,8,4,12
PIT200204080,2002,20408,PIT,CIN,PIT08,0,1,1
PIT200204100,2002,20410,PIT,CIN,PIT08,8,5,13
PIT200204110,2002,20411,PIT,CIN,PIT08,3,2,5
PIT200204120,2002,20412,PIT,CHN,PIT08,7,3,10
PIT200204130,2002,20413,PIT,CHN,PIT08,2,3,5
PIT200204140,2002,20414,PIT,CHN,PIT08,5,1,6
PIT200204190,2002,20419,PIT,PHI,PIT08,4,7,11
PIT200204200,2002,20420,PIT,PHI,PIT08,5,6,11
PIT200204210,2002,20421,PIT,PHI,PIT08,3,9,12
PIT200204230,2002,20423,PIT,LAN,PIT08,9,6,15
PIT200204240,2002,20424,PIT,LAN,PIT08,5,1,6
PIT200204250,2002,20425,PIT,LAN,PIT08,2,3,5
PIT200204260,2002,20426,PIT,SDN,PIT08,10,1,11
PIT200204281,2002,20428,PIT,SDN,PIT08,2,3,5
PIT200204282,2002,20428,PIT,SDN,PIT08,7,2,9
PIT200205100,2002,20510,PIT,HOU,PIT08,1,5,6
PIT200205110,2002,20511,PIT,HOU,PIT08,2,4,6
PIT200205120,2002,20512,PIT,HOU,PIT08,5,1,6
PIT200205130,2002,20513,PIT,ARI,PIT08,11,0,11
PIT200205140,2002,20514,PIT,ARI,PIT08,1,2,3
PIT200205150,2002,20515,PIT,ARI,PIT08,6,2,8
PIT200205240,2002,20524,PIT,SLN,PIT08,2,5,7
PIT200205250,2002,20525,PIT,SLN,PIT08,6,3,9
PIT200205260,2002,20526,PIT,SLN,PIT08,7,3,10
PIT200205270,2002,20527,PIT,CHN,PIT08,2,3,5
PIT200205280,2002,20528,PIT,CHN,PIT08,3,0,3
PIT200205290,2002,20529,PIT,CHN,PIT08,0,5,5
PIT200205300,2002,20530,PIT,CHN,PIT08,9,8,17
PIT200206070,2002,20607,PIT,MIL,PIT08,1,6,7
PIT200206080,2002,20608,PIT,MIL,PIT08,8,9,17
PIT200206090,2002,20609,PIT,MIL,PIT08,4,5,9
PIT200206180,2002,20618,PIT,OAK,PIT08,4,2,6
PIT200206190,2002,20619,PIT,OAK,PIT08,3,2,5
PIT200206200,2002,20620,PIT,OAK,PIT08,5,3,8
PIT200206210,2002,20621,PIT,TEX,PIT08,2,0,2
PIT200206220,2002,20622,PIT,TEX,PIT08,3,2,5
PIT200206230,2002,20623,PIT,TEX,PIT08,10,4,14
PIT200206250,2002,20625,PIT,MON,PIT08,1,4,5
PIT200206260,2002,20626,PIT,MON,PIT08,4,7,11
PIT200206270,2002,20627,PIT,MON,PIT08,7,2,9
PIT200207010,2002,20701,PIT,MIL,PIT08,2,0,2
PIT200207020,2002,20702,PIT,MIL,PIT08,12,6,18
PIT200207030,2002,20703,PIT,MIL,PIT08,1,3,4
PIT200207040,2002,20704,PIT,HOU,PIT08,8,6,14
PIT200207050,2002,20705,PIT,HOU,PIT08,3,4,7
PIT200207060,2002,20706,PIT,HOU,PIT08,10,2,12
PIT200207070,2002,20707,PIT,HOU,PIT08,6,1,7
PIT200207170,2002,20717,PIT,CIN,PIT08,3,6,9
PIT200207180,2002,20718,PIT,CIN,PIT08,7,5,12
PIT200207190,2002,20719,PIT,SLN,PIT08,9,12,21
PIT200207200,2002,20720,PIT,SLN,PIT08,6,15,21
PIT200207210,2002,20721,PIT,SLN,PIT08,8,4,12
PIT200207300,2002,20730,PIT,COL,PIT08,1,4,5
PIT200207310,2002,20731,PIT,COL,PIT08,6,7,13
PIT200208010,2002,20801,PIT,COL,PIT08,3,0,3
PIT200208020,2002,20802,PIT,SFN,PIT08,5,6,11
PIT200208030,2002,20803,PIT,SFN,PIT08,11,6,17
PIT200208040,2002,20804,PIT,SFN,PIT08,10,5,15
PIT200208120,2002,20812,PIT,SLN,PIT08,10,6,16
PIT200208130,2002,20813,PIT,SLN,PIT08,9,5,14
PIT200208140,2002,20814,PIT,SLN,PIT08,7,3,10
PIT200208150,2002,20815,PIT,SLN,PIT08,11,5,16
PIT200208160,2002,20816,PIT,MIL,PIT08,10,3,13
PIT200208170,2002,20817,PIT,MIL,PIT08,0,5,5
PIT200208180,2002,20818,PIT,MIL,PIT08,2,3,5
PIT200208270,2002,20827,PIT,ATL,PIT08,5,4,9
PIT200208280,2002,20828,PIT,ATL,PIT08,0,1,1
PIT200208290,2002,20829,PIT,ATL,PIT08,1,4,5
PIT200209060,2002,20906,PIT,FLO,PIT08,0,11,11
PIT200209070,2002,20907,PIT,FLO,PIT08,1,4,5
PIT200209080,2002,20908,PIT,FLO,PIT08,11,1,12
PIT200209160,2002,20916,PIT,CIN,PIT08,4,3,7
PIT200209170,2002,20917,PIT,CIN,PIT08,3,11,14
PIT200209180,2002,20918,PIT,CIN,PIT08,2,3,5
PIT200209190,2002,20919,PIT,CIN,PIT08,5,4,9
PIT200209200,2002,20920,PIT,CHN,PIT08,4,5,9
PIT200209210,2002,20921,PIT,CHN,PIT08,4,2,6
PIT200209220,2002,20922,PIT,CHN,PIT08,4,5,9
PIT200209240,2002,20924,PIT,NYN,PIT08,3,6,9
PIT200209250,2002,20925,PIT,NYN,PIT08,3,4,7
PIT200304080,2003,30408,PIT,MIL,PIT08,5,3,8
PIT200304090,2003,30409,PIT,MIL,PIT08,3,2,5
PIT200304100,2003,30410,PIT,MIL,PIT08,1,3,4
PIT200304150,2003,30415,PIT,NYN,PIT08,3,1,4
PIT200304160,2003,30416,PIT,NYN,PIT08,3,6,9
PIT200304170,2003,30417,PIT,NYN,PIT08,7,2,9
PIT200304180,2003,30418,PIT,CHN,PIT08,7,2,9
PIT200304190,2003,30419,PIT,CHN,PIT08,6,1,7
PIT200304200,2003,30420,PIT,CHN,PIT08,2,8,10
PIT200304220,2003,30422,PIT,SFN,PIT08,2,5,7
PIT200304230,2003,30423,PIT,SFN,PIT08,4,3,7
PIT200304240,2003,30424,PIT,SFN,PIT08,3,1,4
PIT200304250,2003,30425,PIT,LAN,PIT08,5,2,7
PIT200304260,2003,30426,PIT,LAN,PIT08,4,3,7
PIT200304270,2003,30427,PIT,LAN,PIT08,6,2,8
PIT200305090,2003,30509,PIT,ARI,PIT08,5,0,5
PIT200305100,2003,30510,PIT,ARI,PIT08,4,5,9
PIT200305110,2003,30511,PIT,ARI,PIT08,2,1,3
PIT200305120,2003,30512,PIT,HOU,PIT08,9,4,13
PIT200305130,2003,30513,PIT,HOU,PIT08,6,3,9
PIT200305140,2003,30514,PIT,HOU,PIT08,2,3,5
PIT200305150,2003,30515,PIT,HOU,PIT08,6,2,8
PIT200305210,2003,30521,PIT,CHN,PIT08,2,5,7
PIT200305220,2003,30522,PIT,CHN,PIT08,3,2,5
PIT200305230,2003,30523,PIT,SLN,PIT08,10,8,18
PIT200305240,2003,30524,PIT,SLN,PIT08,6,0,6
PIT200305250,2003,30525,PIT,SLN,PIT08,7,8,15
PIT200306041,2003,30604,PIT,BOS,PIT08,11,4,15
PIT200306042,2003,30604,PIT,BOS,PIT08,8,3,11
PIT200306050,2003,30605,PIT,BOS,PIT08,4,5,9
PIT200306181,2003,30618,PIT,MON,PIT08,3,7,10
PIT200306182,2003,30618,PIT,MON,PIT08,3,4,7
PIT200306190,2003,30619,PIT,MON,PIT08,5,2,7
PIT200306200,2003,30620,PIT,CLE,PIT08,4,5,9
PIT200306210,2003,30621,PIT,CLE,PIT08,6,7,13
PIT200306220,2003,30622,PIT,CLE,PIT08,8,5,13
PIT200306270,2003,30627,PIT,COL,PIT08,3,5,8
PIT200306280,2003,30628,PIT,COL,PIT08,5,4,9
PIT200306290,2003,30629,PIT,COL,PIT08,0,9,9
PIT200307010,2003,30701,PIT,CIN,PIT08,5,3,8
PIT200307020,2003,30702,PIT,CIN,PIT08,4,3,7
PIT200307030,2003,30703,PIT,CIN,PIT08,7,8,15
PIT200307040,2003,30704,PIT,HOU,PIT08,2,3,5
PIT200307050,2003,30705,PIT,HOU,PIT08,3,4,7
PIT200307060,2003,30706,PIT,HOU,PIT08,3,8,11
PIT200307170,2003,30717,PIT,MIL,PIT08,7,5,12
PIT200307180,2003,30718,PIT,MIL,PIT08,2,7,9
PIT200307190,2003,30719,PIT,MIL,PIT08,1,0,1
PIT200307200,2003,30720,PIT,MIL,PIT08,3,6,9
PIT200307210,2003,30721,PIT,HOU,PIT08,3,5,8
PIT200307220,2003,30722,PIT,HOU,PIT08,2,0,2
PIT200307290,2003,30729,PIT,SDN,PIT08,8,7,15
PIT200307300,2003,30730,PIT,SDN,PIT08,2,7,9
PIT200307310,2003,30731,PIT,SDN,PIT08,10,7,17
PIT200308010,2003,30801,PIT,COL,PIT08,11,12,23
PIT200308020,2003,30802,PIT,COL,PIT08,0,1,1
PIT200308030,2003,30803,PIT,COL,PIT08,16,4,20
PIT200308110,2003,30811,PIT,SLN,PIT08,6,4,10
PIT200308120,2003,30812,PIT,SLN,PIT08,10,6,16
PIT200308130,2003,30813,PIT,SLN,PIT08,5,6,11
PIT200308140,2003,30814,PIT,SLN,PIT08,4,3,7
PIT200308150,2003,30815,PIT,MIL,PIT08,3,6,9
PIT200308160,2003,30816,PIT,MIL,PIT08,6,4,10
PIT200308170,2003,30817,PIT,MIL,PIT08,2,5,7
PIT200308260,2003,30826,PIT,FLO,PIT08,3,4,7
PIT200308270,2003,30827,PIT,FLO,PIT08,0,4,4
PIT200308280,2003,30828,PIT,FLO,PIT08,0,5,5
PIT200308290,2003,30829,PIT,ATL,PIT08,5,6,11
PIT200308300,2003,30830,PIT,ATL,PIT08,13,6,19
PIT200308310,2003,30831,PIT,ATL,PIT08,10,4,14
PIT200309120,2003,30912,PIT,PHI,PIT08,4,8,12
PIT200309130,2003,30913,PIT,PHI,PIT08,3,5,8
PIT200309140,2003,30914,PIT,PHI,PIT08,10,7,17
PIT200309150,2003,30915,PIT,CIN,PIT08,3,6,9
PIT200309160,2003,30916,PIT,CIN,PIT08,12,4,16
PIT200309170,2003,30917,PIT,CIN,PIT08,5,8,13
PIT200309180,2003,30918,PIT,CIN,PIT08,0,7,7
PIT200309191,2003,30919,PIT,CHN,PIT08,10,9,19
PIT200309192,2003,30919,PIT,CHN,PIT08,6,10,16
PIT200309200,2003,30920,PIT,CHN,PIT08,2,8,10
PIT200309210,2003,30921,PIT,CHN,PIT08,4,1,5
PIT200404050,2004,40405,PIT,PHI,PIT08,1,2,3
PIT200404070,2004,40407,PIT,PHI,PIT08,5,4,9
PIT200404080,2004,40408,PIT,PHI,PIT08,2,6,8
PIT200404200,2004,40420,PIT,CHN,PIT08,9,1,10
PIT200404210,2004,40421,PIT,CHN,PIT08,12,1,13
PIT200404230,2004,40423,PIT,CIN,PIT08,6,4,10
PIT200404240,2004,40424,PIT,CIN,PIT08,9,7,16
PIT200404250,2004,40425,PIT,CIN,PIT08,0,6,6
PIT200404260,2004,40426,PIT,CIN,PIT08,5,2,7
PIT200404280,2004,40428,PIT,HOU,PIT08,2,4,6
PIT200404290,2004,40429,PIT,HOU,PIT08,2,0,2
PIT200405070,2004,40507,PIT,LAN,PIT08,4,0,4
PIT200405080,2004,40508,PIT,LAN,PIT08,4,3,7
PIT200405090,2004,40509,PIT,LAN,PIT08,9,7,16
PIT200405191,2004,40519,PIT,SDN,PIT08,6,3,9
PIT200405192,2004,40519,PIT,SDN,PIT08,7,3,10
PIT200405200,2004,40520,PIT,SDN,PIT08,7,9,16
PIT200405220,2004,40522,PIT,MIL,PIT08,1,3,4
PIT200405230,2004,40523,PIT,MIL,PIT08,2,1,3
PIT200405281,2004,40528,PIT,CHN,PIT08,5,9,14
PIT200405282,2004,40528,PIT,CHN,PIT08,4,5,9
PIT200405290,2004,40529,PIT,CHN,PIT08,7,10,17
PIT200405300,2004,40530,PIT,CHN,PIT08,12,1,13
PIT200405310,2004,40531,PIT,SLN,PIT08,8,3,11
PIT200406010,2004,40601,PIT,SLN,PIT08,8,1,9
PIT200406020,2004,40602,PIT,SLN,PIT08,5,3,8
PIT200406030,2004,40603,PIT,SLN,PIT08,4,2,6
PIT200406150,2004,40615,PIT,ANA,PIT08,4,2,6
PIT200406160,2004,40616,PIT,ANA,PIT08,3,5,8
PIT200406170,2004,40617,PIT,ANA,PIT08,2,5,7
PIT200406180,2004,40618,PIT,SEA,PIT08,5,4,9
PIT200406190,2004,40619,PIT,SEA,PIT08,5,1,6
PIT200406200,2004,40620,PIT,SEA,PIT08,5,4,9
PIT200406280,2004,40628,PIT,SLN,PIT08,1,2,3
PIT200406290,2004,40629,PIT,SLN,PIT08,0,3,3
PIT200406300,2004,40630,PIT,SLN,PIT08,5,6,11
PIT200407021,2004,40702,PIT,MIL,PIT08,1,8,9
PIT200407022,2004,40702,PIT,MIL,PIT08,2,13,15
PIT200407030,2004,40703,PIT,MIL,PIT08,3,5,8
PIT200407040,2004,40704,PIT,MIL,PIT08,2,6,8
PIT200407160,2004,40716,PIT,FLO,PIT08,2,6,8
PIT200407170,2004,40717,PIT,FLO,PIT08,2,4,6
PIT200407180,2004,40718,PIT,FLO,PIT08,2,4,6
PIT200407190,2004,40719,PIT,MON,PIT08,6,2,8
PIT200407200,2004,40720,PIT,MON,PIT08,1,2,3
PIT200407230,2004,40723,PIT,CIN,PIT08,3,6,9
PIT200407240,2004,40724,PIT,CIN,PIT08,4,14,18
PIT200407250,2004,40725,PIT,CIN,PIT08,5,6,11
PIT200407260,2004,40726,PIT,ATL,PIT08,4,2,6
PIT200407270,2004,40727,PIT,ATL,PIT08,4,8,12
PIT200407280,2004,40728,PIT,ATL,PIT08,1,0,1
PIT200407290,2004,40729,PIT,ATL,PIT08,3,2,5
PIT200408100,2004,40810,PIT,SFN,PIT08,7,8,15
PIT200408110,2004,40811,PIT,SFN,PIT08,6,8,14
PIT200408120,2004,40812,PIT,SFN,PIT08,7,0,7
PIT200408130,2004,40813,PIT,COL,PIT08,9,3,12
PIT200408140,2004,40814,PIT,COL,PIT08,1,6,7
PIT200408150,2004,40815,PIT,COL,PIT08,0,3,3
PIT200408230,2004,40823,PIT,ARI,PIT08,5,4,9
PIT200408240,2004,40824,PIT,ARI,PIT08,1,3,4
PIT200408250,2004,40825,PIT,ARI,PIT08,1,2,3
PIT200408270,2004,40827,PIT,SLN,PIT08,8,5,13
PIT200408280,2004,40828,PIT,SLN,PIT08,6,4,10
PIT200408290,2004,40829,PIT,SLN,PIT08,4,0,4
PIT200409060,2004,40906,PIT,MIL,PIT08,9,5,14
PIT200409070,2004,40907,PIT,MIL,PIT08,0,2,2
PIT200409091,2004,40909,PIT,HOU,PIT08,1,3,4
PIT200409092,2004,40909,PIT,HOU,PIT08,9,2,11
PIT200409100,2004,40910,PIT,HOU,PIT08,1,6,7
PIT200409110,2004,40911,PIT,HOU,PIT08,2,5,7
PIT200409120,2004,40912,PIT,HOU,PIT08,5,4,9
PIT200409180,2004,40918,PIT,NYN,PIT08,8,7,15
PIT200409191,2004,40919,PIT,NYN,PIT08,0,1,1
PIT200409192,2004,40919,PIT,NYN,PIT08,1,6,7
PIT200409210,2004,40921,PIT,CHN,PIT08,5,4,9
PIT200409220,2004,40922,PIT,CHN,PIT08,1,0,1
PIT200409230,2004,40923,PIT,CHN,PIT08,6,3,9
PIT200409240,2004,40924,PIT,CIN,PIT08,14,8,22
PIT200409250,2004,40925,PIT,CIN,PIT08,7,4,11
PIT200409260,2004,40926,PIT,CIN,PIT08,2,4,6
PIT200504040,2005,50404,PIT,MIL,PIT08,9,2,11
PIT200504060,2005,50406,PIT,MIL,PIT08,10,2,12
PIT200504150,2005,50415,PIT,CHN,PIT08,5,8,13
PIT200504160,2005,50416,PIT,CHN,PIT08,4,3,7
PIT200504170,2005,50417,PIT,CHN,PIT08,4,2,6
PIT200504180,2005,50418,PIT,SLN,PIT08,11,1,12
PIT200504190,2005,50419,PIT,SLN,PIT08,7,1,8
PIT200504250,2005,50425,PIT,HOU,PIT08,0,2,2
PIT200504270,2005,50427,PIT,HOU,PIT08,0,2,2
PIT200504290,2005,50429,PIT,SFN,PIT08,3,2,5
PIT200504300,2005,50430,PIT,SFN,PIT08,7,6,13
PIT200505010,2005,50501,PIT,SFN,PIT08,8,3,11
PIT200505130,2005,50513,PIT,MIL,PIT08,4,3,7
PIT200505140,2005,50514,PIT,MIL,PIT08,0,2,2
PIT200505150,2005,50515,PIT,MIL,PIT08,2,4,6
PIT200505170,2005,50517,PIT,CHN,PIT08,4,3,7
PIT200505180,2005,50518,PIT,CHN,PIT08,3,2,5
PIT200505200,2005,50520,PIT,COL,PIT08,4,9,13
PIT200505210,2005,50521,PIT,COL,PIT08,3,8,11
PIT200505220,2005,50522,PIT,COL,PIT08,4,3,7
PIT200505300,2005,50530,PIT,FLO,PIT08,2,3,5
PIT200505310,2005,50531,PIT,FLO,PIT08,4,5,9
PIT200506010,2005,50601,PIT,FLO,PIT08,1,9,10
PIT200506020,2005,50602,PIT,FLO,PIT08,6,3,9
PIT200506030,2005,50603,PIT,ATL,PIT08,1,3,4
PIT200506040,2005,50604,PIT,ATL,PIT08,1,0,1
PIT200506050,2005,50605,PIT,ATL,PIT08,2,5,7
PIT200506060,2005,50606,PIT,BAL,PIT08,4,3,7
PIT200506070,2005,50607,PIT,BAL,PIT08,5,6,11
PIT200506080,2005,50608,PIT,BAL,PIT08,1,6,7
PIT200506100,2005,50610,PIT,TBA,PIT08,2,7,9
PIT200506110,2005,50611,PIT,TBA,PIT08,2,18,20
PIT200506120,2005,50612,PIT,TBA,PIT08,7,5,12
PIT200506200,2005,50620,PIT,WAS,PIT08,7,4,11
PIT200506210,2005,50621,PIT,WAS,PIT08,4,11,15
PIT200506220,2005,50622,PIT,WAS,PIT08,5,4,9
PIT200507040,2005,50704,PIT,PHI,PIT08,12,1,13
PIT200507050,2005,50705,PIT,PHI,PIT08,0,3,3
PIT200507060,2005,50706,PIT,PHI,PIT08,5,0,5
PIT200507070,2005,50707,PIT,PHI,PIT08,1,2,3
PIT200507080,2005,50708,PIT,NYN,PIT08,5,6,11
PIT200507090,2005,50709,PIT,NYN,PIT08,4,11,15
PIT200507100,2005,50710,PIT,NYN,PIT08,6,1,7
PIT200507180,2005,50718,PIT,HOU,PIT08,11,1,12
PIT200507191,2005,50719,PIT,HOU,PIT08,9,3,12
PIT200507192,2005,50719,PIT,HOU,PIT08,6,4,10
PIT200507200,2005,50720,PIT,HOU,PIT08,8,0,8
PIT200507210,2005,50721,PIT,COL,PIT08,1,8,9
PIT200507220,2005,50722,PIT,COL,PIT08,5,3,8
PIT200507230,2005,50723,PIT,COL,PIT08,3,5,8
PIT200507240,2005,50724,PIT,COL,PIT08,0,3,3
PIT200508020,2005,50802,PIT,SDN,PIT08,11,3,14
PIT200508030,2005,50803,PIT,SDN,PIT08,8,9,17
PIT200508040,2005,50804,PIT,SDN,PIT08,12,7,19
PIT200508050,2005,50805,PIT,LAN,PIT08,12,6,18
PIT200508060,2005,50806,PIT,LAN,PIT08,4,9,13
PIT200508070,2005,50807,PIT,LAN,PIT08,6,4,10
PIT200508220,2005,50822,PIT,SLN,PIT08,3,1,4
PIT200508230,2005,50823,PIT,SLN,PIT08,0,10,10
PIT200508240,2005,50824,PIT,SLN,PIT08,8,3,11
PIT200508250,2005,50825,PIT,SLN,PIT08,6,3,9
PIT200508260,2005,50826,PIT,CIN,PIT08,6,1,7
PIT200508270,2005,50827,PIT,CIN,PIT08,4,2,6
PIT200508280,2005,50828,PIT,CIN,PIT08,7,2,9
PIT200509020,2005,50902,PIT,CHN,PIT08,7,3,10
PIT200509030,2005,50903,PIT,CHN,PIT08,9,5,14
PIT200509040,2005,50904,PIT,CHN,PIT08,2,0,2
PIT200509060,2005,50906,PIT,ARI,PIT08,4,2,6
PIT200509070,2005,50907,PIT,ARI,PIT08,4,2,6
PIT200509080,2005,50908,PIT,ARI,PIT08,7,8,15
PIT200509161,2005,50916,PIT,CIN,PIT08,8,2,10
PIT200509162,2005,50916,PIT,CIN,PIT08,4,5,9
PIT200509170,2005,50917,PIT,CIN,PIT08,0,4,4
PIT200509180,2005,50918,PIT,CIN,PIT08,7,9,16
PIT200509190,2005,50919,PIT,HOU,PIT08,0,7,7
PIT200509200,2005,50920,PIT,HOU,PIT08,7,4,11
PIT200509210,2005,50921,PIT,HOU,PIT08,12,8,20
PIT200509220,2005,50922,PIT,HOU,PIT08,2,1,3
PIT200509300,2005,50930,PIT,MIL,PIT08,6,5,11
PIT200510010,2005,51001,PIT,MIL,PIT08,1,5,6
PIT200510020,2005,51002,PIT,MIL,PIT08,1,3,4
PIT200604100,2006,60410,PIT,LAN,PIT08,8,3,11
PIT200604110,2006,60411,PIT,LAN,PIT08,6,7,13
PIT200604120,2006,60412,PIT,LAN,PIT08,5,9,14
PIT200604130,2006,60413,PIT,LAN,PIT08,13,5,18
PIT200604140,2006,60414,PIT,CHN,PIT08,11,6,17
PIT200604150,2006,60415,PIT,CHN,PIT08,1,2,3
PIT200604160,2006,60416,PIT,CHN,PIT08,7,3,10
PIT200604170,2006,60417,PIT,SLN,PIT08,2,1,3
PIT200604180,2006,60418,PIT,SLN,PIT08,4,12,16
PIT200604190,2006,60419,PIT,SLN,PIT08,4,0,4
PIT200604280,2006,60428,PIT,PHI,PIT08,1,3,4
PIT200604290,2006,60429,PIT,PHI,PIT08,2,3,5
PIT200604300,2006,60430,PIT,PHI,PIT08,5,1,6
PIT200605090,2006,60509,PIT,ARI,PIT08,0,3,3
PIT200605100,2006,60510,PIT,ARI,PIT08,7,4,11
PIT200605120,2006,60512,PIT,FLO,PIT08,9,12,21
PIT200605130,2006,60513,PIT,FLO,PIT08,4,3,7
PIT200605140,2006,60514,PIT,FLO,PIT08,8,2,10
PIT200605160,2006,60516,PIT,CIN,PIT08,3,9,12
PIT200605170,2006,60517,PIT,CIN,PIT08,2,7,9
PIT200605180,2006,60518,PIT,CIN,PIT08,9,8,17
PIT200605260,2006,60526,PIT,HOU,PIT08,5,12,17
PIT200605270,2006,60527,PIT,HOU,PIT08,7,8,15
PIT200605280,2006,60528,PIT,HOU,PIT08,5,4,9
PIT200605290,2006,60529,PIT,MIL,PIT08,3,14,17
PIT200605300,2006,60530,PIT,MIL,PIT08,1,12,13
PIT200605310,2006,60531,PIT,MIL,PIT08,1,6,7
PIT200606010,2006,60601,PIT,MIL,PIT08,3,4,7
PIT200606020,2006,60602,PIT,SDN,PIT08,7,0,7
PIT200606030,2006,60603,PIT,SDN,PIT08,4,6,10
PIT200606040,2006,60604,PIT,SDN,PIT08,1,0,1
PIT200606130,2006,60613,PIT,SLN,PIT08,2,1,3
PIT200606140,2006,60614,PIT,SLN,PIT08,7,9,16
PIT200606150,2006,60615,PIT,SLN,PIT08,6,5,11
PIT200606160,2006,60616,PIT,MIN,PIT08,4,2,6
PIT200606170,2006,60617,PIT,MIN,PIT08,5,3,8
PIT200606180,2006,60618,PIT,MIN,PIT08,8,2,10
PIT200606190,2006,60619,PIT,ARI,PIT08,5,4,9
PIT200606270,2006,60627,PIT,CHA,PIT08,4,2,6
PIT200606280,2006,60628,PIT,CHA,PIT08,4,3,7
PIT200606290,2006,60629,PIT,CHA,PIT08,6,7,13
PIT200606300,2006,60630,PIT,DET,PIT08,7,6,13
PIT200607010,2006,60701,PIT,DET,PIT08,2,9,11
PIT200607020,2006,60702,PIT,DET,PIT08,9,8,17
PIT200607140,2006,60714,PIT,WAS,PIT08,4,7,11
PIT200607150,2006,60715,PIT,WAS,PIT08,6,7,13
PIT200607160,2006,60716,PIT,WAS,PIT08,8,4,12
PIT200607170,2006,60717,PIT,COL,PIT08,1,3,4
PIT200607180,2006,60718,PIT,COL,PIT08,13,4,17
PIT200607190,2006,60719,PIT,COL,PIT08,5,6,11
PIT200607280,2006,60728,PIT,SFN,PIT08,0,3,3
PIT200607290,2006,60729,PIT,SFN,PIT08,3,4,7
PIT200607300,2006,60730,PIT,SFN,PIT08,1,2,3
PIT200608010,2006,60801,PIT,ATL,PIT08,4,2,6
PIT200608020,2006,60802,PIT,ATL,PIT08,3,2,5
PIT200608030,2006,60803,PIT,ATL,PIT08,2,3,5
PIT200608110,2006,60811,PIT,SLN,PIT08,1,7,8
PIT200608120,2006,60812,PIT,SLN,PIT08,2,3,5
PIT200608130,2006,60813,PIT,SLN,PIT08,0,7,7
PIT200608140,2006,60814,PIT,MIL,PIT08,2,4,6
PIT200608150,2006,60815,PIT,MIL,PIT08,6,3,9
PIT200608160,2006,60816,PIT,MIL,PIT08,5,2,7
PIT200608240,2006,60824,PIT,HOU,PIT08,3,5,8
PIT200608250,2006,60825,PIT,HOU,PIT08,5,1,6
PIT200608260,2006,60826,PIT,HOU,PIT08,7,4,11
PIT200608270,2006,60827,PIT,HOU,PIT08,13,1,14
PIT200608280,2006,60828,PIT,CHN,PIT08,6,11,17
PIT200608290,2006,60829,PIT,CHN,PIT08,6,7,13
PIT200608300,2006,60830,PIT,CHN,PIT08,9,10,19
PIT200609110,2006,60911,PIT,MIL,PIT08,3,4,7
PIT200609131,2006,60913,PIT,MIL,PIT08,3,6,9
PIT200609132,2006,60913,PIT,MIL,PIT08,2,1,3
PIT200609150,2006,60915,PIT,NYN,PIT08,3,5,8
PIT200609160,2006,60916,PIT,NYN,PIT08,2,3,5
PIT200609170,2006,60917,PIT,NYN,PIT08,0,3,3
PIT200609260,2006,60926,PIT,HOU,PIT08,7,4,11
PIT200609270,2006,60927,PIT,HOU,PIT08,7,6,13
PIT200609280,2006,60928,PIT,HOU,PIT08,3,0,3
PIT200609290,2006,60929,PIT,CIN,PIT08,5,2,7
PIT200609300,2006,60930,PIT,CIN,PIT08,0,3,3
PIT200610010,2006,61001,PIT,CIN,PIT08,0,1,1
PIT200704090,2007,70409,PIT,SLN,PIT08,3,0,3
PIT200704100,2007,70410,PIT,SLN,PIT08,3,2,5
PIT200704110,2007,70411,PIT,SLN,PIT08,3,2,5
PIT200704130,2007,70413,PIT,SFN,PIT08,8,5,13
PIT200704240,2007,70424,PIT,HOU,PIT08,0,3,3
PIT200704250,2007,70425,PIT,HOU,PIT08,3,4,7
PIT200704260,2007,70426,PIT,HOU,PIT08,3,5,8
PIT200704270,2007,70427,PIT,CIN,PIT08,1,3,4
PIT200704280,2007,70428,PIT,CIN,PIT08,8,1,9
PIT200704290,2007,70429,PIT,CIN,PIT08,9,5,14
PIT200704300,2007,70430,PIT,CHN,PIT08,2,3,5
PIT200705010,2007,70501,PIT,CHN,PIT08,8,6,14
PIT200705020,2007,70502,PIT,CHN,PIT08,7,1,8
PIT200705110,2007,70511,PIT,ATL,PIT08,4,1,5
PIT200705120,2007,70512,PIT,ATL,PIT08,9,2,11
PIT200705130,2007,70513,PIT,ATL,PIT08,2,13,15
PIT200705140,2007,70514,PIT,FLO,PIT08,0,7,7
PIT200705150,2007,70515,PIT,FLO,PIT08,9,3,12
PIT200705160,2007,70516,PIT,FLO,PIT08,4,3,7
PIT200705170,2007,70517,PIT,FLO,PIT08,2,7,9
PIT200705180,2007,70518,PIT,ARI,PIT08,5,11,16
PIT200705190,2007,70519,PIT,ARI,PIT08,9,8,17
PIT200705200,2007,70520,PIT,ARI,PIT08,5,2,7
PIT200705290,2007,70529,PIT,SDN,PIT08,1,4,5
PIT200705300,2007,70530,PIT,SDN,PIT08,9,0,9
PIT200705310,2007,70531,PIT,SDN,PIT08,4,2,6
PIT200706010,2007,70601,PIT,LAN,PIT08,5,4,9
PIT200706020,2007,70602,PIT,LAN,PIT08,1,3,4
PIT200706030,2007,70603,PIT,LAN,PIT08,5,4,9
PIT200706040,2007,70604,PIT,LAN,PIT08,6,5,11
PIT200706120,2007,70612,PIT,TEX,PIT08,5,7,12
PIT200706130,2007,70613,PIT,TEX,PIT08,1,8,9
PIT200706140,2007,70614,PIT,TEX,PIT08,6,0,6
PIT200706150,2007,70615,PIT,CHA,PIT08,2,4,6
PIT200706160,2007,70616,PIT,CHA,PIT08,6,1,7
PIT200706170,2007,70617,PIT,CHA,PIT08,7,8,15
PIT200706290,2007,70629,PIT,WAS,PIT08,2,3,5
PIT200706300,2007,70630,PIT,WAS,PIT08,2,7,9
PIT200707010,2007,70701,PIT,WAS,PIT08,3,2,5
PIT200707020,2007,70702,PIT,MIL,PIT08,10,3,13
PIT200707030,2007,70703,PIT,MIL,PIT08,2,6,8
PIT200707040,2007,70704,PIT,MIL,PIT08,3,5,8
PIT200707050,2007,70705,PIT,MIL,PIT08,3,6,9
PIT200707060,2007,70706,PIT,CHN,PIT08,4,8,12
PIT200707070,2007,70707,PIT,CHN,PIT08,7,1,8
PIT200707080,2007,70708,PIT,CHN,PIT08,2,6,8
PIT200707160,2007,70716,PIT,COL,PIT08,10,8,18
PIT200707170,2007,70717,PIT,COL,PIT08,6,2,8
PIT200707180,2007,70718,PIT,COL,PIT08,5,3,8
PIT200707200,2007,70720,PIT,HOU,PIT08,2,1,3
PIT200707210,2007,70721,PIT,HOU,PIT08,3,7,10
PIT200707220,2007,70722,PIT,HOU,PIT08,1,0,1
PIT200707310,2007,70731,PIT,SLN,PIT08,6,4,10
PIT200708010,2007,70801,PIT,SLN,PIT08,1,15,16
PIT200708020,2007,70802,PIT,SLN,PIT08,4,5,9
PIT200708030,2007,70803,PIT,CIN,PIT08,13,4,17
PIT200708040,2007,70804,PIT,CIN,PIT08,9,8,17
PIT200708131,2007,70813,PIT,SFN,PIT08,1,3,4
PIT200708132,2007,70813,PIT,SFN,PIT08,10,3,13
PIT200708140,2007,70814,PIT,NYN,PIT08,5,4,9
PIT200708150,2007,70815,PIT,NYN,PIT08,10,8,18
PIT200708160,2007,70816,PIT,NYN,PIT08,7,10,17
PIT200708170,2007,70817,PIT,PHI,PIT08,11,8,19
PIT200708180,2007,70818,PIT,PHI,PIT08,6,11,17
PIT200708190,2007,70819,PIT,PHI,PIT08,4,8,12
PIT200708281,2007,70828,PIT,CIN,PIT08,4,6,10
PIT200708282,2007,70828,PIT,CIN,PIT08,2,3,5
PIT200708290,2007,70829,PIT,CIN,PIT08,8,0,8
PIT200708300,2007,70830,PIT,CIN,PIT08,5,4,9
PIT200709070,2007,70907,PIT,CHN,PIT08,1,6,7
PIT200709080,2007,70908,PIT,CHN,PIT08,5,1,6
PIT200709090,2007,70909,PIT,CHN,PIT08,5,10,15
PIT200709100,2007,70910,PIT,MIL,PIT08,0,9,9
PIT200709110,2007,70911,PIT,MIL,PIT08,6,1,7
PIT200709120,2007,70912,PIT,MIL,PIT08,4,7,11
PIT200709250,2007,70925,PIT,ARI,PIT08,5,6,11
PIT200709260,2007,70926,PIT,ARI,PIT08,1,5,6
PIT200709270,2007,70927,PIT,ARI,PIT08,8,0,8
PIT200709280,2007,70928,PIT,SLN,PIT08,6,1,7
PIT200709290,2007,70929,PIT,SLN,PIT08,7,3,10
PIT200709300,2007,70930,PIT,SLN,PIT08,6,5,11
PIT200804070,2008,80407,PIT,CHN,PIT08,10,8,18
PIT200804090,2008,80409,PIT,CHN,PIT08,6,4,10
PIT200804100,2008,80410,PIT,CHN,PIT08,7,3,10
PIT200804110,2008,80411,PIT,CIN,PIT08,0,1,1
PIT200804120,2008,80412,PIT,CIN,PIT08,3,4,7
PIT200804130,2008,80413,PIT,CIN,PIT08,1,9,10
PIT200804210,2008,80421,PIT,FLO,PIT08,10,4,14
PIT200804220,2008,80422,PIT,FLO,PIT08,2,3,5
PIT200804230,2008,80423,PIT,SLN,PIT08,4,7,11
PIT200804240,2008,80424,PIT,SLN,PIT08,6,2,8
PIT200804250,2008,80425,PIT,PHI,PIT08,6,5,11
PIT200804260,2008,80426,PIT,PHI,PIT08,8,4,12
PIT200804270,2008,80427,PIT,PHI,PIT08,1,5,6
PIT200805060,2008,80506,PIT,SFN,PIT08,6,12,18
PIT200805070,2008,80507,PIT,SFN,PIT08,1,3,4
PIT200805080,2008,80508,PIT,SFN,PIT08,4,5,9
PIT200805090,2008,80509,PIT,ATL,PIT08,2,3,5
PIT200805100,2008,80510,PIT,ATL,PIT08,2,5,7
PIT200805121,2008,80512,PIT,ATL,PIT08,0,5,5
PIT200805122,2008,80512,PIT,ATL,PIT08,8,1,9
PIT200805200,2008,80520,PIT,MIL,PIT08,7,2,9
PIT200805210,2008,80521,PIT,MIL,PIT08,4,1,5
PIT200805220,2008,80522,PIT,MIL,PIT08,4,8,12
PIT200805230,2008,80523,PIT,CHN,PIT08,12,3,15
PIT200805240,2008,80524,PIT,CHN,PIT08,4,5,9
PIT200805250,2008,80525,PIT,CHN,PIT08,5,6,11
PIT200806030,2008,80603,PIT,HOU,PIT08,2,0,2
PIT200806040,2008,80604,PIT,HOU,PIT08,2,5,7
PIT200806050,2008,80605,PIT,HOU,PIT08,3,4,7
PIT200806060,2008,80606,PIT,ARI,PIT08,3,1,4
PIT200806070,2008,80607,PIT,ARI,PIT08,4,3,7
PIT200806080,2008,80608,PIT,ARI,PIT08,4,6,10
PIT200806090,2008,80609,PIT,ARI,PIT08,3,5,8
PIT200806100,2008,80610,PIT,WAS,PIT08,7,6,13
PIT200806110,2008,80611,PIT,WAS,PIT08,1,3,4
PIT200806120,2008,80612,PIT,WAS,PIT08,5,7,12
PIT200806200,2008,80620,PIT,TOR,PIT08,0,1,1
PIT200806210,2008,80621,PIT,TOR,PIT08,3,6,9
PIT200806220,2008,80622,PIT,TOR,PIT08,8,5,13
PIT200806240,2008,80624,PIT,NYA,PIT08,5,12,17
PIT200806250,2008,80625,PIT,NYA,PIT08,10,0,10
PIT200806270,2008,80627,PIT,TBA,PIT08,10,5,15
PIT200806280,2008,80628,PIT,TBA,PIT08,3,4,7
PIT200806290,2008,80629,PIT,TBA,PIT08,4,3,7
PIT200807070,2008,80707,PIT,HOU,PIT08,7,10,17
PIT200807080,2008,80708,PIT,HOU,PIT08,3,4,7
PIT200807090,2008,80709,PIT,HOU,PIT08,6,4,10
PIT200807100,2008,80710,PIT,NYA,PIT08,2,4,6
PIT200807110,2008,80711,PIT,SLN,PIT08,6,0,6
PIT200807120,2008,80712,PIT,SLN,PIT08,11,12,23
PIT200807130,2008,80713,PIT,SLN,PIT08,11,6,17
PIT200807240,2008,80724,PIT,SDN,PIT08,1,9,10
PIT200807250,2008,80725,PIT,SDN,PIT08,6,5,11
PIT200807260,2008,80726,PIT,SDN,PIT08,9,6,15
PIT200807270,2008,80727,PIT,SDN,PIT08,3,1,4
PIT200807280,2008,80728,PIT,COL,PIT08,4,8,12
PIT200807290,2008,80729,PIT,COL,PIT08,4,6,10
PIT200807300,2008,80730,PIT,COL,PIT08,7,4,11
PIT200808120,2008,80812,PIT,CIN,PIT08,5,1,6
PIT200808130,2008,80813,PIT,CIN,PIT08,2,5,7
PIT200808140,2008,80814,PIT,CIN,PIT08,3,1,4
PIT200808150,2008,80815,PIT,NYN,PIT08,2,1,3
PIT200808160,2008,80816,PIT,NYN,PIT08,7,4,11
PIT200808170,2008,80817,PIT,NYN,PIT08,4,0,4
PIT200808180,2008,80818,PIT,NYN,PIT08,2,5,7
PIT200808250,2008,80825,PIT,CHN,PIT08,12,3,15
PIT200808260,2008,80826,PIT,CHN,PIT08,14,9,23
PIT200808270,2008,80827,PIT,CHN,PIT08,2,0,2
PIT200808290,2008,80829,PIT,MIL,PIT08,3,1,4
PIT200808300,2008,80830,PIT,MIL,PIT08,11,3,14
PIT200808310,2008,80831,PIT,MIL,PIT08,7,0,7
PIT200809120,2008,80912,PIT,SLN,PIT08,2,10,12
PIT200809130,2008,80913,PIT,SLN,PIT08,6,7,13
PIT200809140,2008,80914,PIT,SLN,PIT08,2,7,9
PIT200809150,2008,80915,PIT,LAN,PIT08,8,2,10
PIT200809160,2008,80916,PIT,LAN,PIT08,6,2,8
PIT200809170,2008,80917,PIT,LAN,PIT08,8,15,23
PIT200809180,2008,80918,PIT,LAN,PIT08,4,3,7
PIT200809190,2008,80919,PIT,HOU,PIT08,5,1,6
PIT200809200,2008,80920,PIT,HOU,PIT08,4,6,10
PIT200809210,2008,80921,PIT,HOU,PIT08,6,2,8
PIT200904130,2009,90413,PIT,HOU,PIT08,0,7,7
PIT200904150,2009,90415,PIT,HOU,PIT08,4,1,5
PIT200904160,2009,90416,PIT,HOU,PIT08,6,3,9
PIT200904170,2009,90417,PIT,ATL,PIT08,0,3,3
PIT200904180,2009,90418,PIT,ATL,PIT08,0,10,10
PIT200904190,2009,90419,PIT,ATL,PIT08,11,1,12
PIT200904200,2009,90420,PIT,FLO,PIT08,0,8,8
PIT200904210,2009,90421,PIT,FLO,PIT08,2,3,5
PIT200904220,2009,90422,PIT,FLO,PIT08,4,7,11
PIT200905010,2009,90501,PIT,CIN,PIT08,4,0,4
PIT200905020,2009,90502,PIT,CIN,PIT08,6,8,14
PIT200905030,2009,90503,PIT,CIN,PIT08,5,0,5
PIT200905040,2009,90504,PIT,MIL,PIT08,7,4,11
PIT200905050,2009,90505,PIT,MIL,PIT08,8,5,13
PIT200905120,2009,90512,PIT,SLN,PIT08,1,7,8
PIT200905130,2009,90513,PIT,SLN,PIT08,2,5,7
PIT200905140,2009,90514,PIT,SLN,PIT08,5,1,6
PIT200905150,2009,90515,PIT,COL,PIT08,3,1,4
PIT200905160,2009,90516,PIT,COL,PIT08,4,7,11
PIT200905170,2009,90517,PIT,COL,PIT08,4,11,15
PIT200905290,2009,90529,PIT,HOU,PIT08,6,1,7
PIT200905300,2009,90530,PIT,HOU,PIT08,4,7,11
PIT200905310,2009,90531,PIT,HOU,PIT08,2,1,3
PIT200906010,2009,90601,PIT,NYN,PIT08,5,8,13
PIT200906020,2009,90602,PIT,NYN,PIT08,1,3,4
PIT200906040,2009,90604,PIT,NYN,PIT08,6,11,17
PIT200906120,2009,90612,PIT,DET,PIT08,3,1,4
PIT200906130,2009,90613,PIT,DET,PIT08,3,9,12
PIT200906140,2009,90614,PIT,DET,PIT08,3,6,9
PIT200906230,2009,90623,PIT,CLE,PIT08,5,4,9
PIT200906240,2009,90624,PIT,CLE,PIT08,6,10,16
PIT200906250,2009,90625,PIT,CLE,PIT08,2,3,5
PIT200906260,2009,90626,PIT,KCA,PIT08,3,5,8
PIT200906270,2009,90627,PIT,KCA,PIT08,2,6,8
PIT200906280,2009,90628,PIT,KCA,PIT08,3,2,5
PIT200906290,2009,90629,PIT,CHN,PIT08,3,1,4
PIT200906300,2009,90630,PIT,CHN,PIT08,0,3,3
PIT200907010,2009,90701,PIT,CHN,PIT08,4,1,5
PIT200907020,2009,90702,PIT,NYN,PIT08,9,8,17
PIT200907170,2009,90717,PIT,SFN,PIT08,1,2,3
PIT200907180,2009,90718,PIT,SFN,PIT08,0,2,2
PIT200907190,2009,90719,PIT,SFN,PIT08,4,3,7
PIT200907200,2009,90720,PIT,MIL,PIT08,5,8,13
PIT200907210,2009,90721,PIT,MIL,PIT08,2,0,2
PIT200907220,2009,90722,PIT,MIL,PIT08,7,8,15
PIT200907310,2009,90731,PIT,WAS,PIT08,4,5,9
PIT200908010,2009,90801,PIT,WAS,PIT08,6,11,17
PIT200908020,2009,90802,PIT,WAS,PIT08,5,3,8
PIT200908030,2009,90803,PIT,WAS,PIT08,8,4,12
PIT200908040,2009,90804,PIT,ARI,PIT08,6,0,6
PIT200908050,2009,90805,PIT,ARI,PIT08,4,3,7
PIT200908060,2009,90806,PIT,ARI,PIT08,11,6,17
PIT200908070,2009,90807,PIT,SLN,PIT08,6,4,10
PIT200908080,2009,90808,PIT,SLN,PIT08,5,3,8
PIT200908090,2009,90809,PIT,SLN,PIT08,7,3,10
PIT200908170,2009,90817,PIT,MIL,PIT08,5,9,14
PIT200908180,2009,90818,PIT,MIL,PIT08,2,5,7
PIT200908190,2009,90819,PIT,MIL,PIT08,1,3,4
PIT200908210,2009,90821,PIT,CIN,PIT08,2,5,7
PIT200908220,2009,90822,PIT,CIN,PIT08,2,12,14
PIT200908230,2009,90823,PIT,CIN,PIT08,4,1,5
PIT200908250,2009,90825,PIT,PHI,PIT08,4,6,10
PIT200908260,2009,90826,PIT,PHI,PIT08,4,1,5
PIT200908270,2009,90827,PIT,PHI,PIT08,2,3,5
PIT200909040,2009,90904,PIT,SLN,PIT08,14,7,21
PIT200909050,2009,90905,PIT,SLN,PIT08,2,1,3
PIT200909060,2009,90906,PIT,SLN,PIT08,5,6,11
PIT200909070,2009,90907,PIT,CHN,PIT08,4,2,6
PIT200909080,2009,90908,PIT,CHN,PIT08,9,4,13
PIT200909090,2009,90909,PIT,CHN,PIT08,8,5,13
PIT200909180,2009,90918,PIT,SDN,PIT08,1,5,6
PIT200909190,2009,90919,PIT,SDN,PIT08,2,1,3
PIT200909200,2009,90920,PIT,SDN,PIT08,4,0,4
PIT200909210,2009,90921,PIT,SDN,PIT08,11,6,17
PIT200909220,2009,90922,PIT,CIN,PIT08,10,4,14
PIT200909230,2009,90923,PIT,CIN,PIT08,12,2,14
PIT200909240,2009,90924,PIT,CIN,PIT08,4,1,5
PIT200909250,2009,90925,PIT,LAN,PIT08,1,3,4
PIT200909260,2009,90926,PIT,LAN,PIT08,8,4,12
PIT200909270,2009,90927,PIT,LAN,PIT08,5,6,11
PIT200909280,2009,90928,PIT,LAN,PIT08,1,11,12
SDN200004100,2000,410,SDN,ARI,SAN01,8,4,12
SDN200004110,2000,411,SDN,ARI,SAN01,2,3,5
SDN200004120,2000,412,SDN,ARI,SAN01,2,4,6
SDN200004130,2000,413,SDN,ARI,SAN01,5,4,9
SDN200004140,2000,414,SDN,HOU,SAN01,10,4,14
SDN200004150,2000,415,SDN,HOU,SAN01,3,5,8
SDN200004160,2000,416,SDN,HOU,SAN01,3,13,16
SDN200004280,2000,428,SDN,ATL,SAN01,7,2,9
SDN200004290,2000,429,SDN,ATL,SAN01,7,4,11
SDN200004300,2000,430,SDN,ATL,SAN01,7,4,11
SDN200005010,2000,501,SDN,FLO,SAN01,5,2,7
SDN200005020,2000,502,SDN,FLO,SAN01,3,8,11
SDN200005030,2000,503,SDN,FLO,SAN01,1,3,4
SDN200005120,2000,512,SDN,ARI,SAN01,6,4,10
SDN200005130,2000,513,SDN,ARI,SAN01,6,2,8
SDN200005140,2000,514,SDN,ARI,SAN01,1,3,4
SDN200005220,2000,522,SDN,NYN,SAN01,0,1,1
SDN200005230,2000,523,SDN,NYN,SAN01,5,3,8
SDN200005240,2000,524,SDN,NYN,SAN01,4,5,9
SDN200005260,2000,526,SDN,MON,SAN01,2,6,8
SDN200005270,2000,527,SDN,MON,SAN01,2,4,6
SDN200005280,2000,528,SDN,MON,SAN01,3,4,7
SDN200005290,2000,529,SDN,MIL,SAN01,8,3,11
SDN200005300,2000,530,SDN,MIL,SAN01,3,6,9
SDN200005310,2000,531,SDN,MIL,SAN01,5,9,14
SDN200006090,2000,609,SDN,HOU,SAN01,7,6,13
SDN200006100,2000,610,SDN,HOU,SAN01,3,13,16
SDN200006110,2000,611,SDN,HOU,SAN01,1,4,5
SDN200006120,2000,612,SDN,SLN,SAN01,7,3,10
SDN200006130,2000,613,SDN,SLN,SAN01,8,3,11
SDN200006140,2000,614,SDN,SLN,SAN01,3,1,4
SDN200006160,2000,616,SDN,CIN,SAN01,5,8,13
SDN200006170,2000,617,SDN,CIN,SAN01,1,3,4
SDN200006180,2000,618,SDN,CIN,SAN01,7,8,15
SDN200006300,2000,630,SDN,COL,SAN01,5,4,9
SDN200007010,2000,701,SDN,COL,SAN01,3,5,8
SDN200007020,2000,702,SDN,COL,SAN01,3,2,5
SDN200007030,2000,703,SDN,COL,SAN01,3,1,4
SDN200007040,2000,704,SDN,LAN,SAN01,2,7,9
SDN200007050,2000,705,SDN,LAN,SAN01,7,5,12
SDN200007060,2000,706,SDN,LAN,SAN01,9,3,12
SDN200007130,2000,713,SDN,SEA,SAN01,1,2,3
SDN200007140,2000,714,SDN,SEA,SAN01,7,5,12
SDN200007150,2000,715,SDN,SEA,SAN01,1,4,5
SDN200007160,2000,716,SDN,ANA,SAN01,5,6,11
SDN200007170,2000,717,SDN,ANA,SAN01,3,2,5
SDN200007180,2000,718,SDN,ANA,SAN01,3,2,5
SDN200007240,2000,724,SDN,SFN,SAN01,3,0,3
SDN200007250,2000,725,SDN,SFN,SAN01,2,3,5
SDN200007260,2000,726,SDN,SFN,SAN01,3,1,4
SDN200007310,2000,731,SDN,PHI,SAN01,1,4,5
SDN200008010,2000,801,SDN,PHI,SAN01,9,10,19
SDN200008020,2000,802,SDN,PHI,SAN01,2,5,7
SDN200008030,2000,803,SDN,CHN,SAN01,5,6,11
SDN200008040,2000,804,SDN,CHN,SAN01,9,11,20
SDN200008050,2000,805,SDN,CHN,SAN01,6,3,9
SDN200008060,2000,806,SDN,CHN,SAN01,6,8,14
SDN200008180,2000,818,SDN,MON,SAN01,6,3,9
SDN200008190,2000,819,SDN,MON,SAN01,3,4,7
SDN200008200,2000,820,SDN,MON,SAN01,4,5,9
SDN200008210,2000,821,SDN,NYN,SAN01,4,5,9
SDN200008220,2000,822,SDN,NYN,SAN01,1,16,17
SDN200008230,2000,823,SDN,NYN,SAN01,4,1,5
SDN200009010,2000,901,SDN,PIT,SAN01,3,2,5
SDN200009020,2000,902,SDN,PIT,SAN01,6,3,9
SDN200009030,2000,903,SDN,PIT,SAN01,8,6,14
SDN200009040,2000,904,SDN,MIL,SAN01,3,4,7
SDN200009050,2000,905,SDN,MIL,SAN01,1,3,4
SDN200009060,2000,906,SDN,MIL,SAN01,6,7,13
SDN200009110,2000,911,SDN,COL,SAN01,2,7,9
SDN200009120,2000,912,SDN,COL,SAN01,6,3,9
SDN200009130,2000,913,SDN,COL,SAN01,11,0,11
SDN200009150,2000,915,SDN,SFN,SAN01,4,5,9
SDN200009160,2000,916,SDN,SFN,SAN01,4,3,7
SDN200009170,2000,917,SDN,SFN,SAN01,5,1,6
SDN200009260,2000,926,SDN,SLN,SAN01,7,1,8
SDN200009270,2000,927,SDN,SLN,SAN01,3,0,3
SDN200009280,2000,928,SDN,SLN,SAN01,7,6,13
SDN200009290,2000,929,SDN,LAN,SAN01,3,0,3
SDN200009300,2000,930,SDN,LAN,SAN01,10,2,12
SDN200010010,2000,1001,SDN,LAN,SAN01,0,4,4
SDN200104100,2001,10410,SDN,SFN,SAN01,11,6,17
SDN200104110,2001,10411,SDN,SFN,SAN01,2,1,3
SDN200104120,2001,10412,SDN,SFN,SAN01,3,8,11
SDN200104130,2001,10413,SDN,LAN,SAN01,4,5,9
SDN200104140,2001,10414,SDN,LAN,SAN01,4,5,9
SDN200104150,2001,10415,SDN,LAN,SAN01,5,4,9
SDN200104170,2001,10417,SDN,COL,SAN01,9,5,14
SDN200104180,2001,10418,SDN,COL,SAN01,8,0,8
SDN200104190,2001,10419,SDN,COL,SAN01,4,0,4
SDN200104230,2001,10423,SDN,PHI,SAN01,5,3,8
SDN200104240,2001,10424,SDN,PHI,SAN01,12,7,19
SDN200104250,2001,10425,SDN,PHI,SAN01,5,3,8
SDN200104260,2001,10426,SDN,PHI,SAN01,0,11,11
SDN200104270,2001,10427,SDN,PIT,SAN01,3,0,3
SDN200104280,2001,10428,SDN,PIT,SAN01,1,8,9
SDN200104290,2001,10429,SDN,PIT,SAN01,1,6,7
SDN200105080,2001,10508,SDN,ATL,SAN01,1,7,8
SDN200105090,2001,10509,SDN,ATL,SAN01,3,0,3
SDN200105100,2001,10510,SDN,ATL,SAN01,5,6,11
SDN200105110,2001,10511,SDN,FLO,SAN01,6,7,13
SDN200105120,2001,10512,SDN,FLO,SAN01,3,0,3
SDN200105130,2001,10513,SDN,FLO,SAN01,10,4,14
SDN200105240,2001,10524,SDN,ARI,SAN01,1,3,4
SDN200105250,2001,10525,SDN,ARI,SAN01,7,1,8
SDN200105260,2001,10526,SDN,ARI,SAN01,3,1,4
SDN200105270,2001,10527,SDN,ARI,SAN01,6,4,10
SDN200105290,2001,10529,SDN,HOU,SAN01,4,5,9
SDN200105300,2001,10530,SDN,HOU,SAN01,7,4,11
SDN200105310,2001,10531,SDN,HOU,SAN01,8,4,12
SDN200106120,2001,10612,SDN,OAK,SAN01,5,2,7
SDN200106130,2001,10613,SDN,OAK,SAN01,6,2,8
SDN200106140,2001,10614,SDN,OAK,SAN01,4,6,10
SDN200106150,2001,10615,SDN,SEA,SAN01,8,4,12
SDN200106160,2001,10616,SDN,SEA,SAN01,9,2,11
SDN200106170,2001,10617,SDN,SEA,SAN01,9,11,20
SDN200106190,2001,10619,SDN,SFN,SAN01,3,4,7
SDN200106200,2001,10620,SDN,SFN,SAN01,8,6,14
SDN200106210,2001,10621,SDN,SFN,SAN01,8,3,11
SDN200106280,2001,10628,SDN,LAN,SAN01,7,4,11
SDN200106290,2001,10629,SDN,LAN,SAN01,7,5,12
SDN200106300,2001,10630,SDN,LAN,SAN01,7,3,10
SDN200107010,2001,10701,SDN,LAN,SAN01,8,0,8
SDN200107030,2001,10703,SDN,COL,SAN01,5,6,11
SDN200107040,2001,10704,SDN,COL,SAN01,3,8,11
SDN200107050,2001,10705,SDN,COL,SAN01,4,0,4
SDN200107060,2001,10706,SDN,TEX,SAN01,3,8,11
SDN200107070,2001,10707,SDN,TEX,SAN01,4,3,7
SDN200107080,2001,10708,SDN,TEX,SAN01,2,11,13
SDN200107180,2001,10718,SDN,ARI,SAN01,3,0,3
SDN200107190,2001,10719,SDN,ARI,SAN01,4,8,12
SDN200107200,2001,10720,SDN,MIL,SAN01,2,11,13
SDN200107210,2001,10721,SDN,MIL,SAN01,3,5,8
SDN200107220,2001,10722,SDN,MIL,SAN01,0,4,4
SDN200107310,2001,10731,SDN,CHN,SAN01,7,3,10
SDN200108010,2001,10801,SDN,CHN,SAN01,3,4,7
SDN200108020,2001,10802,SDN,CHN,SAN01,3,4,7
SDN200108030,2001,10803,SDN,CIN,SAN01,9,2,11
SDN200108040,2001,10804,SDN,CIN,SAN01,0,2,2
SDN200108050,2001,10805,SDN,CIN,SAN01,10,9,19
SDN200108140,2001,10814,SDN,NYN,SAN01,0,6,6
SDN200108150,2001,10815,SDN,NYN,SAN01,1,2,3
SDN200108160,2001,10816,SDN,NYN,SAN01,5,6,11
SDN200108170,2001,10817,SDN,MON,SAN01,4,0,4
SDN200108180,2001,10818,SDN,MON,SAN01,3,4,7
SDN200108190,2001,10819,SDN,MON,SAN01,2,1,3
SDN200108311,2001,10831,SDN,ARI,SAN01,4,1,5
SDN200108312,2001,10831,SDN,ARI,SAN01,5,6,11
SDN200109010,2001,10901,SDN,ARI,SAN01,5,7,12
SDN200109020,2001,10902,SDN,ARI,SAN01,0,1,1
SDN200109030,2001,10903,SDN,SLN,SAN01,4,0,4
SDN200109040,2001,10904,SDN,SLN,SAN01,6,1,7
SDN200109050,2001,10905,SDN,SLN,SAN01,2,0,2
SDN200109210,2001,10921,SDN,SFN,SAN01,2,0,2
SDN200109220,2001,10922,SDN,SFN,SAN01,3,4,7
SDN200109230,2001,10923,SDN,SFN,SAN01,11,2,13
SDN200110020,2001,11002,SDN,LAN,SAN01,5,2,7
SDN200110030,2001,11003,SDN,LAN,SAN01,12,5,17
SDN200110040,2001,11004,SDN,LAN,SAN01,3,6,9
SDN200110050,2001,11005,SDN,COL,SAN01,4,0,4
SDN200110060,2001,11006,SDN,COL,SAN01,4,10,14
SDN200110070,2001,11007,SDN,COL,SAN01,14,5,19
SDN200204080,2002,20408,SDN,ARI,SAN01,0,8,8
SDN200204090,2002,20409,SDN,ARI,SAN01,2,5,7
SDN200204100,2002,20410,SDN,ARI,SAN01,1,2,3
SDN200204120,2002,20412,SDN,LAN,SAN01,3,0,3
SDN200204130,2002,20413,SDN,LAN,SAN01,4,6,10
SDN200204140,2002,20414,SDN,LAN,SAN01,0,1,1
SDN200204150,2002,20415,SDN,SFN,SAN01,3,4,7
SDN200204160,2002,20416,SDN,SFN,SAN01,5,1,6
SDN200204170,2002,20417,SDN,SFN,SAN01,3,5,8
SDN200204300,2002,20430,SDN,CHN,SAN01,1,2,3
SDN200205010,2002,20501,SDN,CHN,SAN01,3,4,7
SDN200205020,2002,20502,SDN,CHN,SAN01,6,1,7
SDN200205030,2002,20503,SDN,PIT,SAN01,6,4,10
SDN200205040,2002,20504,SDN,PIT,SAN01,0,3,3
SDN200205050,2002,20505,SDN,PIT,SAN01,5,6,11
SDN200205130,2002,20513,SDN,MON,SAN01,3,7,10
SDN200205140,2002,20514,SDN,MON,SAN01,4,5,9
SDN200205150,2002,20515,SDN,MON,SAN01,1,2,3
SDN200205160,2002,20516,SDN,NYN,SAN01,3,1,4
SDN200205170,2002,20517,SDN,NYN,SAN01,13,4,17
SDN200205180,2002,20518,SDN,NYN,SAN01,5,2,7
SDN200205190,2002,20519,SDN,NYN,SAN01,3,4,7
SDN200205270,2002,20527,SDN,COL,SAN01,5,8,13
SDN200205280,2002,20528,SDN,COL,SAN01,3,2,5
SDN200205290,2002,20529,SDN,COL,SAN01,3,11,14
SDN200205300,2002,20530,SDN,COL,SAN01,4,2,6
SDN200205310,2002,20531,SDN,MIL,SAN01,12,1,13
SDN200206010,2002,20601,SDN,MIL,SAN01,4,3,7
SDN200206020,2002,20602,SDN,MIL,SAN01,4,3,7
SDN200206030,2002,20603,SDN,SFN,SAN01,11,3,14
SDN200206040,2002,20604,SDN,SFN,SAN01,3,1,4
SDN200206050,2002,20605,SDN,SFN,SAN01,12,2,14
SDN200206140,2002,20614,SDN,SEA,SAN01,6,3,9
SDN200206150,2002,20615,SDN,SEA,SAN01,1,3,4
SDN200206160,2002,20616,SDN,SEA,SAN01,3,5,8
SDN200206180,2002,20618,SDN,BOS,SAN01,4,2,6
SDN200206190,2002,20619,SDN,BOS,SAN01,2,3,5
SDN200206200,2002,20620,SDN,BOS,SAN01,5,0,5
SDN200206210,2002,20621,SDN,NYA,SAN01,1,9,10
SDN200206220,2002,20622,SDN,NYA,SAN01,1,0,1
SDN200206230,2002,20623,SDN,NYA,SAN01,3,2,5
SDN200206240,2002,20624,SDN,SFN,SAN01,7,6,13
SDN200206250,2002,20625,SDN,SFN,SAN01,7,10,17
SDN200207120,2002,20712,SDN,SLN,SAN01,3,4,7
SDN200207130,2002,20713,SDN,SLN,SAN01,2,1,3
SDN200207140,2002,20714,SDN,SLN,SAN01,4,1,5
SDN200207150,2002,20715,SDN,COL,SAN01,5,0,5
SDN200207160,2002,20716,SDN,COL,SAN01,1,5,6
SDN200207190,2002,20719,SDN,ARI,SAN01,1,6,7
SDN200207200,2002,20720,SDN,ARI,SAN01,7,1,8
SDN200207210,2002,20721,SDN,ARI,SAN01,9,11,20
SDN200207220,2002,20722,SDN,LAN,SAN01,2,5,7
SDN200207230,2002,20723,SDN,LAN,SAN01,8,6,14
SDN200207240,2002,20724,SDN,LAN,SAN01,0,8,8
SDN200208020,2002,20802,SDN,CIN,SAN01,2,5,7
SDN200208030,2002,20803,SDN,CIN,SAN01,4,3,7
SDN200208040,2002,20804,SDN,CIN,SAN01,15,10,25
SDN200208060,2002,20806,SDN,PHI,SAN01,5,4,9
SDN200208070,2002,20807,SDN,PHI,SAN01,2,5,7
SDN200208080,2002,20808,SDN,PHI,SAN01,4,7,11
SDN200208200,2002,20820,SDN,ATL,SAN01,2,6,8
SDN200208210,2002,20821,SDN,ATL,SAN01,6,3,9
SDN200208220,2002,20822,SDN,ATL,SAN01,2,9,11
SDN200208230,2002,20823,SDN,FLO,SAN01,2,18,20
SDN200208240,2002,20824,SDN,FLO,SAN01,8,4,12
SDN200208250,2002,20825,SDN,FLO,SAN01,7,6,13
SDN200208300,2002,20830,SDN,COL,SAN01,0,2,2
SDN200208310,2002,20831,SDN,COL,SAN01,0,3,3
SDN200209010,2002,20901,SDN,COL,SAN01,5,9,14
SDN200209020,2002,20902,SDN,COL,SAN01,5,2,7
SDN200209030,2002,20903,SDN,HOU,SAN01,6,2,8
SDN200209040,2002,20904,SDN,HOU,SAN01,1,5,6
SDN200209050,2002,20905,SDN,HOU,SAN01,5,0,5
SDN200209120,2002,20912,SDN,SFN,SAN01,2,3,5
SDN200209130,2002,20913,SDN,SFN,SAN01,10,3,13
SDN200209170,2002,20917,SDN,ARI,SAN01,2,3,5
SDN200209180,2002,20918,SDN,ARI,SAN01,10,3,13
SDN200209190,2002,20919,SDN,ARI,SAN01,3,1,4
SDN200209200,2002,20920,SDN,LAN,SAN01,4,8,12
SDN200209210,2002,20921,SDN,LAN,SAN01,5,3,8
SDN200209220,2002,20922,SDN,LAN,SAN01,4,3,7
SDN200303310,2003,30331,SDN,SFN,SAN01,5,2,7
SDN200304010,2003,30401,SDN,SFN,SAN01,8,1,9
SDN200304020,2003,30402,SDN,SFN,SAN01,5,3,8
SDN200304030,2003,30403,SDN,LAN,SAN01,1,6,7
SDN200304040,2003,30404,SDN,LAN,SAN01,2,4,6
SDN200304050,2003,30405,SDN,LAN,SAN01,0,3,3
SDN200304060,2003,30406,SDN,LAN,SAN01,4,3,7
SDN200304110,2003,30411,SDN,COL,SAN01,4,6,10
SDN200304120,2003,30412,SDN,COL,SAN01,3,2,5
SDN200304130,2003,30413,SDN,COL,SAN01,2,6,8
SDN200304290,2003,30429,SDN,PIT,SAN01,7,2,9
SDN200304300,2003,30430,SDN,PIT,SAN01,8,5,13
SDN200305010,2003,30501,SDN,PIT,SAN01,5,2,7
SDN200305020,2003,30502,SDN,PHI,SAN01,4,5,9
SDN200305030,2003,30503,SDN,PHI,SAN01,5,4,9
SDN200305040,2003,30504,SDN,PHI,SAN01,3,1,4
SDN200305120,2003,30512,SDN,FLO,SAN01,6,1,7
SDN200305130,2003,30513,SDN,FLO,SAN01,5,6,11
SDN200305140,2003,30514,SDN,FLO,SAN01,10,3,13
SDN200305150,2003,30515,SDN,ATL,SAN01,15,6,21
SDN200305160,2003,30516,SDN,ATL,SAN01,6,4,10
SDN200305170,2003,30517,SDN,ATL,SAN01,12,2,14
SDN200305180,2003,30518,SDN,ATL,SAN01,6,3,9
SDN200305270,2003,30527,SDN,MIL,SAN01,4,2,6
SDN200305280,2003,30528,SDN,MIL,SAN01,6,8,14
SDN200305290,2003,30529,SDN,MIL,SAN01,3,2,5
SDN200305300,2003,30530,SDN,ARI,SAN01,8,3,11
SDN200305310,2003,30531,SDN,ARI,SAN01,7,8,15
SDN200306010,2003,30601,SDN,ARI,SAN01,10,4,14
SDN200306020,2003,30602,SDN,ARI,SAN01,1,4,5
SDN200306030,2003,30603,SDN,DET,SAN01,3,2,5
SDN200306040,2003,30604,SDN,DET,SAN01,5,3,8
SDN200306050,2003,30605,SDN,DET,SAN01,1,5,6
SDN200306060,2003,30606,SDN,MIN,SAN01,7,5,12
SDN200306070,2003,30607,SDN,MIN,SAN01,6,2,8
SDN200306080,2003,30608,SDN,MIN,SAN01,4,9,13
SDN200306200,2003,30620,SDN,SEA,SAN01,3,5,8
SDN200306210,2003,30621,SDN,SEA,SAN01,4,2,6
SDN200306220,2003,30622,SDN,SEA,SAN01,1,3,4
SDN200306230,2003,30623,SDN,COL,SAN01,5,1,6
SDN200306240,2003,30624,SDN,COL,SAN01,5,2,7
SDN200306250,2003,30625,SDN,COL,SAN01,6,7,13
SDN200307040,2003,30704,SDN,SFN,SAN01,8,6,14
SDN200307050,2003,30705,SDN,SFN,SAN01,2,5,7
SDN200307060,2003,30706,SDN,SFN,SAN01,3,2,5
SDN200307070,2003,30707,SDN,LAN,SAN01,1,7,8
SDN200307080,2003,30708,SDN,LAN,SAN01,5,8,13
SDN200307170,2003,30717,SDN,ARI,SAN01,9,1,10
SDN200307180,2003,30718,SDN,ARI,SAN01,6,0,6
SDN200307190,2003,30719,SDN,ARI,SAN01,0,2,2
SDN200307200,2003,30720,SDN,ARI,SAN01,2,3,5
SDN200307210,2003,30721,SDN,SLN,SAN01,4,5,9
SDN200307220,2003,30722,SDN,SLN,SAN01,2,3,5
SDN200307230,2003,30723,SDN,SLN,SAN01,8,4,12
SDN200308050,2003,30805,SDN,CHN,SAN01,3,0,3
SDN200308060,2003,30806,SDN,CHN,SAN01,3,2,5
SDN200308070,2003,30807,SDN,CHN,SAN01,9,3,12
SDN200308080,2003,30808,SDN,CIN,SAN01,0,1,1
SDN200308090,2003,30809,SDN,CIN,SAN01,9,5,14
SDN200308100,2003,30810,SDN,CIN,SAN01,0,2,2
SDN200308190,2003,30819,SDN,NYN,SAN01,2,3,5
SDN200308200,2003,30820,SDN,NYN,SAN01,1,2,3
SDN200308210,2003,30821,SDN,NYN,SAN01,5,1,6
SDN200308220,2003,30822,SDN,MON,SAN01,3,5,8
SDN200308230,2003,30823,SDN,MON,SAN01,0,1,1
SDN200308240,2003,30824,SDN,MON,SAN01,8,4,12
SDN200309020,2003,30902,SDN,ARI,SAN01,3,6,9
SDN200309030,2003,30903,SDN,ARI,SAN01,0,12,12
SDN200309050,2003,30905,SDN,HOU,SAN01,5,4,9
SDN200309060,2003,30906,SDN,HOU,SAN01,10,4,14
SDN200309070,2003,30907,SDN,HOU,SAN01,1,7,8
SDN200309090,2003,30909,SDN,SFN,SAN01,8,3,11
SDN200309100,2003,30910,SDN,SFN,SAN01,7,1,8
SDN200309110,2003,30911,SDN,SFN,SAN01,4,5,9
SDN200309220,2003,30922,SDN,LAN,SAN01,5,9,14
SDN200309230,2003,30923,SDN,LAN,SAN01,2,1,3
SDN200309240,2003,30924,SDN,LAN,SAN01,2,1,3
SDN200309250,2003,30925,SDN,LAN,SAN01,1,6,7
SDN200309260,2003,30926,SDN,COL,SAN01,0,5,5
SDN200309270,2003,30927,SDN,COL,SAN01,10,2,12
SDN200309280,2003,30928,SDN,COL,SAN01,10,8,18
SDN200404080,2004,40408,SDN,SFN,SAN02,3,4,7
SDN200404100,2004,40410,SDN,SFN,SAN02,4,6,10
SDN200404110,2004,40411,SDN,SFN,SAN02,6,3,9
SDN200404130,2004,40413,SDN,LAN,SAN02,3,8,11
SDN200404140,2004,40414,SDN,LAN,SAN02,11,4,15
SDN200404150,2004,40415,SDN,LAN,SAN02,7,5,12
SDN200404160,2004,40416,SDN,ARI,SAN02,5,0,5
SDN200404170,2004,40417,SDN,ARI,SAN02,2,3,5
SDN200404180,2004,40418,SDN,ARI,SAN02,5,6,11
SDN200404260,2004,40426,SDN,MON,SAN02,2,3,5
SDN200404270,2004,40427,SDN,MON,SAN02,0,3,3
SDN200404280,2004,40428,SDN,MON,SAN02,4,5,9
SDN200404290,2004,40429,SDN,MON,SAN02,1,2,3
SDN200404300,2004,40430,SDN,NYN,SAN02,6,7,13
SDN200405010,2004,40501,SDN,NYN,SAN02,1,3,4
SDN200405020,2004,40502,SDN,NYN,SAN02,6,2,8
SDN200405110,2004,40511,SDN,CIN,SAN02,6,3,9
SDN200405120,2004,40512,SDN,CIN,SAN02,1,2,3
SDN200405130,2004,40513,SDN,CIN,SAN02,2,8,10
SDN200405140,2004,40514,SDN,CHN,SAN02,6,1,7
SDN200405150,2004,40515,SDN,CHN,SAN02,7,5,12
SDN200405160,2004,40516,SDN,CHN,SAN02,4,2,6
SDN200405310,2004,40531,SDN,COL,SAN02,7,1,8
SDN200406010,2004,40601,SDN,COL,SAN02,7,1,8
SDN200406020,2004,40602,SDN,COL,SAN02,1,2,3
SDN200406040,2004,40604,SDN,MIL,SAN02,3,1,4
SDN200406050,2004,40605,SDN,MIL,SAN02,0,4,4
SDN200406060,2004,40606,SDN,MIL,SAN02,3,8,11
SDN200406150,2004,40615,SDN,TBA,SAN02,5,2,7
SDN200406160,2004,40616,SDN,TBA,SAN02,9,6,15
SDN200406170,2004,40617,SDN,TBA,SAN02,4,1,5
SDN200406180,2004,40618,SDN,TOR,SAN02,3,2,5
SDN200406190,2004,40619,SDN,TOR,SAN02,2,3,5
SDN200406200,2004,40620,SDN,TOR,SAN02,3,0,3
SDN200406210,2004,40621,SDN,ARI,SAN02,1,3,4
SDN200406220,2004,40622,SDN,ARI,SAN02,1,2,3
SDN200406230,2004,40623,SDN,ARI,SAN02,3,4,7
SDN200407020,2004,40702,SDN,KCA,SAN02,5,7,12
SDN200407030,2004,40703,SDN,KCA,SAN02,4,5,9
SDN200407040,2004,40704,SDN,KCA,SAN02,1,7,8
SDN200407050,2004,40705,SDN,HOU,SAN02,1,2,3
SDN200407060,2004,40706,SDN,HOU,SAN02,3,5,8
SDN200407070,2004,40707,SDN,HOU,SAN02,5,1,6
SDN200407080,2004,40708,SDN,COL,SAN02,5,1,6
SDN200407090,2004,40709,SDN,COL,SAN02,6,5,11
SDN200407100,2004,40710,SDN,COL,SAN02,6,2,8
SDN200407110,2004,40711,SDN,COL,SAN02,2,4,6
SDN200407260,2004,40726,SDN,SFN,SAN02,2,3,5
SDN200407270,2004,40727,SDN,SFN,SAN02,6,4,10
SDN200407280,2004,40728,SDN,SFN,SAN02,4,9,13
SDN200407290,2004,40729,SDN,SFN,SAN02,4,7,11
SDN200407300,2004,40730,SDN,LAN,SAN02,12,3,15
SDN200407310,2004,40731,SDN,LAN,SAN02,2,3,5
SDN200408010,2004,40801,SDN,LAN,SAN02,2,1,3
SDN200408030,2004,40803,SDN,PHI,SAN02,5,2,7
SDN200408040,2004,40804,SDN,PHI,SAN02,7,5,12
SDN200408050,2004,40805,SDN,PHI,SAN02,5,3,8
SDN200408060,2004,40806,SDN,PIT,SAN02,1,13,14
SDN200408070,2004,40807,SDN,PIT,SAN02,3,1,4
SDN200408080,2004,40808,SDN,PIT,SAN02,4,2,6
SDN200408160,2004,40816,SDN,ATL,SAN02,5,4,9
SDN200408170,2004,40817,SDN,ATL,SAN02,6,11,17
SDN200408180,2004,40818,SDN,ATL,SAN02,6,5,11
SDN200408200,2004,40820,SDN,FLO,SAN02,1,6,7
SDN200408210,2004,40821,SDN,FLO,SAN02,8,2,10
SDN200408220,2004,40822,SDN,FLO,SAN02,8,3,11
SDN200409030,2004,40903,SDN,COL,SAN02,6,7,13
SDN200409040,2004,40904,SDN,COL,SAN02,8,2,10
SDN200409050,2004,40905,SDN,COL,SAN02,5,2,7
SDN200409060,2004,40906,SDN,SLN,SAN02,3,7,10
SDN200409070,2004,40907,SDN,SLN,SAN02,4,2,6
SDN200409080,2004,40908,SDN,SLN,SAN02,5,10,15
SDN200409210,2004,40921,SDN,LAN,SAN02,4,9,13
SDN200409220,2004,40922,SDN,LAN,SAN02,0,4,4
SDN200409230,2004,40923,SDN,LAN,SAN02,9,6,15
SDN200409240,2004,40924,SDN,ARI,SAN02,5,6,11
SDN200409250,2004,40925,SDN,ARI,SAN02,5,6,11
SDN200409260,2004,40926,SDN,ARI,SAN02,1,7,8
SDN200409280,2004,40928,SDN,SFN,SAN02,7,5,12
SDN200409290,2004,40929,SDN,SFN,SAN02,3,4,7
SDN200409300,2004,40930,SDN,SFN,SAN02,4,1,5
SDN200504070,2005,50407,SDN,PIT,SAN02,0,1,1
SDN200504080,2005,50408,SDN,PIT,SAN02,3,2,5
SDN200504090,2005,50409,SDN,PIT,SAN02,3,11,14
SDN200504100,2005,50410,SDN,PIT,SAN02,6,3,9
SDN200504180,2005,50418,SDN,SFN,SAN02,2,7,9
SDN200504190,2005,50419,SDN,SFN,SAN02,2,5,7
SDN200504200,2005,50420,SDN,LAN,SAN02,3,1,4
SDN200504210,2005,50421,SDN,LAN,SAN02,1,6,7
SDN200504290,2005,50429,SDN,ARI,SAN02,4,5,9
SDN200504300,2005,50430,SDN,ARI,SAN02,0,2,2
SDN200505010,2005,50501,SDN,ARI,SAN02,5,2,7
SDN200505020,2005,50502,SDN,COL,SAN02,4,5,9
SDN200505030,2005,50503,SDN,COL,SAN02,1,2,3
SDN200505040,2005,50504,SDN,COL,SAN02,7,8,15
SDN200505130,2005,50513,SDN,FLO,SAN02,2,3,5
SDN200505140,2005,50514,SDN,FLO,SAN02,1,2,3
SDN200505150,2005,50515,SDN,FLO,SAN02,4,12,16
SDN200505160,2005,50516,SDN,ATL,SAN02,3,5,8
SDN200505170,2005,50517,SDN,ATL,SAN02,2,3,5
SDN200505180,2005,50518,SDN,ATL,SAN02,4,8,12
SDN200505300,2005,50530,SDN,MIL,SAN02,1,2,3
SDN200505310,2005,50531,SDN,MIL,SAN02,4,8,12
SDN200506010,2005,50601,SDN,MIL,SAN02,5,2,7
SDN200506020,2005,50602,SDN,CHN,SAN02,5,0,5
SDN200506030,2005,50603,SDN,CHN,SAN02,2,6,8
SDN200506040,2005,50604,SDN,CHN,SAN02,11,5,16
SDN200506050,2005,50605,SDN,CHN,SAN02,4,0,4
SDN200506070,2005,50607,SDN,CLE,SAN02,2,0,2
SDN200506080,2005,50608,SDN,CLE,SAN02,6,1,7
SDN200506090,2005,50609,SDN,CLE,SAN02,2,3,5
SDN200506100,2005,50610,SDN,CHA,SAN02,4,2,6
SDN200506110,2005,50611,SDN,CHA,SAN02,1,2,3
SDN200506120,2005,50612,SDN,CHA,SAN02,8,5,13
SDN200506200,2005,50620,SDN,LAN,SAN02,0,1,1
SDN200506210,2005,50621,SDN,LAN,SAN02,1,2,3
SDN200506220,2005,50622,SDN,LAN,SAN02,6,4,10
SDN200506230,2005,50623,SDN,LAN,SAN02,4,3,7
SDN200506240,2005,50624,SDN,SEA,SAN02,14,5,19
SDN200506250,2005,50625,SDN,SEA,SAN02,5,8,13
SDN200506260,2005,50626,SDN,SEA,SAN02,4,5,9
SDN200507010,2005,50701,SDN,SFN,SAN02,3,2,5
SDN200507020,2005,50702,SDN,SFN,SAN02,3,5,8
SDN200507030,2005,50703,SDN,SFN,SAN02,6,9,15
SDN200507140,2005,50714,SDN,ARI,SAN02,6,0,6
SDN200507150,2005,50715,SDN,ARI,SAN02,7,10,17
SDN200507160,2005,50716,SDN,ARI,SAN02,1,4,5
SDN200507170,2005,50717,SDN,ARI,SAN02,6,1,7
SDN200507260,2005,50726,SDN,SLN,SAN02,4,2,6
SDN200507270,2005,50727,SDN,SLN,SAN02,1,2,3
SDN200507280,2005,50728,SDN,SLN,SAN02,11,3,14
SDN200507290,2005,50729,SDN,CIN,SAN02,8,3,11
SDN200507300,2005,50730,SDN,CIN,SAN02,9,1,10
SDN200507310,2005,50731,SDN,CIN,SAN02,7,1,8
SDN200508090,2005,50809,SDN,NYN,SAN02,3,8,11
SDN200508100,2005,50810,SDN,NYN,SAN02,9,1,10
SDN200508110,2005,50811,SDN,NYN,SAN02,1,2,3
SDN200508120,2005,50812,SDN,PHI,SAN02,3,2,5
SDN200508130,2005,50813,SDN,PHI,SAN02,5,2,7
SDN200508140,2005,50814,SDN,PHI,SAN02,8,3,11
SDN200508220,2005,50822,SDN,HOU,SAN02,6,2,8
SDN200508230,2005,50823,SDN,HOU,SAN02,0,2,2
SDN200508240,2005,50824,SDN,HOU,SAN02,4,7,11
SDN200508260,2005,50826,SDN,COL,SAN02,4,3,7
SDN200508270,2005,50827,SDN,COL,SAN02,4,2,6
SDN200508280,2005,50828,SDN,COL,SAN02,3,4,7
SDN200508290,2005,50829,SDN,ARI,SAN02,7,5,12
SDN200508300,2005,50830,SDN,ARI,SAN02,3,5,8
SDN200508310,2005,50831,SDN,ARI,SAN02,5,9,14
SDN200509060,2005,50906,SDN,COL,SAN02,6,5,11
SDN200509070,2005,50907,SDN,COL,SAN02,2,4,6
SDN200509080,2005,50908,SDN,COL,SAN02,2,3,5
SDN200509160,2005,50916,SDN,WAS,SAN02,5,1,6
SDN200509170,2005,50917,SDN,WAS,SAN02,5,8,13
SDN200509180,2005,50918,SDN,WAS,SAN02,1,2,3
SDN200509260,2005,50926,SDN,SFN,SAN02,3,2,5
SDN200509270,2005,50927,SDN,SFN,SAN02,6,9,15
SDN200509280,2005,50928,SDN,SFN,SAN02,1,9,10
SDN200509290,2005,50929,SDN,SFN,SAN02,0,1,1
SDN200509300,2005,50930,SDN,LAN,SAN02,1,3,4
SDN200510010,2005,51001,SDN,LAN,SAN02,2,1,3
SDN200510020,2005,51002,SDN,LAN,SAN02,1,3,4
SDN200510080,2005,51008,SDN,SLN,SAN02,7,4,11
SDN200604030,2006,60403,SDN,SFN,SAN02,1,6,7
SDN200604050,2006,60405,SDN,SFN,SAN02,3,1,4
SDN200604070,2006,60407,SDN,COL,SAN02,10,4,14
SDN200604080,2006,60408,SDN,COL,SAN02,12,4,16
SDN200604090,2006,60409,SDN,COL,SAN02,10,4,14
SDN200604200,2006,60420,SDN,NYN,SAN02,7,2,9
SDN200604210,2006,60421,SDN,NYN,SAN02,1,2,3
SDN200604220,2006,60422,SDN,NYN,SAN02,8,1,9
SDN200604230,2006,60423,SDN,NYN,SAN02,4,7,11
SDN200604240,2006,60424,SDN,ARI,SAN02,4,1,5
SDN200604250,2006,60425,SDN,ARI,SAN02,7,0,7
SDN200604260,2006,60426,SDN,ARI,SAN02,3,2,5
SDN200604280,2006,60428,SDN,LAN,SAN02,3,0,3
SDN200604290,2006,60429,SDN,LAN,SAN02,4,2,6
SDN200604300,2006,60430,SDN,LAN,SAN02,5,6,11
SDN200605050,2006,60505,SDN,CHN,SAN02,0,1,1
SDN200605060,2006,60506,SDN,CHN,SAN02,1,2,3
SDN200605070,2006,60507,SDN,CHN,SAN02,3,6,9
SDN200605080,2006,60508,SDN,CHN,SAN02,3,8,11
SDN200605090,2006,60509,SDN,MIL,SAN02,5,4,9
SDN200605100,2006,60510,SDN,MIL,SAN02,0,3,3
SDN200605110,2006,60511,SDN,MIL,SAN02,5,8,13
SDN200605220,2006,60522,SDN,ATL,SAN02,3,1,4
SDN200605230,2006,60523,SDN,ATL,SAN02,1,2,3
SDN200605240,2006,60524,SDN,ATL,SAN02,10,6,16
SDN200605260,2006,60526,SDN,SLN,SAN02,1,7,8
SDN200605270,2006,60527,SDN,SLN,SAN02,4,3,7
SDN200605280,2006,60528,SDN,SLN,SAN02,8,10,18
SDN200605290,2006,60529,SDN,COL,SAN02,5,0,5
SDN200605300,2006,60530,SDN,COL,SAN02,0,2,2
SDN200605310,2006,60531,SDN,COL,SAN02,2,3,5
SDN200606090,2006,60609,SDN,FLO,SAN02,2,3,5
SDN200606100,2006,60610,SDN,FLO,SAN02,2,1,3
SDN200606110,2006,60611,SDN,FLO,SAN02,7,3,10
SDN200606130,2006,60613,SDN,LAN,SAN02,1,9,10
SDN200606140,2006,60614,SDN,LAN,SAN02,3,5,8
SDN200606150,2006,60615,SDN,LAN,SAN02,7,3,10
SDN200606230,2006,60623,SDN,SEA,SAN02,1,2,3
SDN200606240,2006,60624,SDN,SEA,SAN02,9,5,14
SDN200606250,2006,60625,SDN,SEA,SAN02,9,4,13
SDN200606270,2006,60627,SDN,OAK,SAN02,0,3,3
SDN200606280,2006,60628,SDN,OAK,SAN02,1,8,9
SDN200606290,2006,60629,SDN,OAK,SAN02,6,5,11
SDN200606300,2006,60630,SDN,SFN,SAN02,5,6,11
SDN200607011,2006,60701,SDN,SFN,SAN02,4,7,11
SDN200607012,2006,60701,SDN,SFN,SAN02,4,1,5
SDN200607020,2006,60702,SDN,SFN,SAN02,6,2,8
SDN200607140,2006,60714,SDN,ATL,SAN02,15,12,27
SDN200607150,2006,60715,SDN,ATL,SAN02,11,3,14
SDN200607160,2006,60716,SDN,ATL,SAN02,10,5,15
SDN200607170,2006,60717,SDN,PHI,SAN02,6,8,14
SDN200607180,2006,60718,SDN,PHI,SAN02,6,10,16
SDN200607190,2006,60719,SDN,PHI,SAN02,5,4,9
SDN200608010,2006,60801,SDN,HOU,SAN02,1,0,1
SDN200608020,2006,60802,SDN,HOU,SAN02,7,1,8
SDN200608030,2006,60803,SDN,HOU,SAN02,2,5,7
SDN200608040,2006,60804,SDN,WAS,SAN02,6,2,8
SDN200608050,2006,60805,SDN,WAS,SAN02,3,6,9
SDN200608060,2006,60806,SDN,WAS,SAN02,2,3,5
SDN200608140,2006,60814,SDN,SFN,SAN02,1,0,1
SDN200608150,2006,60815,SDN,SFN,SAN02,3,2,5
SDN200608160,2006,60816,SDN,SFN,SAN02,7,5,12
SDN200608170,2006,60817,SDN,SFN,SAN02,8,4,12
SDN200608180,2006,60818,SDN,ARI,SAN02,2,8,10
SDN200608190,2006,60819,SDN,ARI,SAN02,5,3,8
SDN200608200,2006,60820,SDN,ARI,SAN02,1,2,3
SDN200608210,2006,60821,SDN,LAN,SAN02,2,4,6
SDN200608220,2006,60822,SDN,LAN,SAN02,0,1,1
SDN200608230,2006,60823,SDN,LAN,SAN02,2,7,9
SDN200609010,2006,60901,SDN,CIN,SAN02,6,2,8
SDN200609020,2006,60902,SDN,CIN,SAN02,1,7,8
SDN200609030,2006,60903,SDN,CIN,SAN02,1,2,3
SDN200609040,2006,60904,SDN,COL,SAN02,5,7,12
SDN200609050,2006,60905,SDN,COL,SAN02,4,5,9
SDN200609060,2006,60906,SDN,COL,SAN02,0,2,2
SDN200609190,2006,60919,SDN,ARI,SAN02,2,5,7
SDN200609200,2006,60920,SDN,ARI,SAN02,8,2,10
SDN200609210,2006,60921,SDN,ARI,SAN02,1,3,4
SDN200609220,2006,60922,SDN,PIT,SAN02,2,6,8
SDN200609230,2006,60923,SDN,PIT,SAN02,1,2,3
SDN200609240,2006,60924,SDN,PIT,SAN02,1,2,3
SDN200610030,2006,61003,SDN,SLN,SAN02,5,1,6
SDN200610050,2006,61005,SDN,SLN,SAN02,2,0,2
SDN200704060,2007,70406,SDN,COL,SAN02,4,3,7
SDN200704070,2007,70407,SDN,COL,SAN02,2,3,5
SDN200704080,2007,70408,SDN,COL,SAN02,1,2,3
SDN200704090,2007,70409,SDN,SFN,SAN02,0,1,1
SDN200704100,2007,70410,SDN,SFN,SAN02,6,5,11
SDN200704110,2007,70411,SDN,SFN,SAN02,0,4,4
SDN200704180,2007,70418,SDN,ARI,SAN02,5,2,7
SDN200704190,2007,70419,SDN,ARI,SAN02,6,11,17
SDN200704270,2007,70427,SDN,LAN,SAN02,6,5,11
SDN200704280,2007,70428,SDN,LAN,SAN02,2,3,5
SDN200704290,2007,70429,SDN,LAN,SAN02,5,4,9
SDN200704300,2007,70430,SDN,WAS,SAN02,3,2,5
SDN200705010,2007,70501,SDN,WAS,SAN02,0,3,3
SDN200705020,2007,70502,SDN,WAS,SAN02,3,7,10
SDN200705110,2007,70511,SDN,SLN,SAN02,0,7,7
SDN200705120,2007,70512,SDN,SLN,SAN02,5,0,5
SDN200705130,2007,70513,SDN,SLN,SAN02,0,3,3
SDN200705140,2007,70514,SDN,CIN,SAN02,1,7,8
SDN200705150,2007,70515,SDN,CIN,SAN02,2,1,3
SDN200705160,2007,70516,SDN,CIN,SAN02,2,3,5
SDN200705220,2007,70522,SDN,CHN,SAN02,1,5,6
SDN200705230,2007,70523,SDN,CHN,SAN02,1,2,3
SDN200705240,2007,70524,SDN,CHN,SAN02,3,1,4
SDN200705250,2007,70525,SDN,MIL,SAN02,6,8,14
SDN200705260,2007,70526,SDN,MIL,SAN02,3,6,9
SDN200705270,2007,70527,SDN,MIL,SAN02,0,3,3
SDN200706050,2007,70605,SDN,LAN,SAN02,0,1,1
SDN200706060,2007,70606,SDN,LAN,SAN02,2,5,7
SDN200706070,2007,70607,SDN,LAN,SAN02,5,6,11
SDN200706080,2007,70608,SDN,SEA,SAN02,6,5,11
SDN200706090,2007,70609,SDN,SEA,SAN02,6,5,11
SDN200706100,2007,70610,SDN,SEA,SAN02,4,3,7
SDN200706190,2007,70619,SDN,BAL,SAN02,6,12,18
SDN200706200,2007,70620,SDN,BAL,SAN02,7,1,8
SDN200706210,2007,70621,SDN,BAL,SAN02,6,3,9
SDN200706220,2007,70622,SDN,BOS,SAN02,2,1,3
SDN200706230,2007,70623,SDN,BOS,SAN02,1,6,7
SDN200706240,2007,70624,SDN,BOS,SAN02,4,2,6
SDN200707020,2007,70702,SDN,FLO,SAN02,1,3,4
SDN200707030,2007,70703,SDN,FLO,SAN02,6,4,10
SDN200707040,2007,70704,SDN,FLO,SAN02,0,1,1
SDN200707050,2007,70705,SDN,FLO,SAN02,3,2,5
SDN200707060,2007,70706,SDN,ATL,SAN02,7,4,11
SDN200707070,2007,70707,SDN,ATL,SAN02,5,8,13
SDN200707080,2007,70708,SDN,ATL,SAN02,5,4,9
SDN200707160,2007,70716,SDN,NYN,SAN02,1,5,6
SDN200707170,2007,70717,SDN,NYN,SAN02,7,0,7
SDN200707180,2007,70718,SDN,NYN,SAN02,4,5,9
SDN200707190,2007,70719,SDN,PHI,SAN02,0,1,1
SDN200707200,2007,70720,SDN,PHI,SAN02,7,3,10
SDN200707210,2007,70721,SDN,PHI,SAN02,12,4,16
SDN200707220,2007,70722,SDN,PHI,SAN02,9,0,9
SDN200707310,2007,70731,SDN,ARI,SAN02,4,0,4
SDN200708010,2007,70801,SDN,ARI,SAN02,9,5,14
SDN200708020,2007,70802,SDN,ARI,SAN02,0,11,11
SDN200708030,2007,70803,SDN,SFN,SAN02,3,4,7
SDN200708040,2007,70804,SDN,SFN,SAN02,2,3,5
SDN200708050,2007,70805,SDN,SFN,SAN02,4,5,9
SDN200708140,2007,70814,SDN,COL,SAN02,0,8,8
SDN200708150,2007,70815,SDN,COL,SAN02,3,0,3
SDN200708160,2007,70816,SDN,COL,SAN02,9,11,20
SDN200708170,2007,70817,SDN,HOU,SAN02,3,1,4
SDN200708180,2007,70818,SDN,HOU,SAN02,3,2,5
SDN200708190,2007,70819,SDN,HOU,SAN02,3,5,8
SDN200708270,2007,70827,SDN,ARI,SAN02,1,3,4
SDN200708280,2007,70828,SDN,ARI,SAN02,4,6,10
SDN200708290,2007,70829,SDN,ARI,SAN02,1,3,4
SDN200708300,2007,70830,SDN,ARI,SAN02,8,7,15
SDN200708310,2007,70831,SDN,LAN,SAN02,4,6,10
SDN200709010,2007,70901,SDN,LAN,SAN02,0,7,7
SDN200709020,2007,70902,SDN,LAN,SAN02,5,0,5
SDN200709140,2007,70914,SDN,SFN,SAN02,4,5,9
SDN200709150,2007,70915,SDN,SFN,SAN02,0,6,6
SDN200709160,2007,70916,SDN,SFN,SAN02,1,5,6
SDN200709170,2007,70917,SDN,PIT,SAN02,0,3,3
SDN200709180,2007,70918,SDN,PIT,SAN02,3,5,8
SDN200709190,2007,70919,SDN,PIT,SAN02,3,5,8
SDN200709200,2007,70920,SDN,PIT,SAN02,3,6,9
SDN200709210,2007,70921,SDN,COL,SAN02,2,1,3
SDN200709220,2007,70922,SDN,COL,SAN02,6,2,8
SDN200709230,2007,70923,SDN,COL,SAN02,7,3,10
SDN200803310,2008,80331,SDN,HOU,SAN02,0,4,4
SDN200804010,2008,80401,SDN,HOU,SAN02,1,2,3
SDN200804020,2008,80402,SDN,HOU,SAN02,9,6,15
SDN200804030,2008,80403,SDN,HOU,SAN02,2,3,5
SDN200804040,2008,80404,SDN,LAN,SAN02,7,1,8
SDN200804050,2008,80405,SDN,LAN,SAN02,1,4,5
SDN200804060,2008,80406,SDN,LAN,SAN02,3,2,5
SDN200804150,2008,80415,SDN,COL,SAN02,0,6,6
SDN200804160,2008,80416,SDN,COL,SAN02,10,2,12
SDN200804170,2008,80417,SDN,COL,SAN02,2,1,3
SDN200804230,2008,80423,SDN,SFN,SAN02,3,2,5
SDN200804240,2008,80424,SDN,SFN,SAN02,1,0,1
SDN200804250,2008,80425,SDN,ARI,SAN02,5,1,6
SDN200804260,2008,80426,SDN,ARI,SAN02,7,8,15
SDN200804270,2008,80427,SDN,ARI,SAN02,2,1,3
SDN200805090,2008,80509,SDN,COL,SAN02,4,2,6
SDN200805100,2008,80510,SDN,COL,SAN02,2,3,5
SDN200805110,2008,80511,SDN,COL,SAN02,1,6,7
SDN200805190,2008,80519,SDN,SLN,SAN02,8,2,10
SDN200805200,2008,80520,SDN,SLN,SAN02,2,3,5
SDN200805210,2008,80521,SDN,SLN,SAN02,11,3,14
SDN200805220,2008,80522,SDN,CIN,SAN02,2,8,10
SDN200805230,2008,80523,SDN,CIN,SAN02,3,2,5
SDN200805240,2008,80524,SDN,CIN,SAN02,7,2,9
SDN200805250,2008,80525,SDN,CIN,SAN02,9,12,21
SDN200805270,2008,80527,SDN,WAS,SAN02,2,4,6
SDN200805280,2008,80528,SDN,WAS,SAN02,6,4,10
SDN200805290,2008,80529,SDN,WAS,SAN02,2,5,7
SDN200806020,2008,80602,SDN,CHN,SAN02,7,6,13
SDN200806030,2008,80603,SDN,CHN,SAN02,9,6,15
SDN200806040,2008,80604,SDN,CHN,SAN02,1,2,3
SDN200806050,2008,80605,SDN,NYN,SAN02,1,2,3
SDN200806060,2008,80606,SDN,NYN,SAN02,1,2,3
SDN200806070,2008,80607,SDN,NYN,SAN02,1,2,3
SDN200806080,2008,80608,SDN,NYN,SAN02,6,8,14
SDN200806100,2008,80610,SDN,LAN,SAN02,7,2,9
SDN200806110,2008,80611,SDN,LAN,SAN02,1,4,5
SDN200806120,2008,80612,SDN,LAN,SAN02,0,9,9
SDN200806200,2008,80620,SDN,DET,SAN02,2,6,8
SDN200806210,2008,80621,SDN,DET,SAN02,7,5,12
SDN200806220,2008,80622,SDN,DET,SAN02,5,3,8
SDN200806240,2008,80624,SDN,MIN,SAN02,3,1,4
SDN200806250,2008,80625,SDN,MIN,SAN02,9,3,12
SDN200806260,2008,80626,SDN,MIN,SAN02,4,3,7
SDN200806270,2008,80627,SDN,SEA,SAN02,5,2,7
SDN200806280,2008,80628,SDN,SEA,SAN02,4,2,6
SDN200806290,2008,80629,SDN,SEA,SAN02,9,2,11
SDN200807070,2008,80707,SDN,FLO,SAN02,3,1,4
SDN200807080,2008,80708,SDN,FLO,SAN02,1,10,11
SDN200807090,2008,80709,SDN,FLO,SAN02,5,2,7
SDN200807110,2008,80711,SDN,ATL,SAN02,0,4,4
SDN200807120,2008,80712,SDN,ATL,SAN02,4,1,5
SDN200807130,2008,80713,SDN,ATL,SAN02,12,3,15
SDN200807280,2008,80728,SDN,ARI,SAN02,5,8,13
SDN200807290,2008,80729,SDN,ARI,SAN02,3,0,3
SDN200807300,2008,80730,SDN,ARI,SAN02,7,3,10
SDN200808010,2008,80801,SDN,SFN,SAN02,3,2,5
SDN200808020,2008,80802,SDN,SFN,SAN02,2,0,2
SDN200808030,2008,80803,SDN,SFN,SAN02,1,4,5
SDN200808120,2008,80812,SDN,MIL,SAN02,5,2,7
SDN200808130,2008,80813,SDN,MIL,SAN02,7,1,8
SDN200808140,2008,80814,SDN,MIL,SAN02,2,3,5
SDN200808150,2008,80815,SDN,PHI,SAN02,1,0,1
SDN200808160,2008,80816,SDN,PHI,SAN02,3,8,11
SDN200808170,2008,80817,SDN,PHI,SAN02,2,1,3
SDN200808250,2008,80825,SDN,ARI,SAN02,2,4,6
SDN200808260,2008,80826,SDN,ARI,SAN02,2,9,11
SDN200808270,2008,80827,SDN,ARI,SAN02,4,5,9
SDN200808290,2008,80829,SDN,COL,SAN02,9,4,13
SDN200808300,2008,80830,SDN,COL,SAN02,4,9,13
SDN200808310,2008,80831,SDN,COL,SAN02,1,2,3
SDN200809080,2008,80908,SDN,LAN,SAN02,0,4,4
SDN200809090,2008,80909,SDN,LAN,SAN02,6,2,8
SDN200809100,2008,80910,SDN,LAN,SAN02,7,2,9
SDN200809110,2008,80911,SDN,SFN,SAN02,3,11,14
SDN200809120,2008,80912,SDN,SFN,SAN02,5,2,7
SDN200809130,2008,80913,SDN,SFN,SAN02,7,0,7
SDN200809140,2008,80914,SDN,SFN,SAN02,8,6,14
SDN200809260,2008,80926,SDN,PIT,SAN02,6,3,9
SDN200809270,2008,80927,SDN,PIT,SAN02,2,3,5
SDN200809280,2008,80928,SDN,PIT,SAN02,6,1,7
SDN200904060,2009,90406,SDN,LAN,SAN02,4,1,5
SDN200904070,2009,90407,SDN,LAN,SAN02,2,4,6
SDN200904080,2009,90408,SDN,LAN,SAN02,5,2,7
SDN200904090,2009,90409,SDN,LAN,SAN02,3,4,7
SDN200904100,2009,90410,SDN,SFN,SAN02,3,7,10
SDN200904110,2009,90411,SDN,SFN,SAN02,3,6,9
SDN200904120,2009,90412,SDN,SFN,SAN02,1,6,7
SDN200904240,2009,90424,SDN,PIT,SAN02,3,4,7
SDN200904250,2009,90425,SDN,PIT,SAN02,10,1,11
SDN200904260,2009,90426,SDN,PIT,SAN02,8,3,11
SDN200905040,2009,90504,SDN,COL,SAN02,9,6,15
SDN200905050,2009,90505,SDN,COL,SAN02,1,2,3
SDN200905060,2009,90506,SDN,ARI,SAN02,3,1,4
SDN200905070,2009,90507,SDN,ARI,SAN02,3,4,7
SDN200905150,2009,90515,SDN,CIN,SAN02,3,5,8
SDN200905160,2009,90516,SDN,CIN,SAN02,5,6,11
SDN200905170,2009,90517,SDN,CIN,SAN02,1,3,4
SDN200905190,2009,90519,SDN,SFN,SAN02,1,2,3
SDN200905200,2009,90520,SDN,SFN,SAN02,1,2,3
SDN200905210,2009,90521,SDN,SFN,SAN02,2,3,5
SDN200905220,2009,90522,SDN,CHN,SAN02,0,4,4
SDN200905230,2009,90523,SDN,CHN,SAN02,1,3,4
SDN200905240,2009,90524,SDN,CHN,SAN02,2,7,9
SDN200906010,2009,90601,SDN,PHI,SAN02,5,3,8
SDN200906020,2009,90602,SDN,PHI,SAN02,10,5,15
SDN200906030,2009,90603,SDN,PHI,SAN02,5,1,6
SDN200906050,2009,90605,SDN,ARI,SAN02,8,0,8
SDN200906060,2009,90606,SDN,ARI,SAN02,4,6,10
SDN200906070,2009,90607,SDN,ARI,SAN02,9,6,15
SDN200906080,2009,90608,SDN,ARI,SAN02,3,6,9
SDN200906160,2009,90616,SDN,SEA,SAN02,5,0,5
SDN200906170,2009,90617,SDN,SEA,SAN02,4,3,7
SDN200906180,2009,90618,SDN,SEA,SAN02,3,4,7
SDN200906190,2009,90619,SDN,OAK,SAN02,7,5,12
SDN200906200,2009,90620,SDN,OAK,SAN02,6,3,9
SDN200906210,2009,90621,SDN,OAK,SAN02,1,4,5
SDN200906290,2009,90629,SDN,HOU,SAN02,3,1,4
SDN200906300,2009,90630,SDN,HOU,SAN02,3,4,7
SDN200907010,2009,90701,SDN,HOU,SAN02,7,1,8
SDN200907020,2009,90702,SDN,HOU,SAN02,7,2,9
SDN200907030,2009,90703,SDN,LAN,SAN02,6,3,9
SDN200907040,2009,90704,SDN,LAN,SAN02,4,7,11
SDN200907050,2009,90705,SDN,LAN,SAN02,7,6,13
SDN200907160,2009,90716,SDN,COL,SAN02,10,1,11
SDN200907170,2009,90717,SDN,COL,SAN02,5,3,8
SDN200907180,2009,90718,SDN,COL,SAN02,1,3,4
SDN200907190,2009,90719,SDN,COL,SAN02,6,1,7
SDN200907200,2009,90720,SDN,FLO,SAN02,3,2,5
SDN200907210,2009,90721,SDN,FLO,SAN02,3,2,5
SDN200907220,2009,90722,SDN,FLO,SAN02,5,0,5
SDN200907310,2009,90731,SDN,MIL,SAN02,7,11,18
SDN200908010,2009,90801,SDN,MIL,SAN02,2,4,6
SDN200908020,2009,90802,SDN,MIL,SAN02,6,1,7
SDN200908030,2009,90803,SDN,ATL,SAN02,2,4,6
SDN200908040,2009,90804,SDN,ATL,SAN02,9,2,11
SDN200908050,2009,90805,SDN,ATL,SAN02,6,2,8
SDN200908060,2009,90806,SDN,NYN,SAN02,3,8,11
SDN200908070,2009,90807,SDN,NYN,SAN02,2,6,8
SDN200908080,2009,90808,SDN,NYN,SAN02,1,3,4
SDN200908090,2009,90809,SDN,NYN,SAN02,5,1,6
SDN200908170,2009,90817,SDN,CHN,SAN02,1,4,5
SDN200908180,2009,90818,SDN,CHN,SAN02,3,6,9
SDN200908190,2009,90819,SDN,CHN,SAN02,7,1,8
SDN200908200,2009,90820,SDN,SLN,SAN02,5,1,6
SDN200908210,2009,90821,SDN,SLN,SAN02,0,4,4
SDN200908220,2009,90822,SDN,SLN,SAN02,7,0,7
SDN200908230,2009,90823,SDN,SLN,SAN02,5,2,7
SDN200908310,2009,90831,SDN,WAS,SAN02,1,3,4
SDN200909010,2009,90901,SDN,WAS,SAN02,1,4,5
SDN200909020,2009,90902,SDN,WAS,SAN02,0,7,7
SDN200909110,2009,90911,SDN,COL,SAN02,4,1,5
SDN200909120,2009,90912,SDN,COL,SAN02,2,3,5
SDN200909130,2009,90913,SDN,COL,SAN02,3,7,10
SDN200909140,2009,90914,SDN,ARI,SAN02,4,2,6
SDN200909150,2009,90915,SDN,ARI,SAN02,4,2,6
SDN200909160,2009,90916,SDN,ARI,SAN02,5,6,11
SDN200909290,2009,90929,SDN,LAN,SAN02,1,3,4
SDN200909300,2009,90930,SDN,LAN,SAN02,0,5,5
SDN200910020,2009,91002,SDN,SFN,SAN02,7,2,9
SDN200910030,2009,91003,SDN,SFN,SAN02,0,2,2
SDN200910040,2009,91004,SDN,SFN,SAN02,4,3,7
SEA200004040,2000,404,SEA,BOS,SEA03,2,0,2
SEA200004050,2000,405,SEA,BOS,SEA03,3,9,12
SEA200004060,2000,406,SEA,BOS,SEA03,2,5,7
SEA200004070,2000,407,SEA,NYA,SEA03,5,7,12
SEA200004080,2000,408,SEA,NYA,SEA03,3,2,5
SEA200004090,2000,409,SEA,NYA,SEA03,3,9,12
SEA200004210,2000,421,SEA,KCA,SEA03,2,10,12
SEA200004220,2000,422,SEA,KCA,SEA03,2,4,6
SEA200004230,2000,423,SEA,KCA,SEA03,5,8,13
SEA200004240,2000,424,SEA,CLE,SEA03,6,0,6
SEA200004250,2000,425,SEA,CLE,SEA03,5,8,13
SEA200004260,2000,426,SEA,CLE,SEA03,5,3,8
SEA200005050,2000,505,SEA,ANA,SEA03,6,5,11
SEA200005060,2000,506,SEA,ANA,SEA03,0,1,1
SEA200005070,2000,507,SEA,ANA,SEA03,2,8,10
SEA200005150,2000,515,SEA,MIN,SEA03,0,14,14
SEA200005160,2000,516,SEA,MIN,SEA03,5,9,14
SEA200005170,2000,517,SEA,MIN,SEA03,0,4,4
SEA200005190,2000,519,SEA,TBA,SEA03,6,7,13
SEA200005200,2000,520,SEA,TBA,SEA03,4,3,7
SEA200005210,2000,521,SEA,TBA,SEA03,4,8,12
SEA200005290,2000,529,SEA,CHA,SEA03,4,5,9
SEA200005300,2000,530,SEA,CHA,SEA03,2,1,3
SEA200005310,2000,531,SEA,CHA,SEA03,4,3,7
SEA200006020,2000,602,SEA,SDN,SEA03,4,7,11
SEA200006030,2000,603,SEA,SDN,SEA03,7,4,11
SEA200006040,2000,604,SEA,SDN,SEA03,4,6,10
SEA200006050,2000,605,SEA,COL,SEA03,2,6,8
SEA200006060,2000,606,SEA,COL,SEA03,1,4,5
SEA200006070,2000,607,SEA,COL,SEA03,6,1,7
SEA200006190,2000,619,SEA,TBA,SEA03,10,3,13
SEA200006200,2000,620,SEA,TBA,SEA03,3,4,7
SEA200006210,2000,621,SEA,TBA,SEA03,5,8,13
SEA200006220,2000,622,SEA,BAL,SEA03,4,11,15
SEA200006230,2000,623,SEA,BAL,SEA03,3,8,11
SEA200006240,2000,624,SEA,BAL,SEA03,1,2,3
SEA200006250,2000,625,SEA,BAL,SEA03,2,4,6
SEA200006270,2000,627,SEA,ANA,SEA03,3,5,8
SEA200006280,2000,628,SEA,ANA,SEA03,3,2,5
SEA200006290,2000,629,SEA,ANA,SEA03,2,7,9
SEA200007070,2000,707,SEA,LAN,SEA03,3,2,5
SEA200007080,2000,708,SEA,LAN,SEA03,0,11,11
SEA200007090,2000,709,SEA,LAN,SEA03,0,2,2
SEA200007210,2000,721,SEA,TEX,SEA03,3,12,15
SEA200007220,2000,722,SEA,TEX,SEA03,5,13,18
SEA200007230,2000,723,SEA,TEX,SEA03,3,2,5
SEA200007240,2000,724,SEA,OAK,SEA03,4,6,10
SEA200007250,2000,725,SEA,OAK,SEA03,8,7,15
SEA200007260,2000,726,SEA,OAK,SEA03,6,1,7
SEA200007270,2000,727,SEA,TOR,SEA03,7,2,9
SEA200007280,2000,728,SEA,TOR,SEA03,4,7,11
SEA200007290,2000,729,SEA,TOR,SEA03,5,6,11
SEA200007300,2000,730,SEA,TOR,SEA03,6,10,16
SEA200007310,2000,731,SEA,BOS,SEA03,8,5,13
SEA200008010,2000,801,SEA,BOS,SEA03,4,5,9
SEA200008020,2000,802,SEA,BOS,SEA03,5,2,7
SEA200008110,2000,811,SEA,CLE,SEA03,1,7,8
SEA200008120,2000,812,SEA,CLE,SEA03,5,4,9
SEA200008130,2000,813,SEA,CLE,SEA03,10,4,14
SEA200008140,2000,814,SEA,DET,SEA03,15,4,19
SEA200008150,2000,815,SEA,DET,SEA03,9,0,9
SEA200008160,2000,816,SEA,DET,SEA03,12,8,20
SEA200008250,2000,825,SEA,CHA,SEA03,4,1,5
SEA200008260,2000,826,SEA,CHA,SEA03,5,11,16
SEA200008270,2000,827,SEA,CHA,SEA03,2,1,3
SEA200008280,2000,828,SEA,NYA,SEA03,9,1,10
SEA200008290,2000,829,SEA,NYA,SEA03,3,5,8
SEA200008300,2000,830,SEA,NYA,SEA03,5,4,9
SEA200009080,2000,908,SEA,MIN,SEA03,4,2,6
SEA200009090,2000,909,SEA,MIN,SEA03,2,7,9
SEA200009100,2000,910,SEA,MIN,SEA03,1,8,9
SEA200009110,2000,911,SEA,KCA,SEA03,6,3,9
SEA200009120,2000,912,SEA,KCA,SEA03,3,11,14
SEA200009130,2000,913,SEA,KCA,SEA03,1,2,3
SEA200009210,2000,921,SEA,OAK,SEA03,5,2,7
SEA200009220,2000,922,SEA,OAK,SEA03,8,3,11
SEA200009230,2000,923,SEA,OAK,SEA03,8,2,10
SEA200009240,2000,924,SEA,OAK,SEA03,2,3,5
SEA200009260,2000,926,SEA,TEX,SEA03,0,5,5
SEA200009270,2000,927,SEA,TEX,SEA03,4,6,10
SEA200009280,2000,928,SEA,TEX,SEA03,13,6,19
SEA200010060,2000,1006,SEA,CHA,SEA03,1,2,3
SEA200010130,2000,1013,SEA,NYA,SEA03,8,2,10
SEA200010140,2000,1014,SEA,NYA,SEA03,5,0,5
SEA200010150,2000,1015,SEA,NYA,SEA03,2,6,8
SEA200104020,2001,10402,SEA,OAK,SEA03,4,5,9
SEA200104030,2001,10403,SEA,OAK,SEA03,5,1,6
SEA200104040,2001,10404,SEA,OAK,SEA03,2,10,12
SEA200104160,2001,10416,SEA,TEX,SEA03,7,9,16
SEA200104170,2001,10417,SEA,TEX,SEA03,4,6,10
SEA200104180,2001,10418,SEA,TEX,SEA03,8,6,14
SEA200104190,2001,10419,SEA,ANA,SEA03,2,3,5
SEA200104200,2001,10420,SEA,ANA,SEA03,1,4,5
SEA200104210,2001,10421,SEA,ANA,SEA03,2,5,7
SEA200104220,2001,10422,SEA,ANA,SEA03,0,5,5
SEA200105010,2001,10501,SEA,BOS,SEA03,2,0,2
SEA200105020,2001,10502,SEA,BOS,SEA03,1,5,6
SEA200105030,2001,10503,SEA,BOS,SEA03,3,10,13
SEA200105040,2001,10504,SEA,TOR,SEA03,8,3,11
SEA200105050,2001,10505,SEA,TOR,SEA03,5,7,12
SEA200105060,2001,10506,SEA,TOR,SEA03,11,3,14
SEA200105150,2001,10515,SEA,CHA,SEA03,3,4,7
SEA200105160,2001,10516,SEA,CHA,SEA03,2,7,9
SEA200105170,2001,10517,SEA,CHA,SEA03,1,5,6
SEA200105180,2001,10518,SEA,NYA,SEA03,14,10,24
SEA200105190,2001,10519,SEA,NYA,SEA03,2,1,3
SEA200105200,2001,10520,SEA,NYA,SEA03,2,6,8
SEA200105290,2001,10529,SEA,BAL,SEA03,2,3,5
SEA200105300,2001,10530,SEA,BAL,SEA03,5,12,17
SEA200105310,2001,10531,SEA,BAL,SEA03,1,2,3
SEA200106010,2001,10601,SEA,TBA,SEA03,4,8,12
SEA200106020,2001,10602,SEA,TBA,SEA03,4,7,11
SEA200106030,2001,10603,SEA,TBA,SEA03,4,8,12
SEA200106040,2001,10604,SEA,TEX,SEA03,6,11,17
SEA200106050,2001,10605,SEA,TEX,SEA03,4,5,9
SEA200106060,2001,10606,SEA,TEX,SEA03,3,7,10
SEA200106080,2001,10608,SEA,SDN,SEA03,1,7,8
SEA200106090,2001,10609,SEA,SDN,SEA03,6,3,9
SEA200106100,2001,10610,SEA,SDN,SEA03,1,8,9
SEA200106220,2001,10622,SEA,ANA,SEA03,8,1,9
SEA200106230,2001,10623,SEA,ANA,SEA03,2,1,3
SEA200106240,2001,10624,SEA,ANA,SEA03,3,7,10
SEA200106260,2001,10626,SEA,OAK,SEA03,3,7,10
SEA200106270,2001,10627,SEA,OAK,SEA03,6,3,9
SEA200106280,2001,10628,SEA,OAK,SEA03,6,3,9
SEA200107120,2001,10712,SEA,SFN,SEA03,3,4,7
SEA200107130,2001,10713,SEA,SFN,SEA03,5,3,8
SEA200107140,2001,10714,SEA,SFN,SEA03,2,3,5
SEA200107150,2001,10715,SEA,ARI,SEA03,0,8,8
SEA200107160,2001,10716,SEA,ARI,SEA03,5,3,8
SEA200107170,2001,10717,SEA,ARI,SEA03,1,6,7
SEA200107240,2001,10724,SEA,KCA,SEA03,6,1,7
SEA200107250,2001,10725,SEA,KCA,SEA03,5,1,6
SEA200107260,2001,10726,SEA,KCA,SEA03,0,4,4
SEA200107270,2001,10727,SEA,MIN,SEA03,4,11,15
SEA200107280,2001,10728,SEA,MIN,SEA03,1,5,6
SEA200107290,2001,10729,SEA,MIN,SEA03,2,10,12
SEA200108070,2001,10807,SEA,TOR,SEA03,4,5,9
SEA200108080,2001,10808,SEA,TOR,SEA03,4,12,16
SEA200108090,2001,10809,SEA,TOR,SEA03,6,5,11
SEA200108100,2001,10810,SEA,CHA,SEA03,8,6,14
SEA200108110,2001,10811,SEA,CHA,SEA03,3,4,7
SEA200108120,2001,10812,SEA,CHA,SEA03,1,2,3
SEA200108200,2001,10820,SEA,DET,SEA03,4,1,5
SEA200108210,2001,10821,SEA,DET,SEA03,1,4,5
SEA200108220,2001,10822,SEA,DET,SEA03,1,16,17
SEA200108230,2001,10823,SEA,DET,SEA03,1,5,6
SEA200108240,2001,10824,SEA,CLE,SEA03,1,4,5
SEA200108250,2001,10825,SEA,CLE,SEA03,2,3,5
SEA200108260,2001,10826,SEA,CLE,SEA03,4,3,7
SEA200109030,2001,10903,SEA,TBA,SEA03,2,3,5
SEA200109040,2001,10904,SEA,TBA,SEA03,8,3,11
SEA200109050,2001,10905,SEA,TBA,SEA03,6,12,18
SEA200109070,2001,10907,SEA,BAL,SEA03,1,10,11
SEA200109080,2001,10908,SEA,BAL,SEA03,1,6,7
SEA200109090,2001,10909,SEA,BAL,SEA03,0,6,6
SEA200109180,2001,10918,SEA,ANA,SEA03,0,4,4
SEA200109190,2001,10919,SEA,ANA,SEA03,0,5,5
SEA200109200,2001,10920,SEA,ANA,SEA03,6,3,9
SEA200109280,2001,10928,SEA,OAK,SEA03,3,5,8
SEA200109290,2001,10929,SEA,OAK,SEA03,8,4,12
SEA200109300,2001,10930,SEA,OAK,SEA03,3,6,9
SEA200110040,2001,11004,SEA,TEX,SEA03,1,16,17
SEA200110050,2001,11005,SEA,TEX,SEA03,2,6,8
SEA200110060,2001,11006,SEA,TEX,SEA03,0,1,1
SEA200110070,2001,11007,SEA,TEX,SEA03,4,3,7
SEA200110090,2001,11009,SEA,CLE,SEA03,5,0,5
SEA200110110,2001,11011,SEA,CLE,SEA03,1,5,6
SEA200110150,2001,11015,SEA,CLE,SEA03,1,3,4
SEA200110170,2001,11017,SEA,NYA,SEA03,4,2,6
SEA200110180,2001,11018,SEA,NYA,SEA03,3,2,5
SEA200204010,2002,20401,SEA,CHA,SEA03,6,5,11
SEA200204020,2002,20402,SEA,CHA,SEA03,4,7,11
SEA200204030,2002,20403,SEA,CHA,SEA03,6,7,13
SEA200204050,2002,20405,SEA,OAK,SEA03,1,7,8
SEA200204060,2002,20406,SEA,OAK,SEA03,8,3,11
SEA200204070,2002,20407,SEA,OAK,SEA03,6,5,11
SEA200204190,2002,20419,SEA,TEX,SEA03,9,0,9
SEA200204200,2002,20420,SEA,TEX,SEA03,2,3,5
SEA200204210,2002,20421,SEA,TEX,SEA03,3,5,8
SEA200204220,2002,20422,SEA,ANA,SEA03,5,16,21
SEA200204230,2002,20423,SEA,ANA,SEA03,0,1,1
SEA200204240,2002,20424,SEA,ANA,SEA03,10,6,16
SEA200204260,2002,20426,SEA,NYA,SEA03,7,1,8
SEA200204270,2002,20427,SEA,NYA,SEA03,0,1,1
SEA200204280,2002,20428,SEA,NYA,SEA03,4,3,7
SEA200205070,2002,20507,SEA,TOR,SEA03,4,1,5
SEA200205080,2002,20508,SEA,TOR,SEA03,4,5,9
SEA200205090,2002,20509,SEA,TOR,SEA03,7,8,15
SEA200205100,2002,20510,SEA,BOS,SEA03,2,7,9
SEA200205110,2002,20511,SEA,BOS,SEA03,1,3,4
SEA200205120,2002,20512,SEA,BOS,SEA03,10,4,14
SEA200205210,2002,20521,SEA,TBA,SEA03,1,0,1
SEA200205220,2002,20522,SEA,TBA,SEA03,3,2,5
SEA200205230,2002,20523,SEA,TBA,SEA03,3,7,10
SEA200205240,2002,20524,SEA,BAL,SEA03,2,6,8
SEA200205250,2002,20525,SEA,BAL,SEA03,3,2,5
SEA200205260,2002,20526,SEA,BAL,SEA03,1,8,9
SEA200206070,2002,20607,SEA,CHN,SEA03,2,0,2
SEA200206080,2002,20608,SEA,CHN,SEA03,2,4,6
SEA200206090,2002,20609,SEA,CHN,SEA03,5,1,6
SEA200206100,2002,20610,SEA,SLN,SEA03,0,10,10
SEA200206110,2002,20611,SEA,SLN,SEA03,7,4,11
SEA200206120,2002,20612,SEA,SLN,SEA03,0,5,5
SEA200206240,2002,20624,SEA,OAK,SEA03,13,2,15
SEA200206250,2002,20625,SEA,OAK,SEA03,1,7,8
SEA200206260,2002,20626,SEA,OAK,SEA03,0,1,1
SEA200206270,2002,20627,SEA,OAK,SEA03,4,7,11
SEA200206280,2002,20628,SEA,COL,SEA03,2,6,8
SEA200206290,2002,20629,SEA,COL,SEA03,1,8,9
SEA200206300,2002,20630,SEA,COL,SEA03,4,3,7
SEA200207010,2002,20701,SEA,KCA,SEA03,0,7,7
SEA200207020,2002,20702,SEA,KCA,SEA03,7,5,12
SEA200207030,2002,20703,SEA,KCA,SEA03,0,3,3
SEA200207040,2002,20704,SEA,MIN,SEA03,1,2,3
SEA200207050,2002,20705,SEA,MIN,SEA03,8,4,12
SEA200207060,2002,20706,SEA,MIN,SEA03,7,2,9
SEA200207070,2002,20707,SEA,MIN,SEA03,2,8,10
SEA200207230,2002,20723,SEA,TEX,SEA03,1,4,5
SEA200207240,2002,20724,SEA,TEX,SEA03,4,3,7
SEA200207250,2002,20725,SEA,TEX,SEA03,2,7,9
SEA200207260,2002,20726,SEA,ANA,SEA03,8,0,8
SEA200207270,2002,20727,SEA,ANA,SEA03,1,3,4
SEA200207280,2002,20728,SEA,ANA,SEA03,1,0,1
SEA200207290,2002,20729,SEA,DET,SEA03,3,4,7
SEA200207300,2002,20730,SEA,DET,SEA03,4,5,9
SEA200207310,2002,20731,SEA,DET,SEA03,2,5,7
SEA200208010,2002,20801,SEA,CLE,SEA03,6,10,16
SEA200208020,2002,20802,SEA,CLE,SEA03,1,3,4
SEA200208030,2002,20803,SEA,CLE,SEA03,4,12,16
SEA200208040,2002,20804,SEA,CLE,SEA03,10,8,18
SEA200208130,2002,20813,SEA,BOS,SEA03,3,10,13
SEA200208140,2002,20814,SEA,BOS,SEA03,12,5,17
SEA200208150,2002,20815,SEA,BOS,SEA03,3,4,7
SEA200208160,2002,20816,SEA,NYA,SEA03,9,3,12
SEA200208170,2002,20817,SEA,NYA,SEA03,8,3,11
SEA200208180,2002,20818,SEA,NYA,SEA03,2,5,7
SEA200208300,2002,20830,SEA,KCA,SEA03,5,1,6
SEA200208310,2002,20831,SEA,KCA,SEA03,4,2,6
SEA200209010,2002,20901,SEA,KCA,SEA03,4,9,13
SEA200209020,2002,20902,SEA,MIN,SEA03,2,5,7
SEA200209040,2002,20904,SEA,MIN,SEA03,3,2,5
SEA200209160,2002,20916,SEA,TEX,SEA03,5,6,11
SEA200209170,2002,20917,SEA,TEX,SEA03,2,3,5
SEA200209180,2002,20918,SEA,TEX,SEA03,2,3,5
SEA200209190,2002,20919,SEA,TEX,SEA03,12,7,19
SEA200209200,2002,20920,SEA,ANA,SEA03,8,1,9
SEA200209210,2002,20921,SEA,ANA,SEA03,4,6,10
SEA200209220,2002,20922,SEA,ANA,SEA03,2,3,5
SEA200209240,2002,20924,SEA,OAK,SEA03,7,8,15
SEA200209250,2002,20925,SEA,OAK,SEA03,2,3,5
SEA200209260,2002,20926,SEA,OAK,SEA03,5,3,8
SEA200304080,2003,30408,SEA,ANA,SEA03,0,5,5
SEA200304090,2003,30409,SEA,ANA,SEA03,5,1,6
SEA200304100,2003,30410,SEA,ANA,SEA03,3,0,3
SEA200304110,2003,30411,SEA,TEX,SEA03,4,2,6
SEA200304120,2003,30412,SEA,TEX,SEA03,4,13,17
SEA200304130,2003,30413,SEA,TEX,SEA03,3,4,7
SEA200304140,2003,30414,SEA,OAK,SEA03,3,4,7
SEA200304150,2003,30415,SEA,OAK,SEA03,3,5,8
SEA200304160,2003,30416,SEA,OAK,SEA03,4,1,5
SEA200304170,2003,30417,SEA,OAK,SEA03,3,4,7
SEA200304220,2003,30422,SEA,CLE,SEA03,5,8,13
SEA200304230,2003,30423,SEA,CLE,SEA03,0,4,4
SEA200304240,2003,30424,SEA,CLE,SEA03,2,4,6
SEA200304250,2003,30425,SEA,DET,SEA03,0,6,6
SEA200304260,2003,30426,SEA,DET,SEA03,6,4,10
SEA200304270,2003,30427,SEA,DET,SEA03,3,4,7
SEA200305060,2003,30506,SEA,NYA,SEA03,7,12,19
SEA200305070,2003,30507,SEA,NYA,SEA03,7,2,9
SEA200305080,2003,30508,SEA,NYA,SEA03,16,5,21
SEA200305090,2003,30509,SEA,CHA,SEA03,3,6,9
SEA200305100,2003,30510,SEA,CHA,SEA03,4,3,7
SEA200305110,2003,30511,SEA,CHA,SEA03,2,7,9
SEA200305200,2003,30520,SEA,KCA,SEA03,4,7,11
SEA200305210,2003,30521,SEA,KCA,SEA03,14,5,19
SEA200305220,2003,30522,SEA,KCA,SEA03,1,5,6
SEA200305230,2003,30523,SEA,MIN,SEA03,2,5,7
SEA200305240,2003,30524,SEA,MIN,SEA03,7,2,9
SEA200305250,2003,30525,SEA,MIN,SEA03,3,1,4
SEA200306100,2003,30610,SEA,MON,SEA03,7,3,10
SEA200306110,2003,30611,SEA,MON,SEA03,3,1,4
SEA200306120,2003,30612,SEA,MON,SEA03,0,1,1
SEA200306130,2003,30613,SEA,ATL,SEA03,1,2,3
SEA200306140,2003,30614,SEA,ATL,SEA03,3,1,4
SEA200306150,2003,30615,SEA,ATL,SEA03,1,2,3
SEA200306160,2003,30616,SEA,ANA,SEA03,3,6,9
SEA200306170,2003,30617,SEA,ANA,SEA03,4,8,12
SEA200306180,2003,30618,SEA,ANA,SEA03,0,2,2
SEA200306190,2003,30619,SEA,ANA,SEA03,2,0,2
SEA200306270,2003,30627,SEA,SDN,SEA03,2,8,10
SEA200306280,2003,30628,SEA,SDN,SEA03,6,0,6
SEA200306290,2003,30629,SEA,SDN,SEA03,8,6,14
SEA200307080,2003,30708,SEA,BAL,SEA03,5,6,11
SEA200307090,2003,30709,SEA,BAL,SEA03,7,2,9
SEA200307100,2003,30710,SEA,BAL,SEA03,4,1,5
SEA200307110,2003,30711,SEA,TBA,SEA03,3,4,7
SEA200307120,2003,30712,SEA,TBA,SEA03,6,5,11
SEA200307130,2003,30713,SEA,TBA,SEA03,2,13,15
SEA200307230,2003,30723,SEA,OAK,SEA03,0,6,6
SEA200307240,2003,30724,SEA,OAK,SEA03,3,0,3
SEA200307250,2003,30725,SEA,TEX,SEA03,5,11,16
SEA200307260,2003,30726,SEA,TEX,SEA03,0,4,4
SEA200307270,2003,30727,SEA,TEX,SEA03,7,3,10
SEA200307280,2003,30728,SEA,TEX,SEA03,10,1,11
SEA200307290,2003,30729,SEA,DET,SEA03,5,11,16
SEA200307300,2003,30730,SEA,DET,SEA03,3,13,16
SEA200307310,2003,30731,SEA,DET,SEA03,0,4,4
SEA200308010,2003,30801,SEA,CHA,SEA03,12,1,13
SEA200308020,2003,30802,SEA,CHA,SEA03,0,10,10
SEA200308030,2003,30803,SEA,CHA,SEA03,2,8,10
SEA200308110,2003,30811,SEA,TOR,SEA03,5,3,8
SEA200308120,2003,30812,SEA,TOR,SEA03,1,3,4
SEA200308130,2003,30813,SEA,TOR,SEA03,6,13,19
SEA200308140,2003,30814,SEA,TOR,SEA03,5,2,7
SEA200308150,2003,30815,SEA,BOS,SEA03,5,10,15
SEA200308160,2003,30816,SEA,BOS,SEA03,5,1,6
SEA200308170,2003,30817,SEA,BOS,SEA03,1,3,4
SEA200308260,2003,30826,SEA,TBA,SEA03,3,9,12
SEA200308270,2003,30827,SEA,TBA,SEA03,8,4,12
SEA200308280,2003,30828,SEA,TBA,SEA03,3,2,5
SEA200308290,2003,30829,SEA,BAL,SEA03,2,3,5
SEA200308300,2003,30830,SEA,BAL,SEA03,1,13,14
SEA200308310,2003,30831,SEA,BAL,SEA03,0,3,3
SEA200309090,2003,30909,SEA,TEX,SEA03,5,4,9
SEA200309100,2003,30910,SEA,TEX,SEA03,1,3,4
SEA200309110,2003,30911,SEA,TEX,SEA03,2,8,10
SEA200309120,2003,30912,SEA,ANA,SEA03,4,7,11
SEA200309130,2003,30913,SEA,ANA,SEA03,1,5,6
SEA200309140,2003,30914,SEA,ANA,SEA03,2,1,3
SEA200309260,2003,30926,SEA,OAK,SEA03,3,9,12
SEA200309270,2003,30927,SEA,OAK,SEA03,4,7,11
SEA200309280,2003,30928,SEA,OAK,SEA03,3,9,12
SEA200404060,2004,40406,SEA,ANA,SEA03,10,5,15
SEA200404070,2004,40407,SEA,ANA,SEA03,10,7,17
SEA200404080,2004,40408,SEA,ANA,SEA03,5,1,6
SEA200404160,2004,40416,SEA,TEX,SEA03,5,0,5
SEA200404170,2004,40417,SEA,TEX,SEA03,1,4,5
SEA200404180,2004,40418,SEA,TEX,SEA03,2,4,6
SEA200404190,2004,40419,SEA,OAK,SEA03,1,2,3
SEA200404200,2004,40420,SEA,OAK,SEA03,1,2,3
SEA200404210,2004,40421,SEA,OAK,SEA03,7,4,11
SEA200404220,2004,40422,SEA,OAK,SEA03,8,2,10
SEA200405040,2004,40504,SEA,MIN,SEA03,3,4,7
SEA200405050,2004,40505,SEA,MIN,SEA03,5,1,6
SEA200405060,2004,40506,SEA,MIN,SEA03,1,2,3
SEA200405070,2004,40507,SEA,NYA,SEA03,2,6,8
SEA200405080,2004,40508,SEA,NYA,SEA03,6,0,6
SEA200405090,2004,40509,SEA,NYA,SEA03,7,6,13
SEA200405180,2004,40518,SEA,BAL,SEA03,7,2,9
SEA200405190,2004,40519,SEA,BAL,SEA03,5,2,7
SEA200405200,2004,40520,SEA,BAL,SEA03,0,11,11
SEA200405210,2004,40521,SEA,DET,SEA03,5,0,5
SEA200405220,2004,40522,SEA,DET,SEA03,8,4,12
SEA200405230,2004,40523,SEA,DET,SEA03,1,3,4
SEA200405310,2004,40531,SEA,TOR,SEA03,2,6,8
SEA200406010,2004,40601,SEA,TOR,SEA03,6,5,11
SEA200406020,2004,40602,SEA,TOR,SEA03,5,3,8
SEA200406040,2004,40604,SEA,CHA,SEA03,4,2,6
SEA200406050,2004,40605,SEA,CHA,SEA03,2,4,6
SEA200406060,2004,40606,SEA,CHA,SEA03,4,5,9
SEA200406070,2004,40607,SEA,HOU,SEA03,0,5,5
SEA200406080,2004,40608,SEA,HOU,SEA03,1,0,1
SEA200406090,2004,40609,SEA,HOU,SEA03,3,0,3
SEA200406110,2004,40611,SEA,MON,SEA03,0,1,1
SEA200406120,2004,40612,SEA,MON,SEA03,0,3,3
SEA200406130,2004,40613,SEA,MON,SEA03,1,8,9
SEA200406250,2004,40625,SEA,SDN,SEA03,3,2,5
SEA200406260,2004,40626,SEA,SDN,SEA03,3,7,10
SEA200406270,2004,40627,SEA,SDN,SEA03,5,1,6
SEA200406280,2004,40628,SEA,TEX,SEA03,8,5,13
SEA200406290,2004,40629,SEA,TEX,SEA03,3,4,7
SEA200406300,2004,40630,SEA,TEX,SEA03,9,6,15
SEA200407010,2004,40701,SEA,TEX,SEA03,4,8,12
SEA200407150,2004,40715,SEA,CLE,SEA03,1,2,3
SEA200407160,2004,40716,SEA,CLE,SEA03,18,6,24
SEA200407170,2004,40717,SEA,CLE,SEA03,6,5,11
SEA200407180,2004,40718,SEA,CLE,SEA03,5,7,12
SEA200407190,2004,40719,SEA,BOS,SEA03,4,8,12
SEA200407200,2004,40720,SEA,BOS,SEA03,9,7,16
SEA200407210,2004,40721,SEA,OAK,SEA03,5,6,11
SEA200407220,2004,40722,SEA,OAK,SEA03,2,4,6
SEA200407230,2004,40723,SEA,ANA,SEA03,8,2,10
SEA200407240,2004,40724,SEA,ANA,SEA03,8,4,12
SEA200407250,2004,40725,SEA,ANA,SEA03,2,6,8
SEA200408100,2004,40810,SEA,MIN,SEA03,3,4,7
SEA200408110,2004,40811,SEA,MIN,SEA03,3,4,7
SEA200408120,2004,40812,SEA,MIN,SEA03,6,3,9
SEA200408130,2004,40813,SEA,NYA,SEA03,11,3,14
SEA200408140,2004,40814,SEA,NYA,SEA03,6,4,10
SEA200408150,2004,40815,SEA,NYA,SEA03,3,7,10
SEA200408230,2004,40823,SEA,TBA,SEA03,9,0,9
SEA200408240,2004,40824,SEA,TBA,SEA03,6,5,11
SEA200408250,2004,40825,SEA,TBA,SEA03,6,5,11
SEA200408260,2004,40826,SEA,KCA,SEA03,7,3,10
SEA200408270,2004,40827,SEA,KCA,SEA03,5,7,12
SEA200408281,2004,40828,SEA,KCA,SEA03,7,9,16
SEA200408282,2004,40828,SEA,KCA,SEA03,3,5,8
SEA200408290,2004,40829,SEA,KCA,SEA03,4,5,9
SEA200409060,2004,40906,SEA,CLE,SEA03,5,0,5
SEA200409080,2004,40908,SEA,CLE,SEA03,9,5,14
SEA200409090,2004,40909,SEA,BOS,SEA03,1,7,8
SEA200409100,2004,40910,SEA,BOS,SEA03,13,2,15
SEA200409110,2004,40911,SEA,BOS,SEA03,9,0,9
SEA200409120,2004,40912,SEA,BOS,SEA03,0,2,2
SEA200409130,2004,40913,SEA,ANA,SEA03,5,1,6
SEA200409140,2004,40914,SEA,ANA,SEA03,2,3,5
SEA200409150,2004,40915,SEA,ANA,SEA03,0,1,1
SEA200409160,2004,40916,SEA,ANA,SEA03,6,1,7
SEA200409170,2004,40917,SEA,OAK,SEA03,3,6,9
SEA200409180,2004,40918,SEA,OAK,SEA03,7,4,11
SEA200409190,2004,40919,SEA,OAK,SEA03,2,1,3
SEA200410010,2004,41001,SEA,TEX,SEA03,3,8,11
SEA200410020,2004,41002,SEA,TEX,SEA03,10,4,14
SEA200410030,2004,41003,SEA,TEX,SEA03,3,0,3
SEA200504040,2005,50404,SEA,MIN,SEA03,1,5,6
SEA200504050,2005,50405,SEA,MIN,SEA03,8,4,12
SEA200504060,2005,50406,SEA,MIN,SEA03,4,1,5
SEA200504080,2005,50408,SEA,TEX,SEA03,6,9,15
SEA200504090,2005,50409,SEA,TEX,SEA03,7,6,13
SEA200504100,2005,50410,SEA,TEX,SEA03,7,6,13
SEA200504200,2005,50420,SEA,OAK,SEA03,6,7,13
SEA200504210,2005,50421,SEA,OAK,SEA03,3,0,3
SEA200504220,2005,50422,SEA,CLE,SEA03,6,1,7
SEA200504230,2005,50423,SEA,CLE,SEA03,5,2,7
SEA200504240,2005,50424,SEA,CLE,SEA03,1,9,10
SEA200505020,2005,50502,SEA,ANA,SEA03,5,0,5
SEA200505030,2005,50503,SEA,ANA,SEA03,5,2,7
SEA200505040,2005,50504,SEA,ANA,SEA03,5,2,7
SEA200505130,2005,50513,SEA,BOS,SEA03,7,14,21
SEA200505140,2005,50514,SEA,BOS,SEA03,6,3,9
SEA200505150,2005,50515,SEA,BOS,SEA03,4,5,9
SEA200505160,2005,50516,SEA,NYA,SEA03,6,3,9
SEA200505170,2005,50517,SEA,NYA,SEA03,6,0,6
SEA200505180,2005,50518,SEA,NYA,SEA03,6,7,13
SEA200505200,2005,50520,SEA,SDN,SEA03,6,1,7
SEA200505210,2005,50521,SEA,SDN,SEA03,3,5,8
SEA200505220,2005,50522,SEA,SDN,SEA03,0,5,5
SEA200505300,2005,50530,SEA,TOR,SEA03,3,4,7
SEA200505310,2005,50531,SEA,TOR,SEA03,9,7,16
SEA200506010,2005,50601,SEA,TOR,SEA03,0,3,3
SEA200506030,2005,50603,SEA,TBA,SEA03,6,1,7
SEA200506040,2005,50604,SEA,TBA,SEA03,5,6,11
SEA200506050,2005,50605,SEA,TBA,SEA03,5,6,11
SEA200506140,2005,50614,SEA,PHI,SEA03,1,3,4
SEA200506150,2005,50615,SEA,PHI,SEA03,1,5,6
SEA200506160,2005,50616,SEA,PHI,SEA03,3,2,5
SEA200506170,2005,50617,SEA,NYN,SEA03,0,5,5
SEA200506180,2005,50618,SEA,NYN,SEA03,1,4,5
SEA200506190,2005,50619,SEA,NYN,SEA03,5,11,16
SEA200506200,2005,50620,SEA,OAK,SEA03,6,2,8
SEA200506210,2005,50621,SEA,OAK,SEA03,4,2,6
SEA200506220,2005,50622,SEA,OAK,SEA03,4,5,9
SEA200506230,2005,50623,SEA,OAK,SEA03,5,0,5
SEA200507010,2005,50701,SEA,TEX,SEA03,6,2,8
SEA200507020,2005,50702,SEA,TEX,SEA03,6,5,11
SEA200507030,2005,50703,SEA,TEX,SEA03,1,2,3
SEA200507140,2005,50714,SEA,BAL,SEA03,5,3,8
SEA200507150,2005,50715,SEA,BAL,SEA03,6,3,9
SEA200507160,2005,50716,SEA,BAL,SEA03,2,3,5
SEA200507170,2005,50717,SEA,BAL,SEA03,2,8,10
SEA200507250,2005,50725,SEA,DET,SEA03,3,5,8
SEA200507260,2005,50726,SEA,DET,SEA03,8,5,13
SEA200507270,2005,50727,SEA,DET,SEA03,3,9,12
SEA200507280,2005,50728,SEA,CLE,SEA03,6,5,11
SEA200507290,2005,50729,SEA,CLE,SEA03,10,5,15
SEA200507300,2005,50730,SEA,CLE,SEA03,2,3,5
SEA200507310,2005,50731,SEA,CLE,SEA03,9,7,16
SEA200508080,2005,50808,SEA,MIN,SEA03,4,5,9
SEA200508090,2005,50809,SEA,MIN,SEA03,0,1,1
SEA200508100,2005,50810,SEA,MIN,SEA03,7,3,10
SEA200508120,2005,50812,SEA,ANA,SEA03,9,4,13
SEA200508130,2005,50813,SEA,ANA,SEA03,9,1,10
SEA200508140,2005,50814,SEA,ANA,SEA03,7,6,13
SEA200508150,2005,50815,SEA,KCA,SEA03,3,11,14
SEA200508160,2005,50816,SEA,KCA,SEA03,3,4,7
SEA200508170,2005,50817,SEA,KCA,SEA03,5,11,16
SEA200508260,2005,50826,SEA,CHA,SEA03,5,3,8
SEA200508270,2005,50827,SEA,CHA,SEA03,4,3,7
SEA200508280,2005,50828,SEA,CHA,SEA03,2,9,11
SEA200508290,2005,50829,SEA,NYA,SEA03,7,4,11
SEA200508300,2005,50830,SEA,NYA,SEA03,3,8,11
SEA200508310,2005,50831,SEA,NYA,SEA03,2,0,2
SEA200509010,2005,50901,SEA,NYA,SEA03,1,5,6
SEA200509090,2005,50909,SEA,BAL,SEA03,2,3,5
SEA200509100,2005,50910,SEA,BAL,SEA03,5,3,8
SEA200509110,2005,50911,SEA,BAL,SEA03,6,3,9
SEA200509120,2005,50912,SEA,ANA,SEA03,1,8,9
SEA200509130,2005,50913,SEA,ANA,SEA03,1,2,3
SEA200509140,2005,50914,SEA,ANA,SEA03,9,10,19
SEA200509270,2005,50927,SEA,TEX,SEA03,3,2,5
SEA200509280,2005,50928,SEA,TEX,SEA03,7,3,10
SEA200509290,2005,50929,SEA,TEX,SEA03,3,4,7
SEA200509300,2005,50930,SEA,OAK,SEA03,1,4,5
SEA200510010,2005,51001,SEA,OAK,SEA03,4,3,7
SEA200510020,2005,51002,SEA,OAK,SEA03,8,3,11
SEA200604030,2006,60403,SEA,ANA,SEA03,5,4,9
SEA200604040,2006,60404,SEA,ANA,SEA03,8,10,18
SEA200604050,2006,60405,SEA,ANA,SEA03,4,6,10
SEA200604060,2006,60406,SEA,OAK,SEA03,2,6,8
SEA200604070,2006,60407,SEA,OAK,SEA03,5,0,5
SEA200604080,2006,60408,SEA,OAK,SEA03,3,0,3
SEA200604090,2006,60409,SEA,OAK,SEA03,6,4,10
SEA200604180,2006,60418,SEA,TEX,SEA03,7,4,11
SEA200604190,2006,60419,SEA,TEX,SEA03,6,9,15
SEA200604200,2006,60420,SEA,TEX,SEA03,4,3,7
SEA200604210,2006,60421,SEA,DET,SEA03,2,1,3
SEA200604220,2006,60422,SEA,DET,SEA03,2,0,2
SEA200604230,2006,60423,SEA,DET,SEA03,6,4,10
SEA200604240,2006,60424,SEA,CHA,SEA03,3,4,7
SEA200604250,2006,60425,SEA,CHA,SEA03,13,3,16
SEA200604260,2006,60426,SEA,CHA,SEA03,1,5,6
SEA200605050,2006,60505,SEA,CLE,SEA03,9,4,13
SEA200605060,2006,60506,SEA,CLE,SEA03,1,4,5
SEA200605070,2006,60507,SEA,CLE,SEA03,2,0,2
SEA200605080,2006,60508,SEA,TBA,SEA03,3,6,9
SEA200605090,2006,60509,SEA,TBA,SEA03,1,8,9
SEA200605100,2006,60510,SEA,TBA,SEA03,1,0,1
SEA200605190,2006,60519,SEA,SDN,SEA03,4,7,11
SEA200605200,2006,60520,SEA,SDN,SEA03,3,6,9
SEA200605210,2006,60521,SEA,SDN,SEA03,8,10,18
SEA200605220,2006,60522,SEA,BAL,SEA03,6,8,14
SEA200605230,2006,60523,SEA,BAL,SEA03,14,4,18
SEA200605240,2006,60524,SEA,BAL,SEA03,4,7,11
SEA200605250,2006,60525,SEA,BAL,SEA03,2,0,2
SEA200606020,2006,60602,SEA,KCA,SEA03,0,4,4
SEA200606030,2006,60603,SEA,KCA,SEA03,1,12,13
SEA200606040,2006,60604,SEA,KCA,SEA03,9,4,13
SEA200606050,2006,60605,SEA,KCA,SEA03,1,4,5
SEA200606060,2006,60606,SEA,MIN,SEA03,2,4,6
SEA200606070,2006,60607,SEA,MIN,SEA03,9,10,19
SEA200606080,2006,60608,SEA,MIN,SEA03,7,3,10
SEA200606160,2006,60616,SEA,SFN,SEA03,4,5,9
SEA200606170,2006,60617,SEA,SFN,SEA03,1,8,9
SEA200606180,2006,60618,SEA,SFN,SEA03,1,5,6
SEA200606300,2006,60630,SEA,COL,SEA03,2,0,2
SEA200607010,2006,60701,SEA,COL,SEA03,7,8,15
SEA200607020,2006,60702,SEA,COL,SEA03,4,3,7
SEA200607030,2006,60703,SEA,ANA,SEA03,7,1,8
SEA200607040,2006,60704,SEA,ANA,SEA03,14,6,20
SEA200607050,2006,60705,SEA,ANA,SEA03,4,0,4
SEA200607070,2006,60707,SEA,DET,SEA03,6,1,7
SEA200607080,2006,60708,SEA,DET,SEA03,2,1,3
SEA200607090,2006,60709,SEA,DET,SEA03,2,3,5
SEA200607210,2006,60721,SEA,BOS,SEA03,9,4,13
SEA200607220,2006,60722,SEA,BOS,SEA03,2,5,7
SEA200607230,2006,60723,SEA,BOS,SEA03,8,9,17
SEA200607240,2006,60724,SEA,TOR,SEA03,3,7,10
SEA200607250,2006,60725,SEA,TOR,SEA03,12,3,15
SEA200607260,2006,60726,SEA,TOR,SEA03,4,7,11
SEA200608040,2006,60804,SEA,OAK,SEA03,5,2,7
SEA200608050,2006,60805,SEA,OAK,SEA03,5,2,7
SEA200608060,2006,60806,SEA,OAK,SEA03,7,6,13
SEA200608070,2006,60807,SEA,TBA,SEA03,4,5,9
SEA200608080,2006,60808,SEA,TBA,SEA03,1,5,6
SEA200608090,2006,60809,SEA,TBA,SEA03,0,2,2
SEA200608220,2006,60822,SEA,NYA,SEA03,5,6,11
SEA200608230,2006,60823,SEA,NYA,SEA03,9,2,11
SEA200608240,2006,60824,SEA,NYA,SEA03,2,4,6
SEA200608250,2006,60825,SEA,BOS,SEA03,0,6,6
SEA200608260,2006,60826,SEA,BOS,SEA03,3,4,7
SEA200608270,2006,60827,SEA,BOS,SEA03,3,6,9
SEA200608280,2006,60828,SEA,ANA,SEA03,0,2,2
SEA200608290,2006,60829,SEA,ANA,SEA03,4,6,10
SEA200608300,2006,60830,SEA,ANA,SEA03,5,3,8
SEA200609080,2006,60908,SEA,TEX,SEA03,2,7,9
SEA200609090,2006,60909,SEA,TEX,SEA03,2,3,5
SEA200609100,2006,60910,SEA,TEX,SEA03,4,2,6
SEA200609110,2006,60911,SEA,TOR,SEA03,6,2,8
SEA200609120,2006,60912,SEA,TOR,SEA03,2,4,6
SEA200609130,2006,60913,SEA,TOR,SEA03,10,0,10
SEA200609250,2006,60925,SEA,OAK,SEA03,9,10,19
SEA200609260,2006,60926,SEA,OAK,SEA03,12,3,15
SEA200609270,2006,60927,SEA,OAK,SEA03,7,6,13
SEA200609290,2006,60929,SEA,TEX,SEA03,6,5,11
SEA200609300,2006,60930,SEA,TEX,SEA03,1,3,4
SEA200610010,2006,61001,SEA,TEX,SEA03,2,3,5
SEA200704020,2007,70402,SEA,OAK,SEA03,0,4,4
SEA200704030,2007,70403,SEA,OAK,SEA03,4,8,12
SEA200704040,2007,70404,SEA,OAK,SEA03,9,0,9
SEA200704130,2007,70413,SEA,TEX,SEA03,5,2,7
SEA200704140,2007,70414,SEA,TEX,SEA03,3,8,11
SEA200704150,2007,70415,SEA,TEX,SEA03,6,14,20
SEA200704170,2007,70417,SEA,MIN,SEA03,11,2,13
SEA200704180,2007,70418,SEA,MIN,SEA03,5,4,9
SEA200704190,2007,70419,SEA,MIN,SEA03,6,5,11
SEA200704270,2007,70427,SEA,KCA,SEA03,4,7,11
SEA200704280,2007,70428,SEA,KCA,SEA03,8,3,11
SEA200704290,2007,70429,SEA,KCA,SEA03,1,5,6
SEA200705010,2007,70501,SEA,CHA,SEA03,2,5,7
SEA200705020,2007,70502,SEA,CHA,SEA03,2,3,5
SEA200705110,2007,70511,SEA,NYA,SEA03,0,3,3
SEA200705120,2007,70512,SEA,NYA,SEA03,7,2,9
SEA200705130,2007,70513,SEA,NYA,SEA03,1,2,3
SEA200705150,2007,70515,SEA,ANA,SEA03,3,11,14
SEA200705160,2007,70516,SEA,ANA,SEA03,5,0,5
SEA200705170,2007,70517,SEA,ANA,SEA03,7,3,10
SEA200705180,2007,70518,SEA,SDN,SEA03,8,1,9
SEA200705190,2007,70519,SEA,SDN,SEA03,4,7,11
SEA200705200,2007,70520,SEA,SDN,SEA03,2,1,3
SEA200705310,2007,70531,SEA,TEX,SEA03,5,9,14
SEA200706010,2007,70601,SEA,TEX,SEA03,9,8,17
SEA200706020,2007,70602,SEA,TEX,SEA03,4,5,9
SEA200706030,2007,70603,SEA,TEX,SEA03,6,11,17
SEA200706040,2007,70604,SEA,BAL,SEA03,4,7,11
SEA200706050,2007,70605,SEA,BAL,SEA03,4,5,9
SEA200706060,2007,70606,SEA,BAL,SEA03,9,5,14
SEA200706190,2007,70619,SEA,PIT,SEA03,5,3,8
SEA200706200,2007,70620,SEA,PIT,SEA03,0,7,7
SEA200706210,2007,70621,SEA,PIT,SEA03,0,3,3
SEA200706220,2007,70622,SEA,CIN,SEA03,16,1,17
SEA200706230,2007,70623,SEA,CIN,SEA03,1,9,10
SEA200706240,2007,70624,SEA,CIN,SEA03,2,3,5
SEA200706250,2007,70625,SEA,BOS,SEA03,4,9,13
SEA200706260,2007,70626,SEA,BOS,SEA03,7,8,15
SEA200706270,2007,70627,SEA,BOS,SEA03,1,2,3
SEA200706290,2007,70629,SEA,TOR,SEA03,3,5,8
SEA200706300,2007,70630,SEA,TOR,SEA03,3,8,11
SEA200707010,2007,70701,SEA,TOR,SEA03,1,2,3
SEA200707120,2007,70712,SEA,DET,SEA03,2,3,5
SEA200707130,2007,70713,SEA,DET,SEA03,6,3,9
SEA200707140,2007,70714,SEA,DET,SEA03,4,6,10
SEA200707150,2007,70715,SEA,DET,SEA03,11,7,18
SEA200707160,2007,70716,SEA,BAL,SEA03,2,4,6
SEA200707170,2007,70717,SEA,BAL,SEA03,8,3,11
SEA200707180,2007,70718,SEA,BAL,SEA03,5,6,11
SEA200707260,2007,70726,SEA,OAK,SEA03,6,2,8
SEA200707270,2007,70727,SEA,OAK,SEA03,1,7,8
SEA200707280,2007,70728,SEA,OAK,SEA03,3,4,7
SEA200707290,2007,70729,SEA,OAK,SEA03,10,14,24
SEA200707300,2007,70730,SEA,ANA,SEA03,0,2,2
SEA200707310,2007,70731,SEA,ANA,SEA03,8,0,8
SEA200708010,2007,70801,SEA,ANA,SEA03,7,8,15
SEA200708030,2007,70803,SEA,BOS,SEA03,4,7,11
SEA200708040,2007,70804,SEA,BOS,SEA03,4,3,7
SEA200708050,2007,70805,SEA,BOS,SEA03,9,2,11
SEA200708130,2007,70813,SEA,MIN,SEA03,3,4,7
SEA200708140,2007,70814,SEA,MIN,SEA03,11,3,14
SEA200708150,2007,70815,SEA,MIN,SEA03,6,1,7
SEA200708170,2007,70817,SEA,CHA,SEA03,4,5,9
SEA200708180,2007,70818,SEA,CHA,SEA03,5,7,12
SEA200708190,2007,70819,SEA,CHA,SEA03,5,11,16
SEA200708270,2007,70827,SEA,ANA,SEA03,6,0,6
SEA200708280,2007,70828,SEA,ANA,SEA03,10,6,16
SEA200708290,2007,70829,SEA,ANA,SEA03,8,2,10
SEA200709100,2007,70910,SEA,OAK,SEA03,9,3,12
SEA200709110,2007,70911,SEA,OAK,SEA03,7,4,11
SEA200709120,2007,70912,SEA,OAK,SEA03,5,6,11
SEA200709130,2007,70913,SEA,TBA,SEA03,7,8,15
SEA200709140,2007,70914,SEA,TBA,SEA03,1,2,3
SEA200709150,2007,70915,SEA,TBA,SEA03,6,2,8
SEA200709160,2007,70916,SEA,TBA,SEA03,9,2,11
SEA200709250,2007,70925,SEA,CLE,SEA03,4,3,7
SEA200709261,2007,70926,SEA,CLE,SEA03,12,4,16
SEA200709262,2007,70926,SEA,CLE,SEA03,2,3,5
SEA200709270,2007,70927,SEA,CLE,SEA03,2,4,6
SEA200709280,2007,70928,SEA,TEX,SEA03,4,6,10
SEA200709290,2007,70929,SEA,TEX,SEA03,1,5,6
SEA200709300,2007,70930,SEA,TEX,SEA03,2,4,6
SEA200803310,2008,80331,SEA,TEX,SEA03,2,5,7
SEA200804010,2008,80401,SEA,TEX,SEA03,5,4,9
SEA200804020,2008,80402,SEA,TEX,SEA03,1,4,5
SEA200804110,2008,80411,SEA,ANA,SEA03,5,8,13
SEA200804120,2008,80412,SEA,ANA,SEA03,3,8,11
SEA200804130,2008,80413,SEA,ANA,SEA03,10,5,15
SEA200804140,2008,80414,SEA,KCA,SEA03,5,1,6
SEA200804150,2008,80415,SEA,KCA,SEA03,6,11,17
SEA200804220,2008,80422,SEA,BAL,SEA03,2,4,6
SEA200804230,2008,80423,SEA,BAL,SEA03,3,2,5
SEA200804240,2008,80424,SEA,BAL,SEA03,8,7,15
SEA200804250,2008,80425,SEA,OAK,SEA03,4,3,7
SEA200804260,2008,80426,SEA,OAK,SEA03,3,5,8
SEA200804270,2008,80427,SEA,OAK,SEA03,4,2,6
SEA200805050,2008,80505,SEA,TEX,SEA03,3,7,10
SEA200805060,2008,80506,SEA,TEX,SEA03,10,1,11
SEA200805070,2008,80507,SEA,TEX,SEA03,2,0,2
SEA200805080,2008,80508,SEA,TEX,SEA03,5,0,5
SEA200805090,2008,80509,SEA,CHA,SEA03,4,2,6
SEA200805100,2008,80510,SEA,CHA,SEA03,8,4,12
SEA200805110,2008,80511,SEA,CHA,SEA03,3,6,9
SEA200805160,2008,80516,SEA,SDN,SEA03,6,4,10
SEA200805170,2008,80517,SEA,SDN,SEA03,2,4,6
SEA200805180,2008,80518,SEA,SDN,SEA03,2,3,5
SEA200805260,2008,80526,SEA,BOS,SEA03,5,3,8
SEA200805270,2008,80527,SEA,BOS,SEA03,3,4,7
SEA200805280,2008,80528,SEA,BOS,SEA03,0,1,1
SEA200805300,2008,80530,SEA,DET,SEA03,7,4,11
SEA200805310,2008,80531,SEA,DET,SEA03,0,5,5
SEA200806010,2008,80601,SEA,DET,SEA03,7,5,12
SEA200806020,2008,80602,SEA,ANA,SEA03,4,2,6
SEA200806030,2008,80603,SEA,ANA,SEA03,5,4,9
SEA200806040,2008,80604,SEA,ANA,SEA03,5,4,9
SEA200806130,2008,80613,SEA,WAS,SEA03,7,6,13
SEA200806140,2008,80614,SEA,WAS,SEA03,5,2,7
SEA200806150,2008,80615,SEA,WAS,SEA03,6,2,8
SEA200806160,2008,80616,SEA,FLO,SEA03,6,1,7
SEA200806170,2008,80617,SEA,FLO,SEA03,4,5,9
SEA200806180,2008,80618,SEA,FLO,SEA03,8,3,11
SEA200806300,2008,80630,SEA,TOR,SEA03,2,0,2
SEA200807010,2008,80701,SEA,TOR,SEA03,6,7,13
SEA200807020,2008,80702,SEA,TOR,SEA03,2,4,6
SEA200807030,2008,80703,SEA,DET,SEA03,8,4,12
SEA200807040,2008,80704,SEA,DET,SEA03,1,4,5
SEA200807050,2008,80705,SEA,DET,SEA03,2,3,5
SEA200807060,2008,80706,SEA,DET,SEA03,2,1,3
SEA200807180,2008,80718,SEA,CLE,SEA03,2,8,10
SEA200807190,2008,80719,SEA,CLE,SEA03,9,6,15
SEA200807200,2008,80720,SEA,CLE,SEA03,6,2,8
SEA200807210,2008,80721,SEA,BOS,SEA03,4,0,4
SEA200807220,2008,80722,SEA,BOS,SEA03,4,2,6
SEA200807230,2008,80723,SEA,BOS,SEA03,6,3,9
SEA200808010,2008,80801,SEA,BAL,SEA03,10,5,15
SEA200808020,2008,80802,SEA,BAL,SEA03,3,1,4
SEA200808030,2008,80803,SEA,BAL,SEA03,4,8,12
SEA200808040,2008,80804,SEA,MIN,SEA03,6,11,17
SEA200808050,2008,80805,SEA,MIN,SEA03,7,8,15
SEA200808060,2008,80806,SEA,MIN,SEA03,7,3,10
SEA200808070,2008,80807,SEA,TBA,SEA03,1,2,3
SEA200808080,2008,80808,SEA,TBA,SEA03,5,3,8
SEA200808090,2008,80809,SEA,TBA,SEA03,8,7,15
SEA200808100,2008,80810,SEA,TBA,SEA03,11,3,14
SEA200808210,2008,80821,SEA,OAK,SEA03,2,0,2
SEA200808220,2008,80822,SEA,OAK,SEA03,5,7,12
SEA200808230,2008,80823,SEA,OAK,SEA03,5,1,6
SEA200808240,2008,80824,SEA,OAK,SEA03,4,8,12
SEA200808250,2008,80825,SEA,MIN,SEA03,2,4,6
SEA200808260,2008,80826,SEA,MIN,SEA03,2,3,5
SEA200808270,2008,80827,SEA,MIN,SEA03,6,5,11
SEA200809050,2008,80905,SEA,NYA,SEA03,1,3,4
SEA200809060,2008,80906,SEA,NYA,SEA03,7,4,11
SEA200809070,2008,80907,SEA,NYA,SEA03,2,5,7
SEA200809090,2008,80909,SEA,TEX,SEA03,7,3,10
SEA200809100,2008,80910,SEA,TEX,SEA03,7,8,15
SEA200809220,2008,80922,SEA,ANA,SEA03,2,1,3
SEA200809230,2008,80923,SEA,ANA,SEA03,6,9,15
SEA200809240,2008,80924,SEA,ANA,SEA03,6,5,11
SEA200809250,2008,80925,SEA,ANA,SEA03,6,4,10
SEA200809260,2008,80926,SEA,OAK,SEA03,8,10,18
SEA200809270,2008,80927,SEA,OAK,SEA03,3,7,10
SEA200809280,2008,80928,SEA,OAK,SEA03,3,4,7
SEA200904140,2009,90414,SEA,ANA,SEA03,2,3,5
SEA200904150,2009,90415,SEA,ANA,SEA03,3,11,14
SEA200904160,2009,90416,SEA,ANA,SEA03,5,1,6
SEA200904170,2009,90417,SEA,DET,SEA03,3,6,9
SEA200904180,2009,90418,SEA,DET,SEA03,2,0,2
SEA200904190,2009,90419,SEA,DET,SEA03,8,2,10
SEA200904210,2009,90421,SEA,TBA,SEA03,2,4,6
SEA200904220,2009,90422,SEA,TBA,SEA03,9,3,12
SEA200904230,2009,90423,SEA,TBA,SEA03,0,1,1
SEA200905010,2009,90501,SEA,OAK,SEA03,7,8,15
SEA200905020,2009,90502,SEA,OAK,SEA03,3,2,5
SEA200905030,2009,90503,SEA,OAK,SEA03,7,8,15
SEA200905040,2009,90504,SEA,TEX,SEA03,6,5,11
SEA200905050,2009,90505,SEA,TEX,SEA03,7,2,9
SEA200905150,2009,90515,SEA,BOS,SEA03,4,5,9
SEA200905160,2009,90516,SEA,BOS,SEA03,5,3,8
SEA200905170,2009,90517,SEA,BOS,SEA03,2,3,5
SEA200905180,2009,90518,SEA,ANA,SEA03,10,6,16
SEA200905190,2009,90519,SEA,ANA,SEA03,6,5,11
SEA200905200,2009,90520,SEA,ANA,SEA03,0,1,1
SEA200905210,2009,90521,SEA,ANA,SEA03,3,0,3
SEA200905220,2009,90522,SEA,SFN,SEA03,1,2,3
SEA200905230,2009,90523,SEA,SFN,SEA03,5,1,6
SEA200905240,2009,90524,SEA,SFN,SEA03,4,5,9
SEA200906010,2009,90601,SEA,BAL,SEA03,1,0,1
SEA200906020,2009,90602,SEA,BAL,SEA03,2,8,10
SEA200906030,2009,90603,SEA,BAL,SEA03,2,3,5
SEA200906050,2009,90605,SEA,MIN,SEA03,2,1,3
SEA200906060,2009,90606,SEA,MIN,SEA03,1,2,3
SEA200906070,2009,90607,SEA,MIN,SEA03,2,4,6
SEA200906190,2009,90619,SEA,ARI,SEA03,3,4,7
SEA200906200,2009,90620,SEA,ARI,SEA03,3,7,10
SEA200906210,2009,90621,SEA,ARI,SEA03,2,3,5
SEA200906230,2009,90623,SEA,SDN,SEA03,9,7,16
SEA200906240,2009,90624,SEA,SDN,SEA03,3,4,7
SEA200906250,2009,90625,SEA,SDN,SEA03,3,9,12
SEA200907060,2009,90706,SEA,BAL,SEA03,0,5,5
SEA200907070,2009,90707,SEA,BAL,SEA03,12,4,16
SEA200907080,2009,90708,SEA,BAL,SEA03,5,3,8
SEA200907090,2009,90709,SEA,TEX,SEA03,1,3,4
SEA200907100,2009,90710,SEA,TEX,SEA03,6,4,10
SEA200907110,2009,90711,SEA,TEX,SEA03,1,4,5
SEA200907120,2009,90712,SEA,TEX,SEA03,3,5,8
SEA200907240,2009,90724,SEA,CLE,SEA03,9,0,9
SEA200907250,2009,90725,SEA,CLE,SEA03,10,3,13
SEA200907260,2009,90726,SEA,CLE,SEA03,12,3,15
SEA200907270,2009,90727,SEA,TOR,SEA03,11,4,15
SEA200907280,2009,90728,SEA,TOR,SEA03,3,4,7
SEA200907290,2009,90729,SEA,TOR,SEA03,2,3,5
SEA200908070,2009,90807,SEA,TBA,SEA03,6,7,13
SEA200908080,2009,90808,SEA,TBA,SEA03,10,4,14
SEA200908090,2009,90809,SEA,TBA,SEA03,2,11,13
SEA200908100,2009,90810,SEA,CHA,SEA03,4,6,10
SEA200908110,2009,90811,SEA,CHA,SEA03,3,1,4
SEA200908120,2009,90812,SEA,CHA,SEA03,0,1,1
SEA200908130,2009,90813,SEA,NYA,SEA03,11,1,12
SEA200908140,2009,90814,SEA,NYA,SEA03,4,2,6
SEA200908150,2009,90815,SEA,NYA,SEA03,5,2,7
SEA200908160,2009,90816,SEA,NYA,SEA03,3,10,13
SEA200908240,2009,90824,SEA,OAK,SEA03,1,3,4
SEA200908250,2009,90825,SEA,OAK,SEA03,2,4,6
SEA200908260,2009,90826,SEA,OAK,SEA03,3,5,8
SEA200908270,2009,90827,SEA,KCA,SEA03,8,4,12
SEA200908280,2009,90828,SEA,KCA,SEA03,3,6,9
SEA200908290,2009,90829,SEA,KCA,SEA03,4,8,12
SEA200908300,2009,90830,SEA,KCA,SEA03,3,0,3
SEA200908310,2009,90831,SEA,ANA,SEA03,10,0,10
SEA200909010,2009,90901,SEA,ANA,SEA03,1,2,3
SEA200909020,2009,90902,SEA,ANA,SEA03,0,3,3
SEA200909150,2009,90915,SEA,CHA,SEA03,6,3,9
SEA200909160,2009,90916,SEA,CHA,SEA03,1,4,5
SEA200909170,2009,90917,SEA,CHA,SEA03,3,4,7
SEA200909180,2009,90918,SEA,NYA,SEA03,2,3,5
SEA200909190,2009,90919,SEA,NYA,SEA03,10,1,11
SEA200909200,2009,90920,SEA,NYA,SEA03,1,7,8
SEA200909290,2009,90929,SEA,OAK,SEA03,4,6,10
SEA200909300,2009,90930,SEA,OAK,SEA03,0,7,7
SEA200910010,2009,91001,SEA,OAK,SEA03,2,4,6
SEA200910020,2009,91002,SEA,TEX,SEA03,7,4,11
SEA200910030,2009,91003,SEA,TEX,SEA03,1,2,3
SEA200910040,2009,91004,SEA,TEX,SEA03,3,4,7
SFN200004110,2000,411,SFN,LAN,SFO03,6,5,11
SFN200004120,2000,412,SFN,LAN,SFO03,6,5,11
SFN200004130,2000,413,SFN,LAN,SFO03,11,7,18
SFN200004140,2000,414,SFN,ARI,SFO03,3,1,4
SFN200004150,2000,415,SFN,ARI,SFO03,7,4,11
SFN200004280,2000,428,SFN,MON,SFO03,9,3,12
SFN200004290,2000,429,SFN,MON,SFO03,1,2,3
SFN200004300,2000,430,SFN,MON,SFO03,4,3,7
SFN200005010,2000,501,SFN,NYN,SFO03,3,10,13
SFN200005020,2000,502,SFN,NYN,SFO03,1,7,8
SFN200005030,2000,503,SFN,NYN,SFO03,5,8,13
SFN200005040,2000,504,SFN,NYN,SFO03,2,7,9
SFN200005050,2000,505,SFN,COL,SFO03,0,5,5
SFN200005060,2000,506,SFN,COL,SFO03,0,6,6
SFN200005080,2000,508,SFN,SLN,SFO03,4,6,10
SFN200005090,2000,509,SFN,SLN,SFO03,13,6,19
SFN200005100,2000,510,SFN,SLN,SFO03,3,4,7
SFN200005230,2000,523,SFN,MON,SFO03,3,2,5
SFN200005240,2000,524,SFN,MON,SFO03,0,18,18
SFN200005250,2000,525,SFN,MON,SFO03,1,4,5
SFN200005260,2000,526,SFN,CHN,SFO03,3,5,8
SFN200005270,2000,527,SFN,CHN,SFO03,3,2,5
SFN200005280,2000,528,SFN,CHN,SFO03,4,1,5
SFN200005290,2000,529,SFN,PHI,SFO03,2,7,9
SFN200005300,2000,530,SFN,PHI,SFO03,3,7,10
SFN200005310,2000,531,SFN,PHI,SFO03,4,10,14
SFN200006090,2000,609,SFN,SEA,SFO03,2,9,11
SFN200006100,2000,610,SFN,SEA,SFO03,5,2,7
SFN200006110,2000,611,SFN,SEA,SFO03,9,2,11
SFN200006120,2000,612,SFN,CIN,SFO03,3,10,13
SFN200006130,2000,613,SFN,CIN,SFO03,2,3,5
SFN200006140,2000,614,SFN,CIN,SFO03,2,6,8
SFN200006160,2000,616,SFN,HOU,SFO03,4,7,11
SFN200006170,2000,617,SFN,HOU,SFO03,4,6,10
SFN200006180,2000,618,SFN,HOU,SFO03,4,2,6
SFN200006300,2000,630,SFN,LAN,SFO03,9,2,11
SFN200007010,2000,701,SFN,LAN,SFO03,1,4,5
SFN200007020,2000,702,SFN,LAN,SFO03,5,6,11
SFN200007041,2000,704,SFN,COL,SFO03,1,4,5
SFN200007042,2000,704,SFN,COL,SFO03,0,3,3
SFN200007050,2000,705,SFN,COL,SFO03,2,4,6
SFN200007060,2000,706,SFN,COL,SFO03,5,6,11
SFN200007130,2000,713,SFN,OAK,SFO03,2,4,6
SFN200007140,2000,714,SFN,OAK,SFO03,2,4,6
SFN200007150,2000,715,SFN,OAK,SFO03,6,2,8
SFN200007160,2000,716,SFN,TEX,SFO03,4,6,10
SFN200007170,2000,717,SFN,TEX,SFO03,8,10,18
SFN200007180,2000,718,SFN,TEX,SFO03,3,5,8
SFN200007190,2000,719,SFN,SDN,SFO03,4,3,7
SFN200007200,2000,720,SFN,SDN,SFO03,3,7,10
SFN200008030,2000,803,SFN,PIT,SFO03,2,10,12
SFN200008040,2000,804,SFN,PIT,SFO03,3,5,8
SFN200008050,2000,805,SFN,PIT,SFO03,7,2,9
SFN200008060,2000,806,SFN,PIT,SFO03,1,7,8
SFN200008070,2000,807,SFN,MIL,SFO03,1,8,9
SFN200008080,2000,808,SFN,MIL,SFO03,0,1,1
SFN200008090,2000,809,SFN,MIL,SFO03,3,9,12
SFN200008180,2000,818,SFN,ATL,SFO03,0,2,2
SFN200008190,2000,819,SFN,ATL,SFO03,3,12,15
SFN200008200,2000,820,SFN,ATL,SFO03,8,5,13
SFN200008210,2000,821,SFN,FLO,SFO03,0,6,6
SFN200008220,2000,822,SFN,FLO,SFO03,7,5,12
SFN200008230,2000,823,SFN,FLO,SFO03,0,5,5
SFN200009010,2000,901,SFN,CHN,SFO03,2,7,9
SFN200009020,2000,902,SFN,CHN,SFO03,2,13,15
SFN200009030,2000,903,SFN,CHN,SFO03,2,5,7
SFN200009040,2000,904,SFN,PHI,SFO03,0,3,3
SFN200009050,2000,905,SFN,PHI,SFO03,5,8,13
SFN200009060,2000,906,SFN,PHI,SFO03,4,5,9
SFN200009070,2000,907,SFN,SDN,SFO03,0,13,13
SFN200009080,2000,908,SFN,SDN,SFO03,10,7,17
SFN200009090,2000,909,SFN,SDN,SFO03,7,3,10
SFN200009100,2000,910,SFN,SDN,SFO03,2,10,12
SFN200009180,2000,918,SFN,CIN,SFO03,7,1,8
SFN200009190,2000,919,SFN,CIN,SFO03,3,7,10
SFN200009200,2000,920,SFN,CIN,SFO03,2,4,6
SFN200009210,2000,921,SFN,ARI,SFO03,7,8,15
SFN200009220,2000,922,SFN,ARI,SFO03,7,1,8
SFN200009231,2000,923,SFN,ARI,SFO03,7,5,12
SFN200009232,2000,923,SFN,ARI,SFO03,5,9,14
SFN200009240,2000,924,SFN,ARI,SFO03,8,3,11
SFN200010040,2000,1004,SFN,NYN,SFO03,1,5,6
SFN200010050,2000,1005,SFN,NYN,SFO03,5,4,9
SFN200104020,2001,10402,SFN,SDN,SFO03,2,3,5
SFN200104040,2001,10404,SFN,SDN,SFO03,7,8,15
SFN200104050,2001,10405,SFN,SDN,SFO03,2,8,10
SFN200104170,2001,10417,SFN,LAN,SFO03,2,3,5
SFN200104180,2001,10418,SFN,LAN,SFO03,4,5,9
SFN200104190,2001,10419,SFN,LAN,SFO03,10,1,11
SFN200104200,2001,10420,SFN,MIL,SFO03,1,3,4
SFN200104210,2001,10421,SFN,MIL,SFO03,6,3,9
SFN200104220,2001,10422,SFN,MIL,SFO03,4,6,10
SFN200104240,2001,10424,SFN,CIN,SFO03,9,5,14
SFN200104250,2001,10425,SFN,CIN,SFO03,7,5,12
SFN200104260,2001,10426,SFN,CIN,SFO03,7,5,12
SFN200104270,2001,10427,SFN,CHN,SFO03,7,3,10
SFN200104280,2001,10428,SFN,CHN,SFO03,0,5,5
SFN200104290,2001,10429,SFN,CHN,SFO03,11,2,13
SFN200105070,2001,10507,SFN,MON,SFO03,2,6,8
SFN200105080,2001,10508,SFN,MON,SFO03,1,9,10
SFN200105090,2001,10509,SFN,MON,SFO03,8,0,8
SFN200105100,2001,10510,SFN,MON,SFO03,0,13,13
SFN200105110,2001,10511,SFN,NYN,SFO03,2,3,5
SFN200105120,2001,10512,SFN,NYN,SFO03,3,10,13
SFN200105130,2001,10513,SFN,NYN,SFO03,3,6,9
SFN200105240,2001,10524,SFN,COL,SFO03,1,5,6
SFN200105250,2001,10525,SFN,COL,SFO03,6,1,7
SFN200105260,2001,10526,SFN,COL,SFO03,10,4,14
SFN200105270,2001,10527,SFN,COL,SFO03,4,5,9
SFN200105280,2001,10528,SFN,ARI,SFO03,2,1,3
SFN200105290,2001,10529,SFN,ARI,SFO03,1,0,1
SFN200105300,2001,10530,SFN,ARI,SFO03,4,3,7
SFN200106040,2001,10604,SFN,SDN,SFO03,1,3,4
SFN200106050,2001,10605,SFN,SDN,SFO03,6,7,13
SFN200106060,2001,10606,SFN,SDN,SFO03,4,6,10
SFN200106070,2001,10607,SFN,SDN,SFO03,10,7,17
SFN200106120,2001,10612,SFN,ANA,SFO03,2,3,5
SFN200106130,2001,10613,SFN,ANA,SFO03,0,1,1
SFN200106140,2001,10614,SFN,ANA,SFO03,4,10,14
SFN200106150,2001,10615,SFN,OAK,SFO03,1,3,4
SFN200106160,2001,10616,SFN,OAK,SFO03,1,2,3
SFN200106170,2001,10617,SFN,OAK,SFO03,0,3,3
SFN200106250,2001,10625,SFN,LAN,SFO03,2,5,7
SFN200106260,2001,10626,SFN,LAN,SFO03,14,8,22
SFN200106270,2001,10627,SFN,LAN,SFO03,7,3,10
SFN200106290,2001,10629,SFN,SLN,SFO03,2,3,5
SFN200106300,2001,10630,SFN,SLN,SFO03,2,5,7
SFN200107010,2001,10701,SFN,SLN,SFO03,4,5,9
SFN200107060,2001,10706,SFN,MIL,SFO03,2,3,5
SFN200107070,2001,10707,SFN,MIL,SFO03,13,3,16
SFN200107080,2001,10708,SFN,MIL,SFO03,6,4,10
SFN200107180,2001,10718,SFN,COL,SFO03,0,10,10
SFN200107190,2001,10719,SFN,COL,SFO03,1,2,3
SFN200107200,2001,10720,SFN,ARI,SFO03,0,1,1
SFN200107210,2001,10721,SFN,ARI,SFO03,9,2,11
SFN200107220,2001,10722,SFN,ARI,SFO03,12,4,16
SFN200107310,2001,10731,SFN,PIT,SFO03,7,8,15
SFN200108010,2001,10801,SFN,PIT,SFO03,1,3,4
SFN200108020,2001,10802,SFN,PIT,SFO03,0,3,3
SFN200108030,2001,10803,SFN,PHI,SFO03,2,4,6
SFN200108040,2001,10804,SFN,PHI,SFO03,12,2,14
SFN200108050,2001,10805,SFN,PHI,SFO03,4,8,12
SFN200108140,2001,10814,SFN,FLO,SFO03,7,13,20
SFN200108150,2001,10815,SFN,FLO,SFO03,1,2,3
SFN200108160,2001,10816,SFN,FLO,SFO03,3,5,8
SFN200108170,2001,10817,SFN,ATL,SFO03,2,1,3
SFN200108180,2001,10818,SFN,ATL,SFO03,3,1,4
SFN200108190,2001,10819,SFN,ATL,SFO03,1,4,5
SFN200108310,2001,10831,SFN,COL,SFO03,5,2,7
SFN200109010,2001,10901,SFN,COL,SFO03,1,2,3
SFN200109020,2001,10902,SFN,COL,SFO03,1,3,4
SFN200109030,2001,10903,SFN,COL,SFO03,4,1,5
SFN200109040,2001,10904,SFN,ARI,SFO03,2,5,7
SFN200109050,2001,10905,SFN,ARI,SFO03,7,2,9
SFN200109060,2001,10906,SFN,ARI,SFO03,5,9,14
SFN200109180,2001,10918,SFN,HOU,SFO03,3,2,5
SFN200109190,2001,10919,SFN,HOU,SFO03,10,3,13
SFN200109200,2001,10920,SFN,HOU,SFO03,5,4,9
SFN200109280,2001,10928,SFN,SDN,SFO03,5,10,15
SFN200109290,2001,10929,SFN,SDN,SFO03,1,3,4
SFN200109300,2001,10930,SFN,SDN,SFO03,5,4,9
SFN200110050,2001,11005,SFN,LAN,SFO03,11,10,21
SFN200110060,2001,11006,SFN,LAN,SFO03,6,2,8
SFN200110070,2001,11007,SFN,LAN,SFO03,1,2,3
SFN200204050,2002,20405,SFN,SDN,SFO03,1,3,4
SFN200204060,2002,20406,SFN,SDN,SFO03,1,4,5
SFN200204070,2002,20407,SFN,SDN,SFO03,1,10,11
SFN200204090,2002,20409,SFN,LAN,SFO03,3,0,3
SFN200204100,2002,20410,SFN,LAN,SFO03,1,2,3
SFN200204110,2002,20411,SFN,LAN,SFO03,4,3,7
SFN200204120,2002,20412,SFN,MIL,SFO03,1,5,6
SFN200204130,2002,20413,SFN,MIL,SFO03,2,3,5
SFN200204140,2002,20414,SFN,MIL,SFO03,4,3,7
SFN200204290,2002,20429,SFN,PHI,SFO03,5,8,13
SFN200204300,2002,20430,SFN,PHI,SFO03,8,2,10
SFN200205010,2002,20501,SFN,PHI,SFO03,1,2,3
SFN200205030,2002,20503,SFN,CIN,SFO03,1,6,7
SFN200205040,2002,20504,SFN,CIN,SFO03,0,3,3
SFN200205050,2002,20505,SFN,CIN,SFO03,5,6,11
SFN200205130,2002,20513,SFN,ATL,SFO03,6,7,13
SFN200205140,2002,20514,SFN,ATL,SFO03,0,2,2
SFN200205150,2002,20515,SFN,ATL,SFO03,6,1,7
SFN200205160,2002,20516,SFN,ATL,SFO03,5,4,9
SFN200205170,2002,20517,SFN,FLO,SFO03,3,9,12
SFN200205180,2002,20518,SFN,FLO,SFO03,5,10,15
SFN200205190,2002,20519,SFN,FLO,SFO03,4,2,6
SFN200205270,2002,20527,SFN,ARI,SFO03,3,7,10
SFN200205280,2002,20528,SFN,ARI,SFO03,0,1,1
SFN200205290,2002,20529,SFN,ARI,SFO03,7,3,10
SFN200205300,2002,20530,SFN,ARI,SFO03,1,0,1
SFN200205310,2002,20531,SFN,COL,SFO03,6,2,8
SFN200206010,2002,20601,SFN,COL,SFO03,5,4,9
SFN200206020,2002,20602,SFN,COL,SFO03,2,9,11
SFN200206140,2002,20614,SFN,OAK,SFO03,3,2,5
SFN200206150,2002,20615,SFN,OAK,SFO03,2,6,8
SFN200206160,2002,20616,SFN,OAK,SFO03,2,1,3
SFN200206180,2002,20618,SFN,TBA,SFO03,8,3,11
SFN200206190,2002,20619,SFN,TBA,SFO03,0,8,8
SFN200206200,2002,20620,SFN,TBA,SFO03,2,10,12
SFN200206210,2002,20621,SFN,BAL,SFO03,3,4,7
SFN200206220,2002,20622,SFN,BAL,SFO03,4,2,6
SFN200206230,2002,20623,SFN,BAL,SFO03,3,1,4
SFN200206260,2002,20626,SFN,SDN,SFO03,5,6,11
SFN200206270,2002,20627,SFN,SDN,SFO03,6,11,17
SFN200207110,2002,20711,SFN,COL,SFO03,2,3,5
SFN200207120,2002,20712,SFN,COL,SFO03,0,9,9
SFN200207130,2002,20713,SFN,COL,SFO03,1,6,7
SFN200207140,2002,20714,SFN,COL,SFO03,5,3,8
SFN200207150,2002,20715,SFN,ARI,SFO03,3,6,9
SFN200207160,2002,20716,SFN,ARI,SFO03,5,3,8
SFN200207220,2002,20722,SFN,SLN,SFO03,5,3,8
SFN200207230,2002,20723,SFN,SLN,SFO03,4,0,4
SFN200207240,2002,20724,SFN,SLN,SFO03,4,6,10
SFN200207250,2002,20725,SFN,SLN,SFO03,4,3,7
SFN200207260,2002,20726,SFN,LAN,SFO03,11,6,17
SFN200207270,2002,20727,SFN,LAN,SFO03,5,1,6
SFN200207280,2002,20728,SFN,LAN,SFO03,1,3,4
SFN200208060,2002,20806,SFN,CHN,SFO03,10,11,21
SFN200208070,2002,20807,SFN,CHN,SFO03,3,4,7
SFN200208080,2002,20808,SFN,CHN,SFO03,9,3,12
SFN200208090,2002,20809,SFN,PIT,SFO03,4,3,7
SFN200208100,2002,20810,SFN,PIT,SFO03,3,8,11
SFN200208110,2002,20811,SFN,PIT,SFO03,4,5,9
SFN200208200,2002,20820,SFN,NYN,SFO03,0,1,1
SFN200208210,2002,20821,SFN,NYN,SFO03,1,3,4
SFN200208220,2002,20822,SFN,NYN,SFO03,1,3,4
SFN200208230,2002,20823,SFN,MON,SFO03,7,2,9
SFN200208240,2002,20824,SFN,MON,SFO03,7,2,9
SFN200208250,2002,20825,SFN,MON,SFO03,4,8,12
SFN200209030,2002,20903,SFN,COL,SFO03,2,4,6
SFN200209040,2002,20904,SFN,COL,SFO03,2,1,3
SFN200209050,2002,20905,SFN,ARI,SFO03,8,5,13
SFN200209060,2002,20906,SFN,ARI,SFO03,0,1,1
SFN200209070,2002,20907,SFN,ARI,SFO03,3,4,7
SFN200209080,2002,20908,SFN,ARI,SFO03,1,3,4
SFN200209090,2002,20909,SFN,LAN,SFO03,5,6,11
SFN200209100,2002,20910,SFN,LAN,SFO03,2,5,7
SFN200209110,2002,20911,SFN,LAN,SFO03,7,3,10
SFN200209140,2002,20914,SFN,SDN,SFO03,4,12,16
SFN200209150,2002,20915,SFN,SDN,SFO03,4,1,5
SFN200209240,2002,20924,SFN,SDN,SFO03,3,12,15
SFN200209250,2002,20925,SFN,SDN,SFO03,0,6,6
SFN200209270,2002,20927,SFN,HOU,SFO03,1,2,3
SFN200209280,2002,20928,SFN,HOU,SFO03,2,5,7
SFN200209290,2002,20929,SFN,HOU,SFO03,0,7,7
SFN200210050,2002,21005,SFN,ATL,SFO03,10,2,12
SFN200210060,2002,21006,SFN,ATL,SFO03,3,8,11
SFN200210120,2002,21012,SFN,SLN,SFO03,5,4,9
SFN200210130,2002,21013,SFN,SLN,SFO03,3,4,7
SFN200210140,2002,21014,SFN,SLN,SFO03,1,2,3
SFN200210220,2002,21022,SFN,ANA,SFO03,10,4,14
SFN200210230,2002,21023,SFN,ANA,SFO03,3,4,7
SFN200210240,2002,21024,SFN,ANA,SFO03,4,16,20
SFN200304070,2003,30407,SFN,SDN,SFO03,4,7,11
SFN200304080,2003,30408,SFN,SDN,SFO03,9,4,13
SFN200304090,2003,30409,SFN,SDN,SFO03,11,15,26
SFN200304100,2003,30410,SFN,LAN,SFO03,1,2,3
SFN200304110,2003,30411,SFN,LAN,SFO03,2,3,5
SFN200304130,2003,30413,SFN,LAN,SFO03,4,5,9
SFN200304140,2003,30414,SFN,HOU,SFO03,2,4,6
SFN200304150,2003,30415,SFN,HOU,SFO03,4,8,12
SFN200304160,2003,30416,SFN,HOU,SFO03,8,5,13
SFN200304290,2003,30429,SFN,CHN,SFO03,4,2,6
SFN200304300,2003,30430,SFN,CHN,SFO03,0,5,5
SFN200305010,2003,30501,SFN,CHN,SFO03,5,1,6
SFN200305020,2003,30502,SFN,CIN,SFO03,5,1,6
SFN200305030,2003,30503,SFN,CIN,SFO03,6,9,15
SFN200305040,2003,30504,SFN,CIN,SFO03,1,6,7
SFN200305120,2003,30512,SFN,MON,SFO03,4,3,7
SFN200305130,2003,30513,SFN,MON,SFO03,6,4,10
SFN200305140,2003,30514,SFN,MON,SFO03,6,3,9
SFN200305150,2003,30515,SFN,NYN,SFO03,3,11,14
SFN200305160,2003,30516,SFN,NYN,SFO03,5,7,12
SFN200305170,2003,30517,SFN,NYN,SFO03,5,1,6
SFN200305180,2003,30518,SFN,NYN,SFO03,5,1,6
SFN200305270,2003,30527,SFN,ARI,SFO03,3,4,7
SFN200305280,2003,30528,SFN,ARI,SFO03,2,10,12
SFN200305300,2003,30530,SFN,COL,SFO03,2,6,8
SFN200305310,2003,30531,SFN,COL,SFO03,1,2,3
SFN200306010,2003,30601,SFN,COL,SFO03,0,4,4
SFN200306020,2003,30602,SFN,COL,SFO03,4,1,5
SFN200306030,2003,30603,SFN,MIN,SFO03,6,4,10
SFN200306040,2003,30604,SFN,MIN,SFO03,3,4,7
SFN200306050,2003,30605,SFN,MIN,SFO03,5,2,7
SFN200306060,2003,30606,SFN,DET,SFO03,3,5,8
SFN200306070,2003,30607,SFN,DET,SFO03,5,7,12
SFN200306080,2003,30608,SFN,DET,SFO03,6,7,13
SFN200306230,2003,30623,SFN,LAN,SFO03,2,3,5
SFN200306240,2003,30624,SFN,LAN,SFO03,1,2,3
SFN200306250,2003,30625,SFN,LAN,SFO03,6,0,6
SFN200306270,2003,30627,SFN,OAK,SFO03,0,6,6
SFN200306280,2003,30628,SFN,OAK,SFO03,7,8,15
SFN200306290,2003,30629,SFN,OAK,SFO03,5,2,7
SFN200307070,2003,30707,SFN,SLN,SFO03,1,5,6
SFN200307080,2003,30708,SFN,SLN,SFO03,3,8,11
SFN200307170,2003,30717,SFN,COL,SFO03,4,8,12
SFN200307180,2003,30718,SFN,COL,SFO03,0,7,7
SFN200307190,2003,30719,SFN,COL,SFO03,3,5,8
SFN200307200,2003,30720,SFN,COL,SFO03,4,8,12
SFN200307210,2003,30721,SFN,ARI,SFO03,4,5,9
SFN200307220,2003,30722,SFN,ARI,SFO03,1,3,4
SFN200307230,2003,30723,SFN,ARI,SFO03,1,7,8
SFN200307240,2003,30724,SFN,ARI,SFO03,2,3,5
SFN200307250,2003,30725,SFN,SDN,SFO03,2,5,7
SFN200307260,2003,30726,SFN,SDN,SFO03,2,1,3
SFN200307270,2003,30727,SFN,SDN,SFO03,2,6,8
SFN200308050,2003,30805,SFN,PIT,SFO03,0,3,3
SFN200308060,2003,30806,SFN,PIT,SFO03,2,0,2
SFN200308070,2003,30807,SFN,PIT,SFO03,5,7,12
SFN200308080,2003,30808,SFN,PHI,SFO03,1,9,10
SFN200308090,2003,30809,SFN,PHI,SFO03,8,6,14
SFN200308100,2003,30810,SFN,PHI,SFO03,2,5,7
SFN200308190,2003,30819,SFN,ATL,SFO03,4,5,9
SFN200308200,2003,30820,SFN,ATL,SFO03,1,2,3
SFN200308210,2003,30821,SFN,ATL,SFO03,3,4,7
SFN200308220,2003,30822,SFN,FLO,SFO03,4,6,10
SFN200308230,2003,30823,SFN,FLO,SFO03,2,3,5
SFN200308240,2003,30824,SFN,FLO,SFO03,7,4,11
SFN200309020,2003,30902,SFN,COL,SFO03,1,2,3
SFN200309030,2003,30903,SFN,COL,SFO03,6,7,13
SFN200309050,2003,30905,SFN,ARI,SFO03,8,1,9
SFN200309060,2003,30906,SFN,ARI,SFO03,4,5,9
SFN200309070,2003,30907,SFN,ARI,SFO03,9,6,15
SFN200309120,2003,30912,SFN,MIL,SFO03,2,8,10
SFN200309130,2003,30913,SFN,MIL,SFO03,5,4,9
SFN200309140,2003,30914,SFN,MIL,SFO03,4,5,9
SFN200309150,2003,30915,SFN,SDN,SFO03,7,8,15
SFN200309160,2003,30916,SFN,SDN,SFO03,2,4,6
SFN200309170,2003,30917,SFN,SDN,SFO03,3,8,11
SFN200309180,2003,30918,SFN,SDN,SFO03,7,3,10
SFN200309260,2003,30926,SFN,LAN,SFO03,1,10,11
SFN200309271,2003,30927,SFN,LAN,SFO03,5,0,5
SFN200309272,2003,30927,SFN,LAN,SFO03,3,6,9
SFN200309280,2003,30928,SFN,LAN,SFO03,3,12,15
SFN200309300,2003,30930,SFN,FLO,SFO03,0,2,2
SFN200310010,2003,31001,SFN,FLO,SFO03,9,5,14
SFN200404120,2004,40412,SFN,MIL,SFO03,5,7,12
SFN200404130,2004,40413,SFN,MIL,SFO03,2,4,6
SFN200404140,2004,40414,SFN,MIL,SFO03,3,0,3
SFN200404160,2004,40416,SFN,LAN,SFO03,3,2,5
SFN200404170,2004,40417,SFN,LAN,SFO03,5,4,9
SFN200404180,2004,40418,SFN,LAN,SFO03,7,6,13
SFN200404190,2004,40419,SFN,SDN,SFO03,3,4,7
SFN200404200,2004,40420,SFN,SDN,SFO03,9,5,14
SFN200404210,2004,40421,SFN,SDN,SFO03,11,0,11
SFN200404220,2004,40422,SFN,SDN,SFO03,9,4,13
SFN200404260,2004,40426,SFN,ATL,SFO03,2,3,5
SFN200404270,2004,40427,SFN,ATL,SFO03,12,3,15
SFN200404280,2004,40428,SFN,ATL,SFO03,7,10,17
SFN200404290,2004,40429,SFN,FLO,SFO03,4,3,7
SFN200404300,2004,40430,SFN,FLO,SFO03,9,12,21
SFN200405010,2004,40501,SFN,FLO,SFO03,3,6,9
SFN200405020,2004,40502,SFN,FLO,SFO03,8,9,17
SFN200405110,2004,40511,SFN,PHI,SFO03,10,4,14
SFN200405120,2004,40512,SFN,PHI,SFO03,3,4,7
SFN200405130,2004,40513,SFN,PHI,SFO03,4,3,7
SFN200405140,2004,40514,SFN,PIT,SFO03,4,2,6
SFN200405150,2004,40515,SFN,PIT,SFO03,6,4,10
SFN200405160,2004,40516,SFN,PIT,SFO03,8,1,9
SFN200405250,2004,40525,SFN,ARI,SFO03,1,4,5
SFN200405260,2004,40526,SFN,ARI,SFO03,3,4,7
SFN200405270,2004,40527,SFN,ARI,SFO03,4,5,9
SFN200405280,2004,40528,SFN,COL,SFO03,2,4,6
SFN200405290,2004,40529,SFN,COL,SFO03,3,5,8
SFN200405300,2004,40530,SFN,COL,SFO03,1,3,4
SFN200406150,2004,40615,SFN,TOR,SFO03,3,4,7
SFN200406160,2004,40616,SFN,TOR,SFO03,2,10,12
SFN200406170,2004,40617,SFN,TOR,SFO03,5,8,13
SFN200406180,2004,40618,SFN,BOS,SFO03,14,9,23
SFN200406190,2004,40619,SFN,BOS,SFO03,4,6,10
SFN200406200,2004,40620,SFN,BOS,SFO03,0,4,4
SFN200406210,2004,40621,SFN,LAN,SFO03,2,3,5
SFN200406220,2004,40622,SFN,LAN,SFO03,5,11,16
SFN200406230,2004,40623,SFN,LAN,SFO03,2,3,5
SFN200406240,2004,40624,SFN,LAN,SFO03,3,9,12
SFN200407020,2004,40702,SFN,OAK,SFO03,3,7,10
SFN200407030,2004,40703,SFN,OAK,SFO03,6,2,8
SFN200407040,2004,40704,SFN,OAK,SFO03,9,6,15
SFN200407050,2004,40705,SFN,COL,SFO03,7,4,11
SFN200407060,2004,40706,SFN,COL,SFO03,8,6,14
SFN200407070,2004,40707,SFN,COL,SFO03,4,8,12
SFN200407080,2004,40708,SFN,ARI,SFO03,8,4,12
SFN200407090,2004,40709,SFN,ARI,SFO03,3,8,11
SFN200407100,2004,40710,SFN,ARI,SFO03,1,3,4
SFN200407110,2004,40711,SFN,ARI,SFO03,2,9,11
SFN200407210,2004,40721,SFN,SDN,SFO03,7,1,8
SFN200407220,2004,40722,SFN,SDN,SFO03,9,4,13
SFN200407300,2004,40730,SFN,SLN,SFO03,7,4,11
SFN200407310,2004,40731,SFN,SLN,SFO03,7,8,15
SFN200408010,2004,40801,SFN,SLN,SFO03,6,1,7
SFN200408030,2004,40803,SFN,CIN,SFO03,0,11,11
SFN200408040,2004,40804,SFN,CIN,SFO03,8,7,15
SFN200408050,2004,40805,SFN,CIN,SFO03,12,3,15
SFN200408060,2004,40806,SFN,CHN,SFO03,2,6,8
SFN200408070,2004,40807,SFN,CHN,SFO03,8,4,12
SFN200408080,2004,40808,SFN,CHN,SFO03,3,6,9
SFN200408160,2004,40816,SFN,MON,SFO03,5,8,13
SFN200408170,2004,40817,SFN,MON,SFO03,4,5,9
SFN200408181,2004,40818,SFN,MON,SFO03,6,2,8
SFN200408182,2004,40818,SFN,MON,SFO03,4,14,18
SFN200408200,2004,40820,SFN,NYN,SFO03,3,7,10
SFN200408210,2004,40821,SFN,NYN,SFO03,11,9,20
SFN200408220,2004,40822,SFN,NYN,SFO03,1,3,4
SFN200408310,2004,40831,SFN,COL,SFO03,5,9,14
SFN200409010,2004,40901,SFN,COL,SFO03,4,1,5
SFN200409020,2004,40902,SFN,COL,SFO03,6,5,11
SFN200409030,2004,40903,SFN,ARI,SFO03,7,18,25
SFN200409040,2004,40904,SFN,ARI,SFO03,7,9,16
SFN200409050,2004,40905,SFN,ARI,SFO03,1,4,5
SFN200409170,2004,40917,SFN,SDN,SFO03,1,4,5
SFN200409180,2004,40918,SFN,SDN,SFO03,5,1,6
SFN200409190,2004,40919,SFN,SDN,SFO03,2,4,6
SFN200409210,2004,40921,SFN,HOU,SFO03,2,9,11
SFN200409220,2004,40922,SFN,HOU,SFO03,1,5,6
SFN200409230,2004,40923,SFN,HOU,SFO03,7,3,10
SFN200409240,2004,40924,SFN,LAN,SFO03,3,2,5
SFN200409250,2004,40925,SFN,LAN,SFO03,5,9,14
SFN200409260,2004,40926,SFN,LAN,SFO03,7,4,11
SFN200504050,2005,50405,SFN,LAN,SFO03,2,4,6
SFN200504060,2005,50406,SFN,LAN,SFO03,10,4,14
SFN200504070,2005,50407,SFN,LAN,SFO03,6,0,6
SFN200504080,2005,50408,SFN,COL,SFO03,8,10,18
SFN200504090,2005,50409,SFN,COL,SFO03,2,4,6
SFN200504100,2005,50410,SFN,COL,SFO03,4,11,15
SFN200504200,2005,50420,SFN,ARI,SFO03,2,1,3
SFN200504210,2005,50421,SFN,ARI,SFO03,3,4,7
SFN200504220,2005,50422,SFN,MIL,SFO03,6,1,7
SFN200504230,2005,50423,SFN,MIL,SFO03,2,6,8
SFN200504240,2005,50424,SFN,MIL,SFO03,8,5,13
SFN200504250,2005,50425,SFN,SDN,SFO03,5,3,8
SFN200504260,2005,50426,SFN,SDN,SFO03,5,6,11
SFN200504270,2005,50427,SFN,SDN,SFO03,3,10,13
SFN200505060,2005,50506,SFN,WAS,SFO03,9,3,12
SFN200505070,2005,50507,SFN,WAS,SFO03,11,8,19
SFN200505080,2005,50508,SFN,WAS,SFO03,3,4,7
SFN200505090,2005,50509,SFN,PIT,SFO03,1,2,3
SFN200505100,2005,50510,SFN,PIT,SFO03,5,2,7
SFN200505110,2005,50511,SFN,PIT,SFO03,7,2,9
SFN200505200,2005,50520,SFN,OAK,SFO03,8,4,12
SFN200505210,2005,50521,SFN,OAK,SFO03,2,3,5
SFN200505220,2005,50522,SFN,OAK,SFO03,1,3,4
SFN200505240,2005,50524,SFN,LAN,SFO03,3,5,8
SFN200505250,2005,50525,SFN,LAN,SFO03,2,10,12
SFN200505260,2005,50526,SFN,LAN,SFO03,6,4,10
SFN200505270,2005,50527,SFN,SDN,SFO03,9,3,12
SFN200505280,2005,50528,SFN,SDN,SFO03,5,3,8
SFN200505290,2005,50529,SFN,SDN,SFO03,9,6,15
SFN200506070,2005,50607,SFN,KCA,SFO03,8,1,9
SFN200506080,2005,50608,SFN,KCA,SFO03,4,1,5
SFN200506090,2005,50609,SFN,KCA,SFO03,7,9,16
SFN200506100,2005,50610,SFN,CLE,SFO03,10,2,12
SFN200506110,2005,50611,SFN,CLE,SFO03,7,6,13
SFN200506120,2005,50612,SFN,CLE,SFO03,5,3,8
SFN200506200,2005,50620,SFN,ARI,SFO03,3,8,11
SFN200506210,2005,50621,SFN,ARI,SFO03,6,4,10
SFN200506220,2005,50622,SFN,ARI,SFO03,0,4,4
SFN200506230,2005,50623,SFN,ARI,SFO03,7,2,9
SFN200507040,2005,50704,SFN,CIN,SFO03,11,10,21
SFN200507050,2005,50705,SFN,CIN,SFO03,7,4,11
SFN200507060,2005,50706,SFN,CIN,SFO03,2,7,9
SFN200507070,2005,50707,SFN,CIN,SFO03,1,5,6
SFN200507080,2005,50708,SFN,SLN,SFO03,3,1,4
SFN200507090,2005,50709,SFN,SLN,SFO03,0,2,2
SFN200507100,2005,50710,SFN,SLN,SFO03,4,3,7
SFN200507180,2005,50718,SFN,ATL,SFO03,6,1,7
SFN200507190,2005,50719,SFN,ATL,SFO03,4,5,9
SFN200507200,2005,50720,SFN,ATL,SFO03,4,1,5
SFN200507220,2005,50722,SFN,FLO,SFO03,5,8,13
SFN200507230,2005,50723,SFN,FLO,SFO03,16,4,20
SFN200507240,2005,50724,SFN,FLO,SFO03,4,1,5
SFN200508020,2005,50802,SFN,COL,SFO03,4,3,7
SFN200508030,2005,50803,SFN,COL,SFO03,3,2,5
SFN200508040,2005,50804,SFN,COL,SFO03,4,6,10
SFN200508050,2005,50805,SFN,HOU,SFO03,0,4,4
SFN200508060,2005,50806,SFN,HOU,SFO03,2,5,7
SFN200508070,2005,50807,SFN,HOU,SFO03,8,1,9
SFN200508220,2005,50822,SFN,PHI,SFO03,0,5,5
SFN200508230,2005,50823,SFN,PHI,SFO03,10,2,12
SFN200508240,2005,50824,SFN,PHI,SFO03,7,4,11
SFN200508260,2005,50826,SFN,NYN,SFO03,1,0,1
SFN200508270,2005,50827,SFN,NYN,SFO03,1,2,3
SFN200508280,2005,50828,SFN,NYN,SFO03,1,4,5
SFN200508290,2005,50829,SFN,COL,SFO03,2,1,3
SFN200508300,2005,50830,SFN,COL,SFO03,3,4,7
SFN200508310,2005,50831,SFN,COL,SFO03,3,5,8
SFN200509080,2005,50908,SFN,CHN,SFO03,5,3,8
SFN200509090,2005,50909,SFN,CHN,SFO03,1,2,3
SFN200509100,2005,50910,SFN,CHN,SFO03,5,2,7
SFN200509110,2005,50911,SFN,CHN,SFO03,3,2,5
SFN200509120,2005,50912,SFN,SDN,SFO03,3,4,7
SFN200509130,2005,50913,SFN,SDN,SFO03,4,5,9
SFN200509140,2005,50914,SFN,SDN,SFO03,5,4,9
SFN200509150,2005,50915,SFN,LAN,SFO03,7,1,8
SFN200509160,2005,50916,SFN,LAN,SFO03,4,5,9
SFN200509170,2005,50917,SFN,LAN,SFO03,1,2,3
SFN200509180,2005,50918,SFN,LAN,SFO03,3,5,8
SFN200509300,2005,50930,SFN,ARI,SFO03,7,3,10
SFN200510010,2005,51001,SFN,ARI,SFO03,2,1,3
SFN200510020,2005,51002,SFN,ARI,SFO03,1,3,4
SFN200604060,2006,60406,SFN,ATL,SFO03,4,6,10
SFN200604070,2006,60407,SFN,ATL,SFO03,14,6,20
SFN200604080,2006,60408,SFN,ATL,SFO03,6,12,18
SFN200604090,2006,60409,SFN,ATL,SFO03,5,6,11
SFN200604131,2006,60413,SFN,HOU,SFO03,3,5,8
SFN200604132,2006,60413,SFN,HOU,SFO03,8,0,8
SFN200604240,2006,60424,SFN,NYN,SFO03,2,6,8
SFN200604250,2006,60425,SFN,NYN,SFO03,4,1,5
SFN200604260,2006,60426,SFN,NYN,SFO03,9,7,16
SFN200604280,2006,60428,SFN,ARI,SFO03,2,10,12
SFN200604290,2006,60429,SFN,ARI,SFO03,2,3,5
SFN200604300,2006,60430,SFN,ARI,SFO03,8,2,10
SFN200605010,2006,60501,SFN,SDN,SFO03,10,4,14
SFN200605020,2006,60502,SFN,SDN,SFO03,5,3,8
SFN200605080,2006,60508,SFN,HOU,SFO03,5,7,12
SFN200605090,2006,60509,SFN,CHN,SFO03,1,6,7
SFN200605100,2006,60510,SFN,CHN,SFO03,8,1,9
SFN200605110,2006,60511,SFN,CHN,SFO03,3,9,12
SFN200605120,2006,60512,SFN,LAN,SFO03,6,1,7
SFN200605130,2006,60513,SFN,LAN,SFO03,5,6,11
SFN200605140,2006,60514,SFN,LAN,SFO03,6,3,9
SFN200605220,2006,60522,SFN,SLN,SFO03,2,9,11
SFN200605230,2006,60523,SFN,SLN,SFO03,8,5,13
SFN200605240,2006,60524,SFN,SLN,SFO03,10,4,14
SFN200605260,2006,60526,SFN,COL,SFO03,0,9,9
SFN200605270,2006,60527,SFN,COL,SFO03,1,4,5
SFN200605280,2006,60528,SFN,COL,SFO03,6,3,9
SFN200606050,2006,60605,SFN,FLO,SFO03,2,14,16
SFN200606060,2006,60606,SFN,FLO,SFO03,1,2,3
SFN200606070,2006,60607,SFN,FLO,SFO03,8,1,9
SFN200606080,2006,60608,SFN,PIT,SFO03,4,5,9
SFN200606090,2006,60609,SFN,PIT,SFO03,3,2,5
SFN200606100,2006,60610,SFN,PIT,SFO03,2,0,2
SFN200606110,2006,60611,SFN,PIT,SFO03,7,5,12
SFN200606190,2006,60619,SFN,ANA,SFO03,1,2,3
SFN200606200,2006,60620,SFN,ANA,SFO03,2,3,5
SFN200606210,2006,60621,SFN,ANA,SFO03,6,3,9
SFN200606230,2006,60623,SFN,OAK,SFO03,4,3,7
SFN200606240,2006,60624,SFN,OAK,SFO03,7,8,15
SFN200606250,2006,60625,SFN,OAK,SFO03,10,4,14
SFN200606270,2006,60627,SFN,TEX,SFO03,3,5,8
SFN200606280,2006,60628,SFN,TEX,SFO03,1,5,6
SFN200606290,2006,60629,SFN,TEX,SFO03,1,2,3
SFN200607140,2006,60714,SFN,PHI,SFO03,3,5,8
SFN200607150,2006,60715,SFN,PHI,SFO03,14,6,20
SFN200607160,2006,60716,SFN,PHI,SFO03,6,2,8
SFN200607170,2006,60717,SFN,MIL,SFO03,10,1,11
SFN200607180,2006,60718,SFN,MIL,SFO03,3,4,7
SFN200607190,2006,60719,SFN,MIL,SFO03,6,7,13
SFN200607200,2006,60720,SFN,SDN,SFO03,3,9,12
SFN200607210,2006,60721,SFN,SDN,SFO03,2,8,10
SFN200607220,2006,60722,SFN,SDN,SFO03,3,4,7
SFN200607230,2006,60723,SFN,SDN,SFO03,6,5,11
SFN200607310,2006,60731,SFN,WAS,SFO03,10,7,17
SFN200608010,2006,60801,SFN,WAS,SFO03,4,1,5
SFN200608020,2006,60802,SFN,WAS,SFO03,6,8,14
SFN200608040,2006,60804,SFN,COL,SFO03,5,2,7
SFN200608050,2006,60805,SFN,COL,SFO03,2,1,3
SFN200608060,2006,60806,SFN,COL,SFO03,2,6,8
SFN200608180,2006,60818,SFN,LAN,SFO03,3,7,10
SFN200608190,2006,60819,SFN,LAN,SFO03,14,7,21
SFN200608200,2006,60820,SFN,LAN,SFO03,5,2,7
SFN200608210,2006,60821,SFN,ARI,SFO03,0,5,5
SFN200608220,2006,60822,SFN,ARI,SFO03,6,7,13
SFN200608230,2006,60823,SFN,ARI,SFO03,6,7,13
SFN200608240,2006,60824,SFN,CIN,SFO03,6,3,9
SFN200608250,2006,60825,SFN,CIN,SFO03,1,4,5
SFN200608260,2006,60826,SFN,CIN,SFO03,1,4,5
SFN200608270,2006,60827,SFN,CIN,SFO03,0,8,8
SFN200609080,2006,60908,SFN,SDN,SFO03,0,4,4
SFN200609090,2006,60909,SFN,SDN,SFO03,4,5,9
SFN200609100,2006,60910,SFN,SDN,SFO03,10,2,12
SFN200609120,2006,60912,SFN,COL,SFO03,6,10,16
SFN200609130,2006,60913,SFN,COL,SFO03,9,8,17
SFN200609140,2006,60914,SFN,COL,SFO03,0,5,5
SFN200609250,2006,60925,SFN,ARI,SFO03,7,1,8
SFN200609260,2006,60926,SFN,ARI,SFO03,2,4,6
SFN200609270,2006,60927,SFN,ARI,SFO03,6,3,9
SFN200609290,2006,60929,SFN,LAN,SFO03,4,3,7
SFN200609300,2006,60930,SFN,LAN,SFO03,4,2,6
SFN200610010,2006,61001,SFN,LAN,SFO03,4,3,7
SFN200704030,2007,70403,SFN,SDN,SFO03,7,0,7
SFN200704040,2007,70404,SFN,SDN,SFO03,5,3,8
SFN200704050,2007,70405,SFN,SDN,SFO03,3,5,8
SFN200704060,2007,70406,SFN,LAN,SFO03,2,1,3
SFN200704070,2007,70407,SFN,LAN,SFO03,4,1,5
SFN200704080,2007,70408,SFN,LAN,SFO03,10,4,14
SFN200704180,2007,70418,SFN,SLN,SFO03,5,6,11
SFN200704190,2007,70419,SFN,SLN,SFO03,2,6,8
SFN200704200,2007,70420,SFN,ARI,SFO03,2,4,6
SFN200704210,2007,70421,SFN,ARI,SFO03,0,1,1
SFN200704220,2007,70422,SFN,ARI,SFO03,1,2,3
SFN200704300,2007,70430,SFN,COL,SFO03,5,9,14
SFN200705010,2007,70501,SFN,COL,SFO03,9,7,16
SFN200705020,2007,70502,SFN,COL,SFO03,3,5,8
SFN200705030,2007,70503,SFN,PHI,SFO03,9,7,16
SFN200705040,2007,70504,SFN,PHI,SFO03,2,6,8
SFN200705050,2007,70505,SFN,PHI,SFO03,4,9,13
SFN200705060,2007,70506,SFN,PHI,SFO03,8,5,13
SFN200705070,2007,70507,SFN,NYN,SFO03,4,9,13
SFN200705080,2007,70508,SFN,NYN,SFO03,4,1,5
SFN200705090,2007,70509,SFN,NYN,SFO03,5,3,8
SFN200705210,2007,70521,SFN,HOU,SFO03,0,4,4
SFN200705220,2007,70522,SFN,HOU,SFO03,2,4,6
SFN200705230,2007,70523,SFN,HOU,SFO03,1,9,10
SFN200705250,2007,70525,SFN,COL,SFO03,5,3,8
SFN200705260,2007,70526,SFN,COL,SFO03,6,1,7
SFN200705270,2007,70527,SFN,COL,SFO03,6,4,10
SFN200706080,2007,70608,SFN,OAK,SFO03,5,3,8
SFN200706090,2007,70609,SFN,OAK,SFO03,6,0,6
SFN200706100,2007,70610,SFN,OAK,SFO03,2,0,2
SFN200706110,2007,70611,SFN,TOR,SFO03,3,4,7
SFN200706120,2007,70612,SFN,TOR,SFO03,2,3,5
SFN200706130,2007,70613,SFN,TOR,SFO03,7,4,11
SFN200706220,2007,70622,SFN,NYA,SFO03,7,3,10
SFN200706230,2007,70623,SFN,NYA,SFO03,5,6,11
SFN200706240,2007,70624,SFN,NYA,SFO03,2,7,9
SFN200706250,2007,70625,SFN,SDN,SFO03,3,4,7
SFN200706260,2007,70626,SFN,SDN,SFO03,3,2,5
SFN200706270,2007,70627,SFN,SDN,SFO03,4,2,6
SFN200706290,2007,70629,SFN,ARI,SFO03,4,3,7
SFN200706300,2007,70630,SFN,ARI,SFO03,1,4,5
SFN200707010,2007,70701,SFN,ARI,SFO03,0,13,13
SFN200707130,2007,70713,SFN,LAN,SFO03,9,1,10
SFN200707140,2007,70714,SFN,LAN,SFO03,8,7,15
SFN200707150,2007,70715,SFN,LAN,SFO03,5,3,8
SFN200707230,2007,70723,SFN,ATL,SFO03,4,2,6
SFN200707240,2007,70724,SFN,ATL,SFO03,7,5,12
SFN200707250,2007,70725,SFN,ATL,SFO03,1,2,3
SFN200707260,2007,70726,SFN,ATL,SFO03,2,4,6
SFN200707270,2007,70727,SFN,FLO,SFO03,10,12,22
SFN200707280,2007,70728,SFN,FLO,SFO03,3,4,7
SFN200707290,2007,70729,SFN,FLO,SFO03,8,5,13
SFN200708060,2007,70806,SFN,WAS,SFO03,2,3,5
SFN200708070,2007,70807,SFN,WAS,SFO03,8,6,14
SFN200708080,2007,70808,SFN,WAS,SFO03,0,5,5
SFN200708090,2007,70809,SFN,WAS,SFO03,3,1,4
SFN200708100,2007,70810,SFN,PIT,SFO03,8,7,15
SFN200708110,2007,70811,SFN,PIT,SFO03,13,3,16
SFN200708120,2007,70812,SFN,PIT,SFO03,5,0,5
SFN200708210,2007,70821,SFN,CHN,SFO03,5,1,6
SFN200708220,2007,70822,SFN,CHN,SFO03,4,2,6
SFN200708230,2007,70823,SFN,CHN,SFO03,1,4,5
SFN200708240,2007,70824,SFN,MIL,SFO03,6,11,17
SFN200708250,2007,70825,SFN,MIL,SFO03,2,6,8
SFN200708260,2007,70826,SFN,MIL,SFO03,4,5,9
SFN200708270,2007,70827,SFN,COL,SFO03,1,4,5
SFN200708280,2007,70828,SFN,COL,SFO03,1,3,4
SFN200708290,2007,70829,SFN,COL,SFO03,8,0,8
SFN200709070,2007,70907,SFN,LAN,SFO03,4,5,9
SFN200709080,2007,70908,SFN,LAN,SFO03,6,2,8
SFN200709090,2007,70909,SFN,LAN,SFO03,2,4,6
SFN200709100,2007,70910,SFN,ARI,SFO03,5,3,8
SFN200709110,2007,70911,SFN,ARI,SFO03,1,2,3
SFN200709120,2007,70912,SFN,ARI,SFO03,9,4,13
SFN200709200,2007,70920,SFN,CIN,SFO03,4,2,6
SFN200709210,2007,70921,SFN,CIN,SFO03,9,8,17
SFN200709220,2007,70922,SFN,CIN,SFO03,0,2,2
SFN200709230,2007,70923,SFN,CIN,SFO03,4,5,9
SFN200709240,2007,70924,SFN,SDN,SFO03,4,9,13
SFN200709250,2007,70925,SFN,SDN,SFO03,6,4,10
SFN200709260,2007,70926,SFN,SDN,SFO03,11,3,14
SFN200804070,2008,80407,SFN,SDN,SFO03,8,4,12
SFN200804080,2008,80408,SFN,SDN,SFO03,2,3,5
SFN200804090,2008,80409,SFN,SDN,SFO03,0,1,1
SFN200804100,2008,80410,SFN,SLN,SFO03,1,5,6
SFN200804110,2008,80411,SFN,SLN,SFO03,8,2,10
SFN200804120,2008,80412,SFN,SLN,SFO03,8,7,15
SFN200804130,2008,80413,SFN,SLN,SFO03,4,7,11
SFN200804140,2008,80414,SFN,ARI,SFO03,4,5,9
SFN200804150,2008,80415,SFN,ARI,SFO03,8,2,10
SFN200804160,2008,80416,SFN,ARI,SFO03,4,1,5
SFN200804250,2008,80425,SFN,CIN,SFO03,1,3,4
SFN200804260,2008,80426,SFN,CIN,SFO03,10,9,19
SFN200804270,2008,80427,SFN,CIN,SFO03,10,1,11
SFN200804280,2008,80428,SFN,COL,SFO03,0,4,4
SFN200804290,2008,80429,SFN,COL,SFO03,3,2,5
SFN200804300,2008,80430,SFN,COL,SFO03,2,3,5
SFN200805090,2008,80509,SFN,PHI,SFO03,7,4,11
SFN200805100,2008,80510,SFN,PHI,SFO03,2,8,10
SFN200805110,2008,80511,SFN,PHI,SFO03,3,4,7
SFN200805120,2008,80512,SFN,HOU,SFO03,7,3,10
SFN200805130,2008,80513,SFN,HOU,SFO03,2,4,6
SFN200805140,2008,80514,SFN,HOU,SFO03,6,3,9
SFN200805150,2008,80515,SFN,HOU,SFO03,8,7,15
SFN200805160,2008,80516,SFN,CHA,SFO03,2,0,2
SFN200805170,2008,80517,SFN,CHA,SFO03,3,1,4
SFN200805180,2008,80518,SFN,CHA,SFO03,13,8,21
SFN200805300,2008,80530,SFN,SDN,SFO03,7,3,10
SFN200805310,2008,80531,SFN,SDN,SFO03,5,1,6
SFN200806010,2008,80601,SFN,SDN,SFO03,3,4,7
SFN200806020,2008,80602,SFN,NYN,SFO03,2,10,12
SFN200806030,2008,80603,SFN,NYN,SFO03,9,6,15
SFN200806040,2008,80604,SFN,NYN,SFO03,5,3,8
SFN200806130,2008,80613,SFN,OAK,SFO03,5,1,6
SFN200806140,2008,80614,SFN,OAK,SFO03,4,0,4
SFN200806150,2008,80615,SFN,OAK,SFO03,5,3,8
SFN200806160,2008,80616,SFN,DET,SFO03,6,8,14
SFN200806170,2008,80617,SFN,DET,SFO03,5,1,6
SFN200806180,2008,80618,SFN,DET,SFO03,7,2,9
SFN200806300,2008,80630,SFN,CHN,SFO03,9,2,11
SFN200807010,2008,80701,SFN,CHN,SFO03,1,2,3
SFN200807020,2008,80702,SFN,CHN,SFO03,6,5,11
SFN200807030,2008,80703,SFN,CHN,SFO03,3,8,11
SFN200807040,2008,80704,SFN,LAN,SFO03,10,7,17
SFN200807050,2008,80705,SFN,LAN,SFO03,2,5,7
SFN200807060,2008,80706,SFN,LAN,SFO03,5,3,8
SFN200807180,2008,80718,SFN,MIL,SFO03,9,1,10
SFN200807190,2008,80719,SFN,MIL,SFO03,8,5,13
SFN200807200,2008,80720,SFN,MIL,SFO03,7,4,11
SFN200807220,2008,80722,SFN,WAS,SFO03,3,6,9
SFN200807230,2008,80723,SFN,WAS,SFO03,4,6,10
SFN200807240,2008,80724,SFN,WAS,SFO03,0,1,1
SFN200807250,2008,80725,SFN,ARI,SFO03,10,2,12
SFN200807260,2008,80726,SFN,ARI,SFO03,5,3,8
SFN200807270,2008,80727,SFN,ARI,SFO03,7,2,9
SFN200808040,2008,80804,SFN,ATL,SFO03,2,4,6
SFN200808050,2008,80805,SFN,ATL,SFO03,11,4,15
SFN200808060,2008,80806,SFN,ATL,SFO03,2,3,5
SFN200808080,2008,80808,SFN,LAN,SFO03,6,2,8
SFN200808090,2008,80809,SFN,LAN,SFO03,2,3,5
SFN200808100,2008,80810,SFN,LAN,SFO03,4,5,9
SFN200808190,2008,80819,SFN,FLO,SFO03,6,0,6
SFN200808200,2008,80820,SFN,FLO,SFO03,5,6,11
SFN200808210,2008,80821,SFN,FLO,SFO03,3,4,7
SFN200808220,2008,80822,SFN,SDN,SFO03,0,5,5
SFN200808230,2008,80823,SFN,SDN,SFO03,3,4,7
SFN200808240,2008,80824,SFN,SDN,SFO03,4,7,11
SFN200808250,2008,80825,SFN,COL,SFO03,4,2,6
SFN200808260,2008,80826,SFN,COL,SFO03,7,2,9
SFN200808270,2008,80827,SFN,COL,SFO03,1,4,5
SFN200809050,2008,80905,SFN,PIT,SFO03,7,0,7
SFN200809060,2008,80906,SFN,PIT,SFO03,6,7,13
SFN200809070,2008,80907,SFN,PIT,SFO03,6,11,17
SFN200809080,2008,80908,SFN,ARI,SFO03,2,6,8
SFN200809090,2008,80909,SFN,ARI,SFO03,4,5,9
SFN200809100,2008,80910,SFN,ARI,SFO03,3,4,7
SFN200809230,2008,80923,SFN,COL,SFO03,9,4,13
SFN200809240,2008,80924,SFN,COL,SFO03,15,6,21
SFN200809250,2008,80925,SFN,COL,SFO03,3,1,4
SFN200809260,2008,80926,SFN,LAN,SFO03,5,6,11
SFN200809270,2008,80927,SFN,LAN,SFO03,2,1,3
SFN200809280,2008,80928,SFN,LAN,SFO03,1,3,4
SFN200904070,2009,90407,SFN,MIL,SFO03,6,10,16
SFN200904080,2009,90408,SFN,MIL,SFO03,4,2,6
SFN200904090,2009,90409,SFN,MIL,SFO03,1,7,8
SFN200904170,2009,90417,SFN,ARI,SFO03,0,2,2
SFN200904180,2009,90418,SFN,ARI,SFO03,2,0,2
SFN200904190,2009,90419,SFN,ARI,SFO03,0,2,2
SFN200904210,2009,90421,SFN,SDN,SFO03,3,8,11
SFN200904220,2009,90422,SFN,SDN,SFO03,0,1,1
SFN200904270,2009,90427,SFN,LAN,SFO03,4,5,9
SFN200904280,2009,90428,SFN,LAN,SFO03,5,3,8
SFN200904290,2009,90429,SFN,LAN,SFO03,4,9,13
SFN200905010,2009,90501,SFN,COL,SFO03,2,3,5
SFN200905020,2009,90502,SFN,COL,SFO03,5,1,6
SFN200905030,2009,90503,SFN,COL,SFO03,0,1,1
SFN200905110,2009,90511,SFN,WAS,SFO03,7,11,18
SFN200905120,2009,90512,SFN,WAS,SFO03,7,9,16
SFN200905130,2009,90513,SFN,WAS,SFO03,6,3,9
SFN200905140,2009,90514,SFN,NYN,SFO03,7,4,11
SFN200905150,2009,90515,SFN,NYN,SFO03,8,6,14
SFN200905160,2009,90516,SFN,NYN,SFO03,9,6,15
SFN200905170,2009,90517,SFN,NYN,SFO03,0,2,2
SFN200905250,2009,90525,SFN,ATL,SFO03,2,8,10
SFN200905260,2009,90526,SFN,ATL,SFO03,0,4,4
SFN200905270,2009,90527,SFN,ATL,SFO03,3,6,9
SFN200905290,2009,90529,SFN,SLN,SFO03,2,4,6
SFN200905300,2009,90530,SFN,SLN,SFO03,6,2,8
SFN200905310,2009,90531,SFN,SLN,SFO03,3,5,8
SFN200906120,2009,90612,SFN,OAK,SFO03,0,3,3
SFN200906130,2009,90613,SFN,OAK,SFO03,2,5,7
SFN200906140,2009,90614,SFN,OAK,SFO03,1,7,8
SFN200906150,2009,90615,SFN,ANA,SFO03,9,7,16
SFN200906160,2009,90616,SFN,ANA,SFO03,8,1,9
SFN200906170,2009,90617,SFN,ANA,SFO03,4,3,7
SFN200906190,2009,90619,SFN,TEX,SFO03,4,6,10
SFN200906200,2009,90620,SFN,TEX,SFO03,1,2,3
SFN200906210,2009,90621,SFN,TEX,SFO03,2,3,5
SFN200907030,2009,90703,SFN,HOU,SFO03,0,13,13
SFN200907040,2009,90704,SFN,HOU,SFO03,0,9,9
SFN200907050,2009,90705,SFN,HOU,SFO03,7,1,8
SFN200907060,2009,90706,SFN,FLO,SFO03,4,5,9
SFN200907070,2009,90707,SFN,FLO,SFO03,0,3,3
SFN200907080,2009,90708,SFN,FLO,SFO03,7,0,7
SFN200907090,2009,90709,SFN,SDN,SFO03,3,9,12
SFN200907100,2009,90710,SFN,SDN,SFO03,0,8,8
SFN200907110,2009,90711,SFN,SDN,SFO03,1,2,3
SFN200907120,2009,90712,SFN,SDN,SFO03,10,4,14
SFN200907270,2009,90727,SFN,PIT,SFO03,2,4,6
SFN200907280,2009,90728,SFN,PIT,SFO03,2,3,5
SFN200907290,2009,90729,SFN,PIT,SFO03,0,1,1
SFN200907300,2009,90730,SFN,PHI,SFO03,2,7,9
SFN200907310,2009,90731,SFN,PHI,SFO03,5,1,6
SFN200908010,2009,90801,SFN,PHI,SFO03,0,2,2
SFN200908020,2009,90802,SFN,PHI,SFO03,3,7,10
SFN200908070,2009,90807,SFN,CIN,SFO03,10,5,15
SFN200908080,2009,90808,SFN,CIN,SFO03,2,4,6
SFN200908090,2009,90809,SFN,CIN,SFO03,5,2,7
SFN200908100,2009,90810,SFN,LAN,SFO03,4,2,6
SFN200908110,2009,90811,SFN,LAN,SFO03,9,1,10
SFN200908120,2009,90812,SFN,LAN,SFO03,2,4,6
SFN200908250,2009,90825,SFN,ARI,SFO03,4,5,9
SFN200908260,2009,90826,SFN,ARI,SFO03,3,4,7
SFN200908270,2009,90827,SFN,ARI,SFO03,11,0,11
SFN200908280,2009,90828,SFN,COL,SFO03,0,2,2
SFN200908290,2009,90829,SFN,COL,SFO03,3,5,8
SFN200908300,2009,90830,SFN,COL,SFO03,5,9,14
SFN200909070,2009,90907,SFN,SDN,SFO03,4,9,13
SFN200909080,2009,90908,SFN,SDN,SFO03,4,3,7
SFN200909090,2009,90909,SFN,SDN,SFO03,4,2,6
SFN200909110,2009,90911,SFN,LAN,SFO03,10,3,13
SFN200909120,2009,90912,SFN,LAN,SFO03,9,1,10
SFN200909130,2009,90913,SFN,LAN,SFO03,2,7,9
SFN200909140,2009,90914,SFN,COL,SFO03,1,9,10
SFN200909150,2009,90915,SFN,COL,SFO03,2,10,12
SFN200909160,2009,90916,SFN,COL,SFO03,4,3,7
SFN200909240,2009,90924,SFN,CHN,SFO03,3,2,5
SFN200909250,2009,90925,SFN,CHN,SFO03,3,0,3
SFN200909260,2009,90926,SFN,CHN,SFO03,6,2,8
SFN200909270,2009,90927,SFN,CHN,SFO03,1,5,6
SFN200909290,2009,90929,SFN,ARI,SFO03,4,8,12
SFN200909300,2009,90930,SFN,ARI,SFO03,1,4,5
SFN200910010,2009,91001,SFN,ARI,SFO03,3,7,10
SLN200004030,2000,403,SLN,CHN,STL09,1,7,8
SLN200004050,2000,405,SLN,CHN,STL09,4,10,14
SLN200004060,2000,406,SLN,CHN,STL09,3,13,16
SLN200004070,2000,407,SLN,MIL,STL09,9,1,10
SLN200004080,2000,408,SLN,MIL,STL09,8,10,18
SLN200004090,2000,409,SLN,MIL,STL09,2,11,13
SLN200004180,2000,418,SLN,SDN,STL09,4,5,9
SLN200004190,2000,419,SLN,SDN,STL09,3,4,7
SLN200004200,2000,420,SLN,SDN,STL09,1,14,15
SLN200004210,2000,421,SLN,COL,STL09,6,4,10
SLN200004220,2000,422,SLN,COL,STL09,7,6,13
SLN200004230,2000,423,SLN,COL,STL09,3,6,9
SLN200004250,2000,425,SLN,MIL,STL09,2,7,9
SLN200004260,2000,426,SLN,MIL,STL09,0,7,7
SLN200004270,2000,427,SLN,MIL,STL09,8,4,12
SLN200005020,2000,502,SLN,PIT,STL09,10,7,17
SLN200005030,2000,503,SLN,PIT,STL09,8,2,10
SLN200005040,2000,504,SLN,PIT,STL09,0,5,5
SLN200005120,2000,512,SLN,LAN,STL09,13,0,13
SLN200005130,2000,513,SLN,LAN,STL09,3,1,4
SLN200005140,2000,514,SLN,LAN,STL09,10,12,22
SLN200005230,2000,523,SLN,FLO,STL09,3,10,13
SLN200005240,2000,524,SLN,FLO,STL09,1,5,6
SLN200005250,2000,525,SLN,FLO,STL09,6,7,13
SLN200005260,2000,526,SLN,NYN,STL09,5,2,7
SLN200005270,2000,527,SLN,NYN,STL09,12,8,20
SLN200005280,2000,528,SLN,NYN,STL09,6,2,8
SLN200006020,2000,602,SLN,CLE,STL09,1,5,6
SLN200006030,2000,603,SLN,CLE,STL09,4,2,6
SLN200006040,2000,604,SLN,CLE,STL09,3,2,5
SLN200006050,2000,605,SLN,KCA,STL09,7,4,11
SLN200006060,2000,606,SLN,KCA,STL09,4,5,9
SLN200006070,2000,607,SLN,KCA,STL09,2,4,6
SLN200006200,2000,620,SLN,SFN,STL09,2,7,9
SLN200006210,2000,621,SLN,SFN,STL09,4,1,5
SLN200006220,2000,622,SLN,SFN,STL09,10,11,21
SLN200006230,2000,623,SLN,LAN,STL09,6,9,15
SLN200006240,2000,624,SLN,LAN,STL09,1,6,7
SLN200006250,2000,625,SLN,LAN,STL09,1,2,3
SLN200006300,2000,630,SLN,HOU,STL09,4,5,9
SLN200007010,2000,701,SLN,HOU,STL09,9,10,19
SLN200007020,2000,702,SLN,HOU,STL09,6,3,9
SLN200007040,2000,704,SLN,CIN,STL09,3,14,17
SLN200007050,2000,705,SLN,CIN,STL09,3,4,7
SLN200007060,2000,706,SLN,CIN,STL09,12,6,18
SLN200007070,2000,707,SLN,SFN,STL09,4,2,6
SLN200007080,2000,708,SLN,SFN,STL09,7,6,13
SLN200007090,2000,709,SLN,SFN,STL09,7,8,15
SLN200007250,2000,725,SLN,ARI,STL09,3,7,10
SLN200007260,2000,726,SLN,ARI,STL09,4,8,12
SLN200007270,2000,727,SLN,ARI,STL09,17,5,22
SLN200008040,2000,804,SLN,ATL,STL09,6,4,10
SLN200008050,2000,805,SLN,ATL,STL09,0,5,5
SLN200008060,2000,806,SLN,ATL,STL09,6,4,10
SLN200008070,2000,807,SLN,FLO,STL09,1,2,3
SLN200008080,2000,808,SLN,FLO,STL09,7,0,7
SLN200008090,2000,809,SLN,FLO,STL09,5,3,8
SLN200008100,2000,810,SLN,COL,STL09,4,5,9
SLN200008180,2000,818,SLN,PHI,STL09,6,7,13
SLN200008190,2000,819,SLN,PHI,STL09,3,6,9
SLN200008200,2000,820,SLN,PHI,STL09,6,0,6
SLN200008210,2000,821,SLN,PIT,STL09,4,7,11
SLN200008220,2000,822,SLN,PIT,STL09,6,2,8
SLN200008230,2000,823,SLN,PIT,STL09,2,5,7
SLN200009010,2000,901,SLN,NYN,STL09,5,6,11
SLN200009020,2000,902,SLN,NYN,STL09,1,2,3
SLN200009030,2000,903,SLN,NYN,STL09,3,4,7
SLN200009040,2000,904,SLN,MON,STL09,2,4,6
SLN200009050,2000,905,SLN,MON,STL09,6,7,13
SLN200009060,2000,906,SLN,MON,STL09,7,2,9
SLN200009070,2000,907,SLN,MON,STL09,1,6,7
SLN200009140,2000,914,SLN,CHN,STL09,0,4,4
SLN200009150,2000,915,SLN,CHN,STL09,2,3,5
SLN200009160,2000,916,SLN,CHN,STL09,6,7,13
SLN200009170,2000,917,SLN,CHN,STL09,2,4,6
SLN200009190,2000,919,SLN,HOU,STL09,8,6,14
SLN200009200,2000,920,SLN,HOU,STL09,6,11,17
SLN200009210,2000,921,SLN,HOU,STL09,7,5,12
SLN200009290,2000,929,SLN,CIN,STL09,8,1,9
SLN200009300,2000,930,SLN,CIN,STL09,8,4,12
SLN200010010,2000,1001,SLN,CIN,STL09,2,6,8
SLN200010030,2000,1003,SLN,ATL,STL09,5,7,12
SLN200010050,2000,1005,SLN,ATL,STL09,4,10,14
SLN200010110,2000,1011,SLN,NYN,STL09,6,2,8
SLN200010120,2000,1012,SLN,NYN,STL09,6,5,11
SLN200104090,2001,10409,SLN,COL,STL09,2,3,5
SLN200104110,2001,10411,SLN,COL,STL09,1,3,4
SLN200104120,2001,10412,SLN,COL,STL09,6,4,10
SLN200104130,2001,10413,SLN,HOU,STL09,4,2,6
SLN200104140,2001,10414,SLN,HOU,STL09,7,4,11
SLN200104150,2001,10415,SLN,HOU,STL09,5,6,11
SLN200104160,2001,10416,SLN,ARI,STL09,2,1,3
SLN200104170,2001,10417,SLN,ARI,STL09,17,4,21
SLN200104180,2001,10418,SLN,ARI,STL09,1,3,4
SLN200104240,2001,10424,SLN,MON,STL09,2,7,9
SLN200104250,2001,10425,SLN,MON,STL09,2,5,7
SLN200104260,2001,10426,SLN,MON,STL09,4,3,7
SLN200104270,2001,10427,SLN,NYN,STL09,0,9,9
SLN200104280,2001,10428,SLN,NYN,STL09,6,5,11
SLN200104290,2001,10429,SLN,NYN,STL09,1,12,13
SLN200105070,2001,10507,SLN,PIT,STL09,0,7,7
SLN200105080,2001,10508,SLN,PIT,STL09,2,8,10
SLN200105090,2001,10509,SLN,PIT,STL09,2,6,8
SLN200105100,2001,10510,SLN,PIT,STL09,5,11,16
SLN200105110,2001,10511,SLN,CHN,STL09,2,7,9
SLN200105120,2001,10512,SLN,CHN,STL09,2,5,7
SLN200105130,2001,10513,SLN,CHN,STL09,4,13,17
SLN200105280,2001,10528,SLN,MIL,STL09,2,6,8
SLN200105290,2001,10529,SLN,MIL,STL09,7,0,7
SLN200105300,2001,10530,SLN,MIL,STL09,11,1,12
SLN200105310,2001,10531,SLN,MIL,STL09,6,2,8
SLN200106010,2001,10601,SLN,CIN,STL09,5,1,6
SLN200106020,2001,10602,SLN,CIN,STL09,5,8,13
SLN200106030,2001,10603,SLN,CIN,STL09,3,4,7
SLN200106040,2001,10604,SLN,CIN,STL09,2,5,7
SLN200106150,2001,10615,SLN,CHA,STL09,3,10,13
SLN200106160,2001,10616,SLN,CHA,STL09,3,8,11
SLN200106170,2001,10617,SLN,CHA,STL09,3,8,11
SLN200106180,2001,10618,SLN,CHN,STL09,2,6,8
SLN200106190,2001,10619,SLN,CHN,STL09,2,3,5
SLN200106200,2001,10620,SLN,CHN,STL09,9,4,13
SLN200106210,2001,10621,SLN,CHN,STL09,5,2,7
SLN200106220,2001,10622,SLN,SFN,STL09,10,5,15
SLN200106230,2001,10623,SLN,SFN,STL09,5,6,11
SLN200106240,2001,10624,SLN,SFN,STL09,3,7,10
SLN200106260,2001,10626,SLN,CIN,STL09,10,9,19
SLN200106270,2001,10627,SLN,CIN,STL09,3,1,4
SLN200107120,2001,10712,SLN,DET,STL09,7,5,12
SLN200107130,2001,10713,SLN,DET,STL09,4,1,5
SLN200107140,2001,10714,SLN,DET,STL09,2,3,5
SLN200107150,2001,10715,SLN,MIN,STL09,1,5,6
SLN200107160,2001,10716,SLN,MIN,STL09,3,4,7
SLN200107170,2001,10717,SLN,MIN,STL09,2,4,6
SLN200107200,2001,10720,SLN,PIT,STL09,4,1,5
SLN200107210,2001,10721,SLN,PIT,STL09,2,9,11
SLN200107220,2001,10722,SLN,PIT,STL09,2,0,2
SLN200107240,2001,10724,SLN,HOU,STL09,2,1,3
SLN200107250,2001,10725,SLN,HOU,STL09,2,10,12
SLN200107310,2001,10731,SLN,ATL,STL09,2,6,8
SLN200108010,2001,10801,SLN,ATL,STL09,0,4,4
SLN200108020,2001,10802,SLN,ATL,STL09,2,1,3
SLN200108031,2001,10803,SLN,FLO,STL09,5,9,14
SLN200108032,2001,10803,SLN,FLO,STL09,6,4,10
SLN200108040,2001,10804,SLN,FLO,STL09,0,3,3
SLN200108050,2001,10805,SLN,FLO,STL09,5,3,8
SLN200108130,2001,10813,SLN,CIN,STL09,2,3,5
SLN200108140,2001,10814,SLN,CIN,STL09,1,7,8
SLN200108150,2001,10815,SLN,CIN,STL09,4,8,12
SLN200108160,2001,10816,SLN,CIN,STL09,3,8,11
SLN200108170,2001,10817,SLN,PHI,STL09,3,4,7
SLN200108180,2001,10818,SLN,PHI,STL09,3,6,9
SLN200108190,2001,10819,SLN,PHI,STL09,0,9,9
SLN200108280,2001,10828,SLN,SDN,STL09,5,2,7
SLN200108290,2001,10829,SLN,SDN,STL09,14,16,30
SLN200108300,2001,10830,SLN,SDN,STL09,3,13,16
SLN200109070,2001,10907,SLN,LAN,STL09,7,1,8
SLN200109080,2001,10908,SLN,LAN,STL09,5,6,11
SLN200109090,2001,10909,SLN,LAN,STL09,1,8,9
SLN200109170,2001,10917,SLN,MIL,STL09,1,2,3
SLN200109180,2001,10918,SLN,MIL,STL09,4,9,13
SLN200109190,2001,10919,SLN,MIL,STL09,2,8,10
SLN200109280,2001,10928,SLN,PIT,STL09,3,14,17
SLN200109290,2001,10929,SLN,PIT,STL09,0,2,2
SLN200109300,2001,10930,SLN,PIT,STL09,3,7,10
SLN200110050,2001,11005,SLN,HOU,STL09,2,1,3
SLN200110060,2001,11006,SLN,HOU,STL09,6,10,16
SLN200110070,2001,11007,SLN,HOU,STL09,9,2,11
SLN200110120,2001,11012,SLN,ARI,STL09,5,3,8
SLN200110130,2001,11013,SLN,ARI,STL09,1,4,5
SLN200204010,2002,20401,SLN,COL,STL09,2,10,12
SLN200204030,2002,20403,SLN,COL,STL09,6,3,9
SLN200204040,2002,20404,SLN,COL,STL09,6,1,7
SLN200204090,2002,20409,SLN,MIL,STL09,5,6,11
SLN200204100,2002,20410,SLN,MIL,STL09,5,6,11
SLN200204110,2002,20411,SLN,MIL,STL09,5,6,11
SLN200204120,2002,20412,SLN,HOU,STL09,3,7,10
SLN200204130,2002,20413,SLN,HOU,STL09,1,2,3
SLN200204140,2002,20414,SLN,HOU,STL09,5,4,9
SLN200204300,2002,20430,SLN,FLO,STL09,7,2,9
SLN200205010,2002,20501,SLN,FLO,STL09,4,6,10
SLN200205020,2002,20502,SLN,FLO,STL09,9,6,15
SLN200205030,2002,20503,SLN,ATL,STL09,2,1,3
SLN200205040,2002,20504,SLN,ATL,STL09,2,3,5
SLN200205050,2002,20505,SLN,ATL,STL09,4,2,6
SLN200205130,2002,20513,SLN,CHN,STL09,0,3,3
SLN200205140,2002,20514,SLN,CHN,STL09,2,11,13
SLN200205150,2002,20515,SLN,CHN,STL09,1,4,5
SLN200205170,2002,20517,SLN,CIN,STL09,1,3,4
SLN200205180,2002,20518,SLN,CIN,STL09,7,3,10
SLN200205190,2002,20519,SLN,CIN,STL09,1,10,11
SLN200205200,2002,20520,SLN,CIN,STL09,3,7,10
SLN200205210,2002,20521,SLN,HOU,STL09,1,3,4
SLN200205220,2002,20522,SLN,HOU,STL09,2,3,5
SLN200205230,2002,20523,SLN,HOU,STL09,4,5,9
SLN200205310,2002,20531,SLN,PIT,STL09,3,1,4
SLN200206010,2002,20601,SLN,PIT,STL09,4,9,13
SLN200206020,2002,20602,SLN,PIT,STL09,5,2,7
SLN200206140,2002,20614,SLN,KCA,STL09,0,3,3
SLN200206150,2002,20615,SLN,KCA,STL09,3,5,8
SLN200206160,2002,20616,SLN,KCA,STL09,1,5,6
SLN200206180,2002,20618,SLN,ANA,STL09,2,7,9
SLN200206190,2002,20619,SLN,ANA,STL09,2,6,8
SLN200206200,2002,20620,SLN,ANA,STL09,3,2,5
SLN200206250,2002,20625,SLN,MIL,STL09,2,0,2
SLN200206260,2002,20626,SLN,MIL,STL09,2,5,7
SLN200206270,2002,20627,SLN,MIL,STL09,7,2,9
SLN200206280,2002,20628,SLN,CIN,STL09,2,3,5
SLN200206290,2002,20629,SLN,CIN,STL09,4,2,6
SLN200206300,2002,20630,SLN,CIN,STL09,12,8,20
SLN200207010,2002,20701,SLN,SDN,STL09,3,7,10
SLN200207020,2002,20702,SLN,SDN,STL09,5,11,16
SLN200207030,2002,20703,SLN,SDN,STL09,1,4,5
SLN200207040,2002,20704,SLN,LAN,STL09,2,3,5
SLN200207050,2002,20705,SLN,LAN,STL09,6,5,11
SLN200207060,2002,20706,SLN,LAN,STL09,4,2,6
SLN200207070,2002,20707,SLN,LAN,STL09,6,12,18
SLN200207170,2002,20717,SLN,SFN,STL09,5,4,9
SLN200207180,2002,20718,SLN,SFN,STL09,1,5,6
SLN200207260,2002,20726,SLN,CHN,STL09,4,8,12
SLN200207270,2002,20727,SLN,CHN,STL09,7,3,10
SLN200207280,2002,20728,SLN,CHN,STL09,9,10,19
SLN200208060,2002,20806,SLN,MON,STL09,10,1,11
SLN200208070,2002,20807,SLN,MON,STL09,4,1,5
SLN200208080,2002,20808,SLN,MON,STL09,3,5,8
SLN200208090,2002,20809,SLN,NYN,STL09,2,1,3
SLN200208100,2002,20810,SLN,NYN,STL09,4,5,9
SLN200208110,2002,20811,SLN,NYN,STL09,0,9,9
SLN200208190,2002,20819,SLN,PIT,STL09,2,7,9
SLN200208200,2002,20820,SLN,PIT,STL09,8,0,8
SLN200208210,2002,20821,SLN,PIT,STL09,1,4,5
SLN200208220,2002,20822,SLN,PIT,STL09,4,5,9
SLN200208230,2002,20823,SLN,PHI,STL09,5,4,9
SLN200208240,2002,20824,SLN,PHI,STL09,4,0,4
SLN200208250,2002,20825,SLN,PHI,STL09,5,3,8
SLN200209020,2002,20902,SLN,CIN,STL09,5,3,8
SLN200209030,2002,20903,SLN,CIN,STL09,1,3,4
SLN200209040,2002,20904,SLN,CIN,STL09,5,10,15
SLN200209060,2002,20906,SLN,CHN,STL09,2,11,13
SLN200209070,2002,20907,SLN,CHN,STL09,5,6,11
SLN200209080,2002,20908,SLN,CHN,STL09,1,3,4
SLN200209200,2002,20920,SLN,HOU,STL09,3,9,12
SLN200209210,2002,20921,SLN,HOU,STL09,6,3,9
SLN200209220,2002,20922,SLN,HOU,STL09,3,7,10
SLN200209230,2002,20923,SLN,ARI,STL09,1,13,14
SLN200209240,2002,20924,SLN,ARI,STL09,2,3,5
SLN200209250,2002,20925,SLN,ARI,STL09,1,6,7
SLN200209260,2002,20926,SLN,MIL,STL09,1,9,10
SLN200209270,2002,20927,SLN,MIL,STL09,2,1,3
SLN200209280,2002,20928,SLN,MIL,STL09,1,3,4
SLN200209290,2002,20929,SLN,MIL,STL09,0,4,4
SLN200210050,2002,21005,SLN,ARI,STL09,3,6,9
SLN200210090,2002,21009,SLN,SFN,STL09,9,6,15
SLN200210100,2002,21010,SLN,SFN,STL09,4,1,5
SLN200303310,2003,30331,SLN,MIL,STL09,9,11,20
SLN200304020,2003,30402,SLN,MIL,STL09,0,7,7
SLN200304030,2003,30403,SLN,MIL,STL09,4,6,10
SLN200304040,2003,30404,SLN,HOU,STL09,6,5,11
SLN200304050,2003,30405,SLN,HOU,STL09,2,1,3
SLN200304180,2003,30418,SLN,ARI,STL09,3,6,9
SLN200304190,2003,30419,SLN,ARI,STL09,4,3,7
SLN200304200,2003,30420,SLN,ARI,STL09,1,0,1
SLN200304290,2003,30429,SLN,NYN,STL09,3,13,16
SLN200304300,2003,30430,SLN,NYN,STL09,4,13,17
SLN200305010,2003,30501,SLN,NYN,STL09,5,6,11
SLN200305020,2003,30502,SLN,MON,STL09,1,8,9
SLN200305030,2003,30503,SLN,MON,STL09,1,3,4
SLN200305040,2003,30504,SLN,MON,STL09,2,6,8
SLN200305130,2003,30513,SLN,CIN,STL09,7,2,9
SLN200305140,2003,30514,SLN,CIN,STL09,4,0,4
SLN200305150,2003,30515,SLN,CIN,STL09,3,6,9
SLN200305160,2003,30516,SLN,CHN,STL09,4,7,11
SLN200305170,2003,30517,SLN,CHN,STL09,2,1,3
SLN200305180,2003,30518,SLN,CHN,STL09,3,6,9
SLN200305190,2003,30519,SLN,CHN,STL09,0,2,2
SLN200305260,2003,30526,SLN,HOU,STL09,5,10,15
SLN200305270,2003,30527,SLN,HOU,STL09,7,4,11
SLN200305280,2003,30528,SLN,HOU,STL09,1,3,4
SLN200305290,2003,30529,SLN,HOU,STL09,7,4,11
SLN200305300,2003,30530,SLN,PIT,STL09,7,3,10
SLN200305310,2003,30531,SLN,PIT,STL09,4,3,7
SLN200306010,2003,30601,SLN,PIT,STL09,4,5,9
SLN200306030,2003,30603,SLN,TOR,STL09,5,11,16
SLN200306040,2003,30604,SLN,TOR,STL09,5,8,13
SLN200306050,2003,30605,SLN,TOR,STL09,5,13,18
SLN200306060,2003,30606,SLN,BAL,STL09,6,8,14
SLN200306070,2003,30607,SLN,BAL,STL09,8,1,9
SLN200306080,2003,30608,SLN,BAL,STL09,10,11,21
SLN200306200,2003,30620,SLN,KCA,STL09,10,4,14
SLN200306210,2003,30621,SLN,KCA,STL09,1,8,9
SLN200306220,2003,30622,SLN,KCA,STL09,5,2,7
SLN200306240,2003,30624,SLN,CIN,STL09,7,4,11
SLN200306250,2003,30625,SLN,CIN,STL09,6,9,15
SLN200306260,2003,30626,SLN,CIN,STL09,7,11,18
SLN200306300,2003,30630,SLN,SFN,STL09,5,1,6
SLN200307010,2003,30701,SLN,SFN,STL09,5,1,6
SLN200307020,2003,30702,SLN,SFN,STL09,4,1,5
SLN200307030,2003,30703,SLN,SFN,STL09,5,9,14
SLN200307090,2003,30709,SLN,LAN,STL09,6,5,11
SLN200307100,2003,30710,SLN,LAN,STL09,9,4,13
SLN200307110,2003,30711,SLN,SDN,STL09,2,4,6
SLN200307120,2003,30712,SLN,SDN,STL09,7,9,16
SLN200307130,2003,30713,SLN,SDN,STL09,1,3,4
SLN200307250,2003,30725,SLN,PIT,STL09,10,5,15
SLN200307260,2003,30726,SLN,PIT,STL09,8,13,21
SLN200307270,2003,30727,SLN,PIT,STL09,3,4,7
SLN200307280,2003,30728,SLN,PIT,STL09,3,0,3
SLN200308050,2003,30805,SLN,FLO,STL09,4,0,4
SLN200308060,2003,30806,SLN,FLO,STL09,7,3,10
SLN200308070,2003,30807,SLN,FLO,STL09,0,3,3
SLN200308080,2003,30808,SLN,ATL,STL09,7,2,9
SLN200308090,2003,30809,SLN,ATL,STL09,1,3,4
SLN200308100,2003,30810,SLN,ATL,STL09,2,3,5
SLN200308190,2003,30819,SLN,PIT,STL09,5,13,18
SLN200308200,2003,30820,SLN,PIT,STL09,14,0,14
SLN200308210,2003,30821,SLN,PIT,STL09,3,6,9
SLN200308220,2003,30822,SLN,PHI,STL09,9,4,13
SLN200308230,2003,30823,SLN,PHI,STL09,3,5,8
SLN200308240,2003,30824,SLN,PHI,STL09,0,3,3
SLN200308260,2003,30826,SLN,CHN,STL09,7,4,11
SLN200308270,2003,30827,SLN,CHN,STL09,2,4,6
SLN200308280,2003,30828,SLN,CHN,STL09,2,3,5
SLN200309050,2003,30905,SLN,CIN,STL09,4,2,6
SLN200309060,2003,30906,SLN,CIN,STL09,6,13,19
SLN200309070,2003,30907,SLN,CIN,STL09,0,9,9
SLN200309090,2003,30909,SLN,COL,STL09,8,1,9
SLN200309100,2003,30910,SLN,COL,STL09,2,10,12
SLN200309110,2003,30911,SLN,COL,STL09,9,4,13
SLN200309150,2003,30915,SLN,MIL,STL09,2,11,13
SLN200309160,2003,30916,SLN,MIL,STL09,5,6,11
SLN200309170,2003,30917,SLN,MIL,STL09,7,6,13
SLN200309180,2003,30918,SLN,MIL,STL09,0,13,13
SLN200309190,2003,30919,SLN,HOU,STL09,8,1,9
SLN200309200,2003,30920,SLN,HOU,STL09,2,3,5
SLN200309210,2003,30921,SLN,HOU,STL09,4,6,10
SLN200404050,2004,40405,SLN,MIL,STL09,8,6,14
SLN200404060,2004,40406,SLN,MIL,STL09,7,5,12
SLN200404070,2004,40407,SLN,MIL,STL09,4,9,13
SLN200404080,2004,40408,SLN,MIL,STL09,11,5,16
SLN200404120,2004,40412,SLN,HOU,STL09,10,5,15
SLN200404130,2004,40413,SLN,HOU,STL09,5,3,8
SLN200404140,2004,40414,SLN,HOU,STL09,11,1,12
SLN200404160,2004,40416,SLN,COL,STL09,5,13,18
SLN200404170,2004,40417,SLN,COL,STL09,4,8,12
SLN200404180,2004,40418,SLN,COL,STL09,8,5,13
SLN200404270,2004,40427,SLN,PHI,STL09,7,3,10
SLN200404280,2004,40428,SLN,PHI,STL09,6,3,9
SLN200404290,2004,40429,SLN,PHI,STL09,4,5,9
SLN200404300,2004,40430,SLN,CHN,STL09,3,4,7
SLN200405010,2004,40501,SLN,CHN,STL09,4,2,6
SLN200405020,2004,40502,SLN,CHN,STL09,0,1,1
SLN200405030,2004,40503,SLN,CHN,STL09,7,3,10
SLN200405110,2004,40511,SLN,ATL,STL09,1,5,6
SLN200405120,2004,40512,SLN,ATL,STL09,2,5,7
SLN200405130,2004,40513,SLN,ATL,STL09,6,5,11
SLN200405140,2004,40514,SLN,FLO,STL09,3,6,9
SLN200405150,2004,40515,SLN,FLO,STL09,0,4,4
SLN200405160,2004,40516,SLN,FLO,STL09,3,2,5
SLN200405260,2004,40526,SLN,PIT,STL09,11,8,19
SLN200405270,2004,40527,SLN,PIT,STL09,3,6,9
SLN200406040,2004,40604,SLN,HOU,STL09,3,5,8
SLN200406050,2004,40605,SLN,HOU,STL09,4,10,14
SLN200406060,2004,40606,SLN,HOU,STL09,3,2,5
SLN200406150,2004,40615,SLN,OAK,STL09,4,8,12
SLN200406160,2004,40616,SLN,OAK,STL09,2,6,8
SLN200406170,2004,40617,SLN,OAK,STL09,4,5,9
SLN200406180,2004,40618,SLN,CIN,STL09,3,4,7
SLN200406190,2004,40619,SLN,CIN,STL09,2,9,11
SLN200406200,2004,40620,SLN,CIN,STL09,6,0,6
SLN200406220,2004,40622,SLN,CHN,STL09,5,4,9
SLN200406230,2004,40623,SLN,CHN,STL09,9,10,19
SLN200406240,2004,40624,SLN,CHN,STL09,0,4,4
SLN200407020,2004,40702,SLN,SEA,STL09,2,11,13
SLN200407030,2004,40703,SLN,SEA,STL09,1,8,9
SLN200407040,2004,40704,SLN,SEA,STL09,1,2,3
SLN200407050,2004,40705,SLN,CIN,STL09,1,4,5
SLN200407060,2004,40706,SLN,CIN,STL09,3,5,8
SLN200407070,2004,40707,SLN,CIN,STL09,2,4,6
SLN200407090,2004,40709,SLN,CHN,STL09,1,6,7
SLN200407100,2004,40710,SLN,CHN,STL09,2,5,7
SLN200407110,2004,40711,SLN,CHN,STL09,8,4,12
SLN200407210,2004,40721,SLN,MIL,STL09,0,1,1
SLN200407220,2004,40722,SLN,MIL,STL09,0,4,4
SLN200407230,2004,40723,SLN,SFN,STL09,7,2,9
SLN200407240,2004,40724,SLN,SFN,STL09,5,3,8
SLN200407250,2004,40725,SLN,SFN,STL09,0,6,6
SLN200408030,2004,40803,SLN,MON,STL09,10,6,16
SLN200408040,2004,40804,SLN,MON,STL09,4,5,9
SLN200408050,2004,40805,SLN,MON,STL09,1,2,3
SLN200408060,2004,40806,SLN,NYN,STL09,4,6,10
SLN200408070,2004,40807,SLN,NYN,STL09,1,2,3
SLN200408080,2004,40808,SLN,NYN,STL09,2,6,8
SLN200408160,2004,40816,SLN,CIN,STL09,5,10,15
SLN200408170,2004,40817,SLN,CIN,STL09,2,7,9
SLN200408180,2004,40818,SLN,CIN,STL09,5,4,9
SLN200408190,2004,40819,SLN,PIT,STL09,3,2,5
SLN200408201,2004,40820,SLN,PIT,STL09,4,5,9
SLN200408202,2004,40820,SLN,PIT,STL09,3,5,8
SLN200408210,2004,40821,SLN,PIT,STL09,6,10,16
SLN200408220,2004,40822,SLN,PIT,STL09,4,11,15
SLN200408310,2004,40831,SLN,SDN,STL09,3,9,12
SLN200409010,2004,40901,SLN,SDN,STL09,2,4,6
SLN200409020,2004,40902,SLN,SDN,STL09,2,7,9
SLN200409030,2004,40903,SLN,LAN,STL09,0,3,3
SLN200409040,2004,40904,SLN,LAN,STL09,1,5,6
SLN200409050,2004,40905,SLN,LAN,STL09,5,6,11
SLN200409140,2004,40914,SLN,HOU,STL09,7,5,12
SLN200409150,2004,40915,SLN,HOU,STL09,2,4,6
SLN200409160,2004,40916,SLN,HOU,STL09,8,3,11
SLN200409170,2004,40917,SLN,ARI,STL09,3,4,7
SLN200409180,2004,40918,SLN,ARI,STL09,0,7,7
SLN200409190,2004,40919,SLN,ARI,STL09,3,2,5
SLN200409300,2004,40930,SLN,MIL,STL09,7,6,13
SLN200410010,2004,41001,SLN,MIL,STL09,1,4,5
SLN200410020,2004,41002,SLN,MIL,STL09,5,1,6
SLN200410030,2004,41003,SLN,MIL,STL09,4,9,13
SLN200410050,2004,41005,SLN,LAN,STL09,3,8,11
SLN200410070,2004,41007,SLN,LAN,STL09,3,8,11
SLN200410130,2004,41013,SLN,HOU,STL09,7,10,17
SLN200410140,2004,41014,SLN,HOU,STL09,4,6,10
SLN200410200,2004,41020,SLN,HOU,STL09,4,6,10
SLN200410210,2004,41021,SLN,HOU,STL09,2,5,7
SLN200410260,2004,41026,SLN,BOS,STL09,4,1,5
SLN200410270,2004,41027,SLN,BOS,STL09,3,0,3
SLN200504080,2005,50408,SLN,PHI,STL09,5,6,11
SLN200504090,2005,50409,SLN,PHI,STL09,10,4,14
SLN200504100,2005,50410,SLN,PHI,STL09,13,4,17
SLN200504120,2005,50412,SLN,CIN,STL09,1,5,6
SLN200504130,2005,50413,SLN,CIN,STL09,6,5,11
SLN200504200,2005,50420,SLN,CHN,STL09,3,1,4
SLN200504210,2005,50421,SLN,CHN,STL09,0,4,4
SLN200504220,2005,50422,SLN,HOU,STL09,7,8,15
SLN200504230,2005,50423,SLN,HOU,STL09,0,1,1
SLN200504240,2005,50424,SLN,HOU,STL09,5,8,13
SLN200504260,2005,50426,SLN,MIL,STL09,3,5,8
SLN200504270,2005,50427,SLN,MIL,STL09,3,6,9
SLN200504280,2005,50428,SLN,MIL,STL09,4,3,7
SLN200505050,2005,50505,SLN,SDN,STL09,8,3,11
SLN200505060,2005,50506,SLN,SDN,STL09,6,5,11
SLN200505070,2005,50507,SLN,SDN,STL09,5,4,9
SLN200505080,2005,50508,SLN,SDN,STL09,5,15,20
SLN200505090,2005,50509,SLN,LAN,STL09,2,4,6
SLN200505100,2005,50510,SLN,LAN,STL09,9,8,17
SLN200505110,2005,50511,SLN,LAN,STL09,3,9,12
SLN200505120,2005,50512,SLN,LAN,STL09,3,10,13
SLN200505230,2005,50523,SLN,PIT,STL09,2,4,6
SLN200505240,2005,50524,SLN,PIT,STL09,1,2,3
SLN200505250,2005,50525,SLN,PIT,STL09,5,11,16
SLN200505270,2005,50527,SLN,WAS,STL09,3,6,9
SLN200505280,2005,50528,SLN,WAS,STL09,1,3,4
SLN200505290,2005,50529,SLN,WAS,STL09,3,2,5
SLN200506060,2005,50606,SLN,BOS,STL09,1,7,8
SLN200506070,2005,50607,SLN,BOS,STL09,2,9,11
SLN200506080,2005,50608,SLN,BOS,STL09,4,0,4
SLN200506100,2005,50610,SLN,NYA,STL09,1,8,9
SLN200506110,2005,50611,SLN,NYA,STL09,5,0,5
SLN200506120,2005,50612,SLN,NYA,STL09,3,5,8
SLN200506230,2005,50623,SLN,PIT,STL09,11,7,18
SLN200506240,2005,50624,SLN,PIT,STL09,1,8,9
SLN200506250,2005,50625,SLN,PIT,STL09,0,8,8
SLN200506260,2005,50626,SLN,PIT,STL09,5,4,9
SLN200506280,2005,50628,SLN,CIN,STL09,1,2,3
SLN200506290,2005,50629,SLN,CIN,STL09,3,11,14
SLN200506300,2005,50630,SLN,COL,STL09,7,0,7
SLN200507010,2005,50701,SLN,COL,STL09,0,6,6
SLN200507020,2005,50702,SLN,COL,STL09,3,1,4
SLN200507030,2005,50703,SLN,COL,STL09,4,5,9
SLN200507150,2005,50715,SLN,HOU,STL09,3,4,7
SLN200507160,2005,50716,SLN,HOU,STL09,2,4,6
SLN200507170,2005,50717,SLN,HOU,STL09,0,3,3
SLN200507180,2005,50718,SLN,MIL,STL09,4,11,15
SLN200507190,2005,50719,SLN,MIL,STL09,5,4,9
SLN200507200,2005,50720,SLN,MIL,STL09,2,4,6
SLN200507210,2005,50721,SLN,MIL,STL09,12,7,19
SLN200507220,2005,50722,SLN,CHN,STL09,1,2,3
SLN200507230,2005,50723,SLN,CHN,STL09,6,5,11
SLN200507240,2005,50724,SLN,CHN,STL09,8,4,12
SLN200508010,2005,50801,SLN,FLO,STL09,6,5,11
SLN200508020,2005,50802,SLN,FLO,STL09,1,3,4
SLN200508030,2005,50803,SLN,FLO,STL09,6,9,15
SLN200508040,2005,50804,SLN,FLO,STL09,4,3,7
SLN200508050,2005,50805,SLN,ATL,STL09,3,11,14
SLN200508060,2005,50806,SLN,ATL,STL09,8,1,9
SLN200508070,2005,50807,SLN,ATL,STL09,3,5,8
SLN200508160,2005,50816,SLN,ARI,STL09,2,8,10
SLN200508170,2005,50817,SLN,ARI,STL09,0,5,5
SLN200508180,2005,50818,SLN,ARI,STL09,9,2,11
SLN200508190,2005,50819,SLN,SFN,STL09,4,5,9
SLN200508200,2005,50820,SLN,SFN,STL09,2,4,6
SLN200508210,2005,50821,SLN,SFN,STL09,4,2,6
SLN200509050,2005,50905,SLN,CHN,STL09,4,6,10
SLN200509060,2005,50906,SLN,CHN,STL09,5,2,7
SLN200509070,2005,50907,SLN,CHN,STL09,2,1,3
SLN200509080,2005,50908,SLN,NYN,STL09,0,5,5
SLN200509090,2005,50909,SLN,NYN,STL09,2,3,5
SLN200509100,2005,50910,SLN,NYN,STL09,2,4,6
SLN200509110,2005,50911,SLN,NYN,STL09,7,2,9
SLN200509120,2005,50912,SLN,PIT,STL09,3,4,7
SLN200509130,2005,50913,SLN,PIT,STL09,4,5,9
SLN200509140,2005,50914,SLN,PIT,STL09,5,3,8
SLN200509270,2005,50927,SLN,HOU,STL09,3,1,4
SLN200509280,2005,50928,SLN,HOU,STL09,7,6,13
SLN200509300,2005,50930,SLN,CIN,STL09,6,12,18
SLN200510010,2005,51001,SLN,CIN,STL09,6,9,15
SLN200510020,2005,51002,SLN,CIN,STL09,5,7,12
SLN200510040,2005,51004,SLN,SDN,STL09,5,8,13
SLN200510060,2005,51006,SLN,SDN,STL09,2,6,8
SLN200510120,2005,51012,SLN,HOU,STL09,3,5,8
SLN200510130,2005,51013,SLN,HOU,STL09,4,1,5
SLN200510190,2005,51019,SLN,HOU,STL09,5,1,6
SLN200604100,2006,60410,SLN,MIL,STL10,4,6,10
SLN200604120,2006,60412,SLN,MIL,STL10,3,8,11
SLN200604130,2006,60413,SLN,MIL,STL10,4,3,7
SLN200604140,2006,60414,SLN,CIN,STL10,1,0,1
SLN200604150,2006,60415,SLN,CIN,STL10,3,9,12
SLN200604160,2006,60416,SLN,CIN,STL10,7,8,15
SLN200604210,2006,60421,SLN,CHN,STL10,3,9,12
SLN200604220,2006,60422,SLN,CHN,STL10,1,4,5
SLN200604230,2006,60423,SLN,CHN,STL10,7,3,10
SLN200604240,2006,60424,SLN,PIT,STL10,2,7,9
SLN200604250,2006,60425,SLN,PIT,STL10,3,6,9
SLN200604260,2006,60426,SLN,PIT,STL10,3,4,7
SLN200604270,2006,60427,SLN,WAS,STL10,2,6,8
SLN200604280,2006,60428,SLN,WAS,STL10,8,3,11
SLN200604290,2006,60429,SLN,WAS,STL10,1,2,3
SLN200604300,2006,60430,SLN,WAS,STL10,2,9,11
SLN200605080,2006,60508,SLN,COL,STL10,6,2,8
SLN200605090,2006,60509,SLN,COL,STL10,2,4,6
SLN200605100,2006,60510,SLN,COL,STL10,4,7,11
SLN200605120,2006,60512,SLN,ARI,STL10,3,5,8
SLN200605130,2006,60513,SLN,ARI,STL10,1,9,10
SLN200605140,2006,60514,SLN,ARI,STL10,7,6,13
SLN200605160,2006,60516,SLN,NYN,STL10,8,3,11
SLN200605170,2006,60517,SLN,NYN,STL10,0,1,1
SLN200605180,2006,60518,SLN,NYN,STL10,3,6,9
SLN200605290,2006,60529,SLN,HOU,STL10,1,3,4
SLN200605300,2006,60530,SLN,HOU,STL10,6,3,9
SLN200605310,2006,60531,SLN,HOU,STL10,3,4,7
SLN200606020,2006,60602,SLN,CHN,STL10,5,4,9
SLN200606030,2006,60603,SLN,CHN,STL10,8,5,13
SLN200606040,2006,60604,SLN,CHN,STL10,6,9,15
SLN200606050,2006,60605,SLN,CIN,STL10,8,7,15
SLN200606060,2006,60606,SLN,CIN,STL10,7,0,7
SLN200606070,2006,60607,SLN,CIN,STL10,7,4,11
SLN200606160,2006,60616,SLN,COL,STL10,1,8,9
SLN200606170,2006,60617,SLN,COL,STL10,5,6,11
SLN200606180,2006,60618,SLN,COL,STL10,1,4,5
SLN200606260,2006,60626,SLN,CLE,STL10,10,3,13
SLN200606270,2006,60627,SLN,CLE,STL10,3,1,4
SLN200606280,2006,60628,SLN,CLE,STL10,4,5,9
SLN200606300,2006,60630,SLN,KCA,STL10,7,5,12
SLN200607010,2006,60701,SLN,KCA,STL10,8,7,15
SLN200607020,2006,60702,SLN,KCA,STL10,7,9,16
SLN200607130,2006,60713,SLN,LAN,STL10,2,3,5
SLN200607140,2006,60714,SLN,LAN,STL10,0,5,5
SLN200607150,2006,60715,SLN,LAN,STL10,1,2,3
SLN200607160,2006,60716,SLN,LAN,STL10,3,11,14
SLN200607170,2006,60717,SLN,ATL,STL10,15,3,18
SLN200607180,2006,60718,SLN,ATL,STL10,14,5,19
SLN200607190,2006,60719,SLN,ATL,STL10,3,8,11
SLN200608010,2006,60801,SLN,PHI,STL10,5,3,8
SLN200608020,2006,60802,SLN,PHI,STL10,16,8,24
SLN200608030,2006,60803,SLN,PHI,STL10,8,1,9
SLN200608040,2006,60804,SLN,MIL,STL10,4,3,7
SLN200608050,2006,60805,SLN,MIL,STL10,3,4,7
SLN200608060,2006,60806,SLN,MIL,STL10,1,7,8
SLN200608150,2006,60815,SLN,CIN,STL10,0,5,5
SLN200608160,2006,60816,SLN,CIN,STL10,7,2,9
SLN200608170,2006,60817,SLN,CIN,STL10,1,2,3
SLN200608250,2006,60825,SLN,CHN,STL10,0,2,2
SLN200608260,2006,60826,SLN,CHN,STL10,1,2,3
SLN200608270,2006,60827,SLN,CHN,STL10,6,10,16
SLN200608290,2006,60829,SLN,FLO,STL10,9,1,10
SLN200608300,2006,60830,SLN,FLO,STL10,6,13,19
SLN200608310,2006,60831,SLN,FLO,STL10,2,5,7
SLN200609010,2006,60901,SLN,PIT,STL10,1,3,4
SLN200609020,2006,60902,SLN,PIT,STL10,1,0,1
SLN200609030,2006,60903,SLN,PIT,STL10,3,6,9
SLN200609110,2006,60911,SLN,HOU,STL10,0,7,7
SLN200609120,2006,60912,SLN,HOU,STL10,5,6,11
SLN200609130,2006,60913,SLN,HOU,STL10,5,1,6
SLN200609150,2006,60915,SLN,SFN,STL10,4,14,18
SLN200609160,2006,60916,SLN,SFN,STL10,1,6,7
SLN200609250,2006,60925,SLN,SDN,STL10,6,5,11
SLN200609260,2006,60926,SLN,SDN,STL10,7,5,12
SLN200609270,2006,60927,SLN,SDN,STL10,2,4,6
SLN200609280,2006,60928,SLN,MIL,STL10,9,4,13
SLN200609290,2006,60929,SLN,MIL,STL10,5,10,15
SLN200609300,2006,60930,SLN,MIL,STL10,2,3,5
SLN200610010,2006,61001,SLN,MIL,STL10,5,3,8
SLN200610070,2006,61007,SLN,SDN,STL10,3,1,4
SLN200610080,2006,61008,SLN,SDN,STL10,2,6,8
SLN200610140,2006,61014,SLN,NYN,STL10,0,5,5
SLN200610150,2006,61015,SLN,NYN,STL10,12,5,17
SLN200610170,2006,61017,SLN,NYN,STL10,2,4,6
SLN200610240,2006,61024,SLN,DET,STL10,0,5,5
SLN200610260,2006,61026,SLN,DET,STL10,4,5,9
SLN200610270,2006,61027,SLN,DET,STL10,2,4,6
SLN200704010,2007,70401,SLN,NYN,STL10,6,1,7
SLN200704030,2007,70403,SLN,NYN,STL10,4,1,5
SLN200704040,2007,70404,SLN,NYN,STL10,10,0,10
SLN200704140,2007,70414,SLN,MIL,STL10,3,2,5
SLN200704150,2007,70415,SLN,MIL,STL10,2,10,12
SLN200704160,2007,70416,SLN,PIT,STL10,3,2,5
SLN200704170,2007,70417,SLN,PIT,STL10,6,1,7
SLN200704240,2007,70424,SLN,CIN,STL10,10,3,13
SLN200704250,2007,70425,SLN,CIN,STL10,2,5,7
SLN200704260,2007,70426,SLN,CIN,STL10,5,7,12
SLN200704270,2007,70427,SLN,CHN,STL10,5,3,8
SLN200704280,2007,70428,SLN,CHN,STL10,8,1,9
SLN200705040,2007,70504,SLN,HOU,STL10,2,3,5
SLN200705050,2007,70505,SLN,HOU,STL10,13,0,13
SLN200705060,2007,70506,SLN,HOU,STL10,1,3,4
SLN200705070,2007,70507,SLN,COL,STL10,3,2,5
SLN200705080,2007,70508,SLN,COL,STL10,1,4,5
SLN200705090,2007,70509,SLN,COL,STL10,2,9,11
SLN200705220,2007,70522,SLN,PIT,STL10,4,9,13
SLN200705230,2007,70523,SLN,PIT,STL10,3,5,8
SLN200705240,2007,70524,SLN,PIT,STL10,1,3,4
SLN200705250,2007,70525,SLN,WAS,STL10,5,4,9
SLN200705260,2007,70526,SLN,WAS,STL10,6,8,14
SLN200705270,2007,70527,SLN,WAS,STL10,7,2,9
SLN200706050,2007,70605,SLN,CIN,STL10,3,4,7
SLN200706060,2007,70606,SLN,CIN,STL10,4,6,10
SLN200706070,2007,70607,SLN,CIN,STL10,5,1,6
SLN200706080,2007,70608,SLN,ANA,STL10,10,6,16
SLN200706090,2007,70609,SLN,ANA,STL10,9,3,12
SLN200706100,2007,70610,SLN,ANA,STL10,6,9,15
SLN200706180,2007,70618,SLN,KCA,STL10,5,3,8
SLN200706190,2007,70619,SLN,KCA,STL10,1,5,6
SLN200706200,2007,70620,SLN,KCA,STL10,6,7,13
SLN200706220,2007,70622,SLN,PHI,STL10,6,0,6
SLN200706230,2007,70623,SLN,PHI,STL10,3,8,11
SLN200706240,2007,70624,SLN,PHI,STL10,5,1,6
SLN200707020,2007,70702,SLN,ARI,STL10,3,11,14
SLN200707030,2007,70703,SLN,ARI,STL10,7,1,8
SLN200707040,2007,70704,SLN,ARI,STL10,4,5,9
SLN200707050,2007,70705,SLN,ARI,STL10,2,3,5
SLN200707060,2007,70706,SLN,SFN,STL10,4,3,7
SLN200707070,2007,70707,SLN,SFN,STL10,7,6,13
SLN200707080,2007,70708,SLN,SFN,STL10,0,7,7
SLN200707240,2007,70724,SLN,CHN,STL10,4,3,7
SLN200707250,2007,70725,SLN,CHN,STL10,7,1,8
SLN200707260,2007,70726,SLN,CHN,STL10,1,11,12
SLN200707270,2007,70727,SLN,MIL,STL10,12,2,14
SLN200707281,2007,70728,SLN,MIL,STL10,6,7,13
SLN200707282,2007,70728,SLN,MIL,STL10,2,5,7
SLN200707290,2007,70729,SLN,MIL,STL10,5,9,14
SLN200708060,2007,70806,SLN,SDN,STL10,5,10,15
SLN200708070,2007,70807,SLN,SDN,STL10,4,0,4
SLN200708080,2007,70808,SLN,SDN,STL10,1,2,3
SLN200708090,2007,70809,SLN,SDN,STL10,0,5,5
SLN200708100,2007,70810,SLN,LAN,STL10,2,1,3
SLN200708110,2007,70811,SLN,LAN,STL10,1,6,7
SLN200708120,2007,70812,SLN,LAN,STL10,2,12,14
SLN200708210,2007,70821,SLN,FLO,STL10,2,5,7
SLN200708220,2007,70822,SLN,FLO,STL10,4,6,10
SLN200708230,2007,70823,SLN,FLO,STL10,11,3,14
SLN200708240,2007,70824,SLN,ATL,STL10,7,2,9
SLN200708250,2007,70825,SLN,ATL,STL10,4,5,9
SLN200708260,2007,70826,SLN,ATL,STL10,1,4,5
SLN200708310,2007,70831,SLN,CIN,STL10,5,8,13
SLN200709010,2007,70901,SLN,CIN,STL10,3,11,14
SLN200709020,2007,70902,SLN,CIN,STL10,2,3,5
SLN200709030,2007,70903,SLN,PIT,STL10,11,0,11
SLN200709040,2007,70904,SLN,PIT,STL10,2,6,8
SLN200709050,2007,70905,SLN,PIT,STL10,8,2,10
SLN200709060,2007,70906,SLN,PIT,STL10,4,16,20
SLN200709140,2007,70914,SLN,CHN,STL10,5,3,8
SLN200709151,2007,70915,SLN,CHN,STL10,3,2,5
SLN200709152,2007,70915,SLN,CHN,STL10,3,4,7
SLN200709160,2007,70916,SLN,CHN,STL10,4,2,6
SLN200709170,2007,70917,SLN,PHI,STL10,13,11,24
SLN200709180,2007,70918,SLN,PHI,STL10,7,4,11
SLN200709190,2007,70919,SLN,PHI,STL10,1,2,3
SLN200709200,2007,70920,SLN,HOU,STL10,18,1,19
SLN200709210,2007,70921,SLN,HOU,STL10,6,3,9
SLN200709220,2007,70922,SLN,HOU,STL10,4,7,11
SLN200709230,2007,70923,SLN,HOU,STL10,3,4,7
SLN200804010,2008,80401,SLN,COL,STL10,2,1,3
SLN200804020,2008,80402,SLN,COL,STL10,3,8,11
SLN200804030,2008,80403,SLN,COL,STL10,0,3,3
SLN200804040,2008,80404,SLN,WAS,STL10,4,5,9
SLN200804050,2008,80405,SLN,WAS,STL10,4,5,9
SLN200804060,2008,80406,SLN,WAS,STL10,0,3,3
SLN200804150,2008,80415,SLN,MIL,STL10,1,6,7
SLN200804160,2008,80416,SLN,MIL,STL10,4,5,9
SLN200804170,2008,80417,SLN,MIL,STL10,5,3,8
SLN200804180,2008,80418,SLN,SFN,STL10,1,11,12
SLN200804190,2008,80419,SLN,SFN,STL10,3,0,3
SLN200804200,2008,80420,SLN,SFN,STL10,8,2,10
SLN200804250,2008,80425,SLN,HOU,STL10,3,2,5
SLN200804260,2008,80426,SLN,HOU,STL10,3,4,7
SLN200804270,2008,80427,SLN,HOU,STL10,1,5,6
SLN200804280,2008,80428,SLN,CIN,STL10,4,3,7
SLN200804290,2008,80429,SLN,CIN,STL10,2,7,9
SLN200804300,2008,80430,SLN,CIN,STL10,2,5,7
SLN200805020,2008,80502,SLN,CHN,STL10,3,5,8
SLN200805030,2008,80503,SLN,CHN,STL10,9,3,12
SLN200805040,2008,80504,SLN,CHN,STL10,3,5,8
SLN200805130,2008,80513,SLN,PIT,STL10,8,4,12
SLN200805140,2008,80514,SLN,PIT,STL10,1,5,6
SLN200805150,2008,80515,SLN,PIT,STL10,11,5,16
SLN200805160,2008,80516,SLN,TBA,STL10,3,1,4
SLN200805170,2008,80517,SLN,TBA,STL10,8,9,17
SLN200805180,2008,80518,SLN,TBA,STL10,4,5,9
SLN200805270,2008,80527,SLN,HOU,STL10,8,2,10
SLN200805280,2008,80528,SLN,HOU,STL10,1,6,7
SLN200805290,2008,80529,SLN,HOU,STL10,2,3,5
SLN200805300,2008,80530,SLN,PIT,STL10,4,5,9
SLN200805310,2008,80531,SLN,PIT,STL10,14,4,18
SLN200806010,2008,80601,SLN,PIT,STL10,4,7,11
SLN200806020,2008,80602,SLN,PIT,STL10,5,4,9
SLN200806130,2008,80613,SLN,PHI,STL10,20,2,22
SLN200806140,2008,80614,SLN,PHI,STL10,2,3,5
SLN200806150,2008,80615,SLN,PHI,STL10,6,7,13
SLN200806170,2008,80617,SLN,KCA,STL10,2,1,3
SLN200806180,2008,80618,SLN,KCA,STL10,3,2,5
SLN200806190,2008,80619,SLN,KCA,STL10,4,1,5
SLN200806300,2008,80630,SLN,NYN,STL10,1,7,8
SLN200807010,2008,80701,SLN,NYN,STL10,7,4,11
SLN200807020,2008,80702,SLN,NYN,STL10,7,8,15
SLN200807030,2008,80703,SLN,NYN,STL10,11,1,12
SLN200807040,2008,80704,SLN,CHN,STL10,2,1,3
SLN200807050,2008,80705,SLN,CHN,STL10,4,5,9
SLN200807060,2008,80706,SLN,CHN,STL10,7,1,8
SLN200807170,2008,80717,SLN,SDN,STL10,3,4,7
SLN200807180,2008,80718,SLN,SDN,STL10,7,11,18
SLN200807190,2008,80719,SLN,SDN,STL10,5,6,11
SLN200807200,2008,80720,SLN,SDN,STL10,5,9,14
SLN200807210,2008,80721,SLN,MIL,STL10,6,3,9
SLN200807220,2008,80722,SLN,MIL,STL10,4,3,7
SLN200807230,2008,80723,SLN,MIL,STL10,3,0,3
SLN200807240,2008,80724,SLN,MIL,STL10,4,3,7
SLN200808010,2008,80801,SLN,PHI,STL10,3,6,9
SLN200808020,2008,80802,SLN,PHI,STL10,2,1,3
SLN200808030,2008,80803,SLN,PHI,STL10,5,4,9
SLN200808050,2008,80805,SLN,LAN,STL10,4,6,10
SLN200808060,2008,80806,SLN,LAN,STL10,6,9,15
SLN200808070,2008,80807,SLN,LAN,STL10,4,1,5
SLN200808190,2008,80819,SLN,PIT,STL10,4,1,5
SLN200808200,2008,80820,SLN,PIT,STL10,2,11,13
SLN200808220,2008,80822,SLN,ATL,STL10,3,18,21
SLN200808230,2008,80823,SLN,ATL,STL10,8,4,12
SLN200808240,2008,80824,SLN,ATL,STL10,3,6,9
SLN200808260,2008,80826,SLN,MIL,STL10,12,0,12
SLN200808270,2008,80827,SLN,MIL,STL10,3,5,8
SLN200809050,2008,80905,SLN,FLO,STL10,4,1,5
SLN200809060,2008,80906,SLN,FLO,STL10,3,5,8
SLN200809070,2008,80907,SLN,FLO,STL10,1,3,4
SLN200809090,2008,80909,SLN,CHN,STL10,3,4,7
SLN200809100,2008,80910,SLN,CHN,STL10,4,3,7
SLN200809110,2008,80911,SLN,CHN,STL10,3,2,5
SLN200809220,2008,80922,SLN,ARI,STL10,4,2,6
SLN200809230,2008,80923,SLN,ARI,STL10,4,7,11
SLN200809240,2008,80924,SLN,ARI,STL10,2,4,6
SLN200809250,2008,80925,SLN,ARI,STL10,3,12,15
SLN200809260,2008,80926,SLN,CIN,STL10,6,7,13
SLN200809270,2008,80927,SLN,CIN,STL10,5,8,13
SLN200809280,2008,80928,SLN,CIN,STL10,4,11,15
SLN200904060,2009,90406,SLN,PIT,STL10,6,4,10
SLN200904070,2009,90407,SLN,PIT,STL10,3,9,12
SLN200904080,2009,90408,SLN,PIT,STL10,7,4,11
SLN200904090,2009,90409,SLN,PIT,STL10,1,2,3
SLN200904100,2009,90410,SLN,HOU,STL10,3,5,8
SLN200904110,2009,90411,SLN,HOU,STL10,2,11,13
SLN200904120,2009,90412,SLN,HOU,STL10,0,3,3
SLN200904210,2009,90421,SLN,NYN,STL10,4,6,10
SLN200904220,2009,90422,SLN,NYN,STL10,2,5,7
SLN200904230,2009,90423,SLN,NYN,STL10,8,12,20
SLN200904240,2009,90424,SLN,CHN,STL10,3,4,7
SLN200904250,2009,90425,SLN,CHN,STL10,2,8,10
SLN200904260,2009,90426,SLN,CHN,STL10,10,3,13
SLN200905040,2009,90504,SLN,PHI,STL10,6,1,7
SLN200905050,2009,90505,SLN,PHI,STL10,10,7,17
SLN200905060,2009,90506,SLN,PIT,STL10,2,4,6
SLN200905070,2009,90507,SLN,PIT,STL10,2,5,7
SLN200905160,2009,90516,SLN,MIL,STL10,1,0,1
SLN200905170,2009,90517,SLN,MIL,STL10,8,2,10
SLN200905180,2009,90518,SLN,MIL,STL10,8,4,12
SLN200905190,2009,90519,SLN,CHN,STL10,0,3,3
SLN200905200,2009,90520,SLN,CHN,STL10,1,2,3
SLN200905210,2009,90521,SLN,CHN,STL10,1,3,4
SLN200905220,2009,90522,SLN,KCA,STL10,0,5,5
SLN200905230,2009,90523,SLN,KCA,STL10,0,5,5
SLN200905240,2009,90524,SLN,KCA,STL10,3,2,5
SLN200906010,2009,90601,SLN,CIN,STL10,5,3,8
SLN200906020,2009,90602,SLN,CIN,STL10,2,5,7
SLN200906030,2009,90603,SLN,CIN,STL10,9,3,12
SLN200906040,2009,90604,SLN,CIN,STL10,1,3,4
SLN200906050,2009,90605,SLN,COL,STL10,11,4,15
SLN200906060,2009,90606,SLN,COL,STL10,10,1,11
SLN200906070,2009,90607,SLN,COL,STL10,7,2,9
SLN200906080,2009,90608,SLN,COL,STL10,5,2,7
SLN200906160,2009,90616,SLN,DET,STL10,2,11,13
SLN200906170,2009,90617,SLN,DET,STL10,3,4,7
SLN200906180,2009,90618,SLN,DET,STL10,6,3,9
SLN200906260,2009,90626,SLN,MIN,STL10,3,1,4
SLN200906270,2009,90627,SLN,MIN,STL10,3,5,8
SLN200906280,2009,90628,SLN,MIN,STL10,6,2,8
SLN200906290,2009,90629,SLN,SFN,STL10,10,0,10
SLN200906300,2009,90630,SLN,SFN,STL10,6,3,9
SLN200907010,2009,90701,SLN,SFN,STL10,1,2,3
SLN200907020,2009,90702,SLN,SFN,STL10,2,5,7
SLN200907170,2009,90717,SLN,ARI,STL10,1,6,7
SLN200907180,2009,90718,SLN,ARI,STL10,4,2,6
SLN200907190,2009,90719,SLN,ARI,STL10,1,2,3
SLN200907270,2009,90727,SLN,LAN,STL10,1,6,7
SLN200907280,2009,90728,SLN,LAN,STL10,0,10,10
SLN200907290,2009,90729,SLN,LAN,STL10,2,3,5
SLN200907300,2009,90730,SLN,LAN,STL10,5,3,8
SLN200907310,2009,90731,SLN,HOU,STL10,3,4,7
SLN200908010,2009,90801,SLN,HOU,STL10,1,3,4
SLN200908020,2009,90802,SLN,HOU,STL10,2,0,2
SLN200908100,2009,90810,SLN,CIN,STL10,1,4,5
SLN200908110,2009,90811,SLN,CIN,STL10,5,4,9
SLN200908120,2009,90812,SLN,CIN,STL10,2,5,7
SLN200908140,2009,90814,SLN,SDN,STL10,2,9,11
SLN200908150,2009,90815,SLN,SDN,STL10,4,7,11
SLN200908160,2009,90816,SLN,SDN,STL10,5,7,12
SLN200908250,2009,90825,SLN,HOU,STL10,0,1,1
SLN200908260,2009,90826,SLN,HOU,STL10,2,3,5
SLN200908270,2009,90827,SLN,HOU,STL10,4,3,7
SLN200908280,2009,90828,SLN,WAS,STL10,2,3,5
SLN200908290,2009,90829,SLN,WAS,STL10,4,9,13
SLN200908300,2009,90830,SLN,WAS,STL10,1,2,3
SLN200909010,2009,90901,SLN,MIL,STL10,6,7,13
SLN200909020,2009,90902,SLN,MIL,STL10,3,10,13
SLN200909030,2009,90903,SLN,MIL,STL10,4,3,7
SLN200909110,2009,90911,SLN,ATL,STL10,1,0,1
SLN200909120,2009,90912,SLN,ATL,STL10,7,6,13
SLN200909130,2009,90913,SLN,ATL,STL10,9,2,11
SLN200909140,2009,90914,SLN,FLO,STL10,6,11,17
SLN200909150,2009,90915,SLN,FLO,STL10,2,1,3
SLN200909160,2009,90916,SLN,FLO,STL10,5,2,7
SLN200909180,2009,90918,SLN,CHN,STL10,2,3,5
SLN200909190,2009,90919,SLN,CHN,STL10,1,2,3
SLN200909200,2009,90920,SLN,CHN,STL10,6,3,9
SLN200910020,2009,91002,SLN,MIL,STL10,12,6,18
SLN200910030,2009,91003,SLN,MIL,STL10,5,4,9
SLN200910040,2009,91004,SLN,MIL,STL10,9,7,16
SLN200910100,2009,91010,SLN,LAN,STL10,5,1,6
TBA200004070,2000,407,TBA,CLE,STP01,14,5,19
TBA200004080,2000,408,TBA,CLE,STP01,6,4,10
TBA200004090,2000,409,TBA,CLE,STP01,17,4,21
TBA200004110,2000,411,TBA,CHA,STP01,13,6,19
TBA200004120,2000,412,TBA,CHA,STP01,7,1,8
TBA200004130,2000,413,TBA,CHA,STP01,5,6,11
TBA200004210,2000,421,TBA,ANA,STP01,9,6,15
TBA200004220,2000,422,TBA,ANA,STP01,9,11,20
TBA200004230,2000,423,TBA,ANA,STP01,0,1,1
TBA200005020,2000,502,TBA,TEX,STP01,8,1,9
TBA200005030,2000,503,TBA,TEX,STP01,5,1,6
TBA200005040,2000,504,TBA,TEX,STP01,7,8,15
TBA200005120,2000,512,TBA,TOR,STP01,3,4,7
TBA200005130,2000,513,TBA,TOR,STP01,8,4,12
TBA200005140,2000,514,TBA,TOR,STP01,3,2,5
TBA200005230,2000,523,TBA,OAK,STP01,4,6,10
TBA200005240,2000,524,TBA,OAK,STP01,9,2,11
TBA200005250,2000,525,TBA,OAK,STP01,6,3,9
TBA200005260,2000,526,TBA,SEA,STP01,11,4,15
TBA200005270,2000,527,TBA,SEA,STP01,6,3,9
TBA200005280,2000,528,TBA,SEA,STP01,4,14,18
TBA200005290,2000,529,TBA,BAL,STP01,5,1,6
TBA200005300,2000,530,TBA,BAL,STP01,8,7,15
TBA200005310,2000,531,TBA,BAL,STP01,3,4,7
TBA200006010,2000,601,TBA,BAL,STP01,1,2,3
TBA200006090,2000,609,TBA,FLO,STP01,4,6,10
TBA200006100,2000,610,TBA,FLO,STP01,5,1,6
TBA200006110,2000,611,TBA,FLO,STP01,6,7,13
TBA200006130,2000,613,TBA,ANA,STP01,5,3,8
TBA200006140,2000,614,TBA,ANA,STP01,2,3,5
TBA200006150,2000,615,TBA,ANA,STP01,1,2,3
TBA200006160,2000,616,TBA,TEX,STP01,2,9,11
TBA200006170,2000,617,TBA,TEX,STP01,5,0,5
TBA200006180,2000,618,TBA,TEX,STP01,1,6,7
TBA200006270,2000,627,TBA,TOR,STP01,1,11,12
TBA200006280,2000,628,TBA,TOR,STP01,5,2,7
TBA200006290,2000,629,TBA,TOR,STP01,12,3,15
TBA200006300,2000,630,TBA,NYA,STP01,4,6,10
TBA200007010,2000,701,TBA,NYA,STP01,6,1,7
TBA200007020,2000,702,TBA,NYA,STP01,5,2,7
TBA200007030,2000,703,TBA,DET,STP01,5,4,9
TBA200007040,2000,704,TBA,DET,STP01,11,0,11
TBA200007050,2000,705,TBA,DET,STP01,1,4,5
TBA200007130,2000,713,TBA,MON,STP01,4,6,10
TBA200007140,2000,714,TBA,MON,STP01,5,8,13
TBA200007150,2000,715,TBA,MON,STP01,4,1,5
TBA200007160,2000,716,TBA,ATL,STP01,6,4,10
TBA200007170,2000,717,TBA,ATL,STP01,6,8,14
TBA200007180,2000,718,TBA,ATL,STP01,8,2,10
TBA200008010,2000,801,TBA,CLE,STP01,5,6,11
TBA200008020,2000,802,TBA,CLE,STP01,5,3,8
TBA200008030,2000,803,TBA,CLE,STP01,5,1,6
TBA200008040,2000,804,TBA,BAL,STP01,10,9,19
TBA200008050,2000,805,TBA,BAL,STP01,4,5,9
TBA200008060,2000,806,TBA,BAL,STP01,4,7,11
TBA200008070,2000,807,TBA,MIN,STP01,4,2,6
TBA200008080,2000,808,TBA,MIN,STP01,0,5,5
TBA200008090,2000,809,TBA,MIN,STP01,4,5,9
TBA200008100,2000,810,TBA,MIN,STP01,4,10,14
TBA200008110,2000,811,TBA,CHA,STP01,6,5,11
TBA200008120,2000,812,TBA,CHA,STP01,5,4,9
TBA200008130,2000,813,TBA,CHA,STP01,3,5,8
TBA200008280,2000,828,TBA,BOS,STP01,2,5,7
TBA200008290,2000,829,TBA,BOS,STP01,8,0,8
TBA200008300,2000,830,TBA,BOS,STP01,1,3,4
TBA200008310,2000,831,TBA,KCA,STP01,1,2,3
TBA200009010,2000,901,TBA,KCA,STP01,9,5,14
TBA200009020,2000,902,TBA,KCA,STP01,7,5,12
TBA200009030,2000,903,TBA,KCA,STP01,8,2,10
TBA200009150,2000,915,TBA,OAK,STP01,17,3,20
TBA200009160,2000,916,TBA,OAK,STP01,5,2,7
TBA200009180,2000,918,TBA,SEA,STP01,4,3,7
TBA200009190,2000,919,TBA,SEA,STP01,5,2,7
TBA200009200,2000,920,TBA,SEA,STP01,5,4,9
TBA200009260,2000,926,TBA,NYA,STP01,1,2,3
TBA200009270,2000,927,TBA,NYA,STP01,1,11,12
TBA200009280,2000,928,TBA,NYA,STP01,3,11,14
TBA200009290,2000,929,TBA,BOS,STP01,6,8,14
TBA200009300,2000,930,TBA,BOS,STP01,4,2,6
TBA200010010,2000,1001,TBA,BOS,STP01,2,3,5
TBA200104030,2001,10403,TBA,TOR,STP01,1,8,9
TBA200104040,2001,10404,TBA,TOR,STP01,11,8,19
TBA200104050,2001,10405,TBA,TOR,STP01,11,0,11
TBA200104170,2001,10417,TBA,BOS,STP01,10,0,10
TBA200104180,2001,10418,TBA,BOS,STP01,9,1,10
TBA200104190,2001,10419,TBA,BOS,STP01,8,3,11
TBA200104200,2001,10420,TBA,BAL,STP01,6,3,9
TBA200104210,2001,10421,TBA,BAL,STP01,5,6,11
TBA200104220,2001,10422,TBA,BAL,STP01,10,8,18
TBA200104240,2001,10424,TBA,KCA,STP01,2,4,6
TBA200104250,2001,10425,TBA,KCA,STP01,3,5,8
TBA200104260,2001,10426,TBA,KCA,STP01,6,0,6
TBA200105040,2001,10504,TBA,CLE,STP01,8,6,14
TBA200105050,2001,10505,TBA,CLE,STP01,9,4,13
TBA200105060,2001,10506,TBA,CLE,STP01,10,3,13
TBA200105080,2001,10508,TBA,BAL,STP01,3,4,7
TBA200105090,2001,10509,TBA,BAL,STP01,8,6,14
TBA200105100,2001,10510,TBA,BAL,STP01,9,5,14
TBA200105180,2001,10518,TBA,DET,STP01,18,2,20
TBA200105190,2001,10519,TBA,DET,STP01,10,5,15
TBA200105200,2001,10520,TBA,DET,STP01,2,10,12
TBA200105220,2001,10522,TBA,TEX,STP01,5,2,7
TBA200105230,2001,10523,TBA,TEX,STP01,6,10,16
TBA200105240,2001,10524,TBA,TEX,STP01,9,3,12
TBA200105250,2001,10525,TBA,ANA,STP01,6,4,10
TBA200105260,2001,10526,TBA,ANA,STP01,10,4,14
TBA200105270,2001,10527,TBA,ANA,STP01,3,4,7
TBA200105280,2001,10528,TBA,ANA,STP01,3,1,4
TBA200106080,2001,10608,TBA,NYN,STP01,5,7,12
TBA200106090,2001,10609,TBA,NYN,STP01,2,5,7
TBA200106100,2001,10610,TBA,NYN,STP01,10,0,10
TBA200106120,2001,10612,TBA,PHI,STP01,5,9,14
TBA200106130,2001,10613,TBA,PHI,STP01,3,5,8
TBA200106140,2001,10614,TBA,PHI,STP01,3,6,9
TBA200106190,2001,10619,TBA,BOS,STP01,5,4,9
TBA200106200,2001,10620,TBA,BOS,STP01,8,2,10
TBA200106210,2001,10621,TBA,BOS,STP01,7,4,11
TBA200106220,2001,10622,TBA,NYA,STP01,6,3,9
TBA200106230,2001,10623,TBA,NYA,STP01,2,1,3
TBA200106240,2001,10624,TBA,NYA,STP01,4,5,9
TBA200107030,2001,10703,TBA,TOR,STP01,2,7,9
TBA200107040,2001,10704,TBA,TOR,STP01,8,1,9
TBA200107050,2001,10705,TBA,TOR,STP01,7,4,11
TBA200107060,2001,10706,TBA,FLO,STP01,4,5,9
TBA200107070,2001,10707,TBA,FLO,STP01,3,4,7
TBA200107080,2001,10708,TBA,FLO,STP01,6,1,7
TBA200107180,2001,10718,TBA,ANA,STP01,2,1,3
TBA200107190,2001,10719,TBA,ANA,STP01,2,1,3
TBA200107200,2001,10720,TBA,TEX,STP01,4,1,5
TBA200107210,2001,10721,TBA,TEX,STP01,1,2,3
TBA200107220,2001,10722,TBA,TEX,STP01,4,7,11
TBA200108070,2001,10807,TBA,NYA,STP01,2,3,5
TBA200108080,2001,10808,TBA,NYA,STP01,16,1,17
TBA200108090,2001,10809,TBA,NYA,STP01,4,3,7
TBA200108100,2001,10810,TBA,MIN,STP01,2,4,6
TBA200108110,2001,10811,TBA,MIN,STP01,3,4,7
TBA200108120,2001,10812,TBA,MIN,STP01,3,4,7
TBA200108130,2001,10813,TBA,MIN,STP01,1,5,6
TBA200108210,2001,10821,TBA,BAL,STP01,4,8,12
TBA200108220,2001,10822,TBA,BAL,STP01,10,11,21
TBA200108230,2001,10823,TBA,BAL,STP01,7,4,11
TBA200108240,2001,10824,TBA,CHA,STP01,5,4,9
TBA200108250,2001,10825,TBA,CHA,STP01,4,8,12
TBA200108260,2001,10826,TBA,CHA,STP01,3,2,5
TBA200108280,2001,10828,TBA,SEA,STP01,0,6,6
TBA200108290,2001,10829,TBA,SEA,STP01,5,2,7
TBA200108300,2001,10830,TBA,SEA,STP01,4,0,4
TBA200108310,2001,10831,TBA,OAK,STP01,9,5,14
TBA200109010,2001,10901,TBA,OAK,STP01,6,8,14
TBA200109020,2001,10902,TBA,OAK,STP01,3,1,4
TBA200109270,2001,10927,TBA,TOR,STP01,1,5,6
TBA200109280,2001,10928,TBA,TOR,STP01,1,6,7
TBA200109290,2001,10929,TBA,TOR,STP01,2,5,7
TBA200109300,2001,10930,TBA,TOR,STP01,6,5,11
TBA200110010,2001,11001,TBA,BOS,STP01,3,10,13
TBA200110020,2001,11002,TBA,BOS,STP01,3,10,13
TBA200110030,2001,11003,TBA,BOS,STP01,10,3,13
TBA200110040,2001,11004,TBA,NYA,STP01,1,4,5
TBA200110050,2001,11005,TBA,NYA,STP01,4,8,12
TBA200110060,2001,11006,TBA,NYA,STP01,2,5,7
TBA200110070,2001,11007,TBA,NYA,STP01,1,0,1
TBA200204020,2002,20402,TBA,DET,STP01,5,9,14
TBA200204030,2002,20403,TBA,DET,STP01,1,2,3
TBA200204040,2002,20404,TBA,DET,STP01,2,9,11
TBA200204120,2002,20412,TBA,TOR,STP01,14,7,21
TBA200204130,2002,20413,TBA,TOR,STP01,5,4,9
TBA200204140,2002,20414,TBA,TOR,STP01,4,5,9
TBA200204190,2002,20419,TBA,BAL,STP01,6,5,11
TBA200204200,2002,20420,TBA,BAL,STP01,6,3,9
TBA200204210,2002,20421,TBA,BAL,STP01,1,2,3
TBA200204230,2002,20423,TBA,MIN,STP01,4,6,10
TBA200204240,2002,20424,TBA,MIN,STP01,1,9,10
TBA200204250,2002,20425,TBA,MIN,STP01,6,2,8
TBA200205030,2002,20503,TBA,BOS,STP01,3,2,5
TBA200205040,2002,20504,TBA,BOS,STP01,7,5,12
TBA200205050,2002,20505,TBA,BOS,STP01,2,0,2
TBA200205060,2002,20506,TBA,BOS,STP01,5,3,8
TBA200205070,2002,20507,TBA,NYA,STP01,5,2,7
TBA200205080,2002,20508,TBA,NYA,STP01,7,2,9
TBA200205090,2002,20509,TBA,NYA,STP01,3,1,4
TBA200205100,2002,20510,TBA,BAL,STP01,6,5,11
TBA200205110,2002,20511,TBA,BAL,STP01,4,6,10
TBA200205120,2002,20512,TBA,BAL,STP01,3,6,9
TBA200205280,2002,20528,TBA,SEA,STP01,1,5,6
TBA200205290,2002,20529,TBA,SEA,STP01,5,2,7
TBA200205300,2002,20530,TBA,OAK,STP01,3,4,7
TBA200205310,2002,20531,TBA,OAK,STP01,13,9,22
TBA200206010,2002,20601,TBA,OAK,STP01,8,3,11
TBA200206020,2002,20602,TBA,OAK,STP01,4,2,6
TBA200206070,2002,20607,TBA,SDN,STP01,8,4,12
TBA200206080,2002,20608,TBA,SDN,STP01,2,3,5
TBA200206090,2002,20609,TBA,SDN,STP01,9,6,15
TBA200206100,2002,20610,TBA,LAN,STP01,10,5,15
TBA200206110,2002,20611,TBA,LAN,STP01,2,11,13
TBA200206120,2002,20612,TBA,LAN,STP01,4,2,6
TBA200206250,2002,20625,TBA,TOR,STP01,20,11,31
TBA200206260,2002,20626,TBA,TOR,STP01,2,4,6
TBA200206270,2002,20627,TBA,TOR,STP01,4,6,10
TBA200206280,2002,20628,TBA,FLO,STP01,0,4,4
TBA200206290,2002,20629,TBA,FLO,STP01,3,2,5
TBA200206300,2002,20630,TBA,FLO,STP01,5,6,11
TBA200207110,2002,20711,TBA,SEA,STP01,4,0,4
TBA200207120,2002,20712,TBA,SEA,STP01,2,1,3
TBA200207130,2002,20713,TBA,SEA,STP01,3,4,7
TBA200207140,2002,20714,TBA,SEA,STP01,7,6,13
TBA200207150,2002,20715,TBA,OAK,STP01,4,0,4
TBA200207160,2002,20716,TBA,OAK,STP01,2,1,3
TBA200207170,2002,20717,TBA,BOS,STP01,6,1,7
TBA200207180,2002,20718,TBA,BOS,STP01,4,3,7
TBA200207260,2002,20726,TBA,NYA,STP01,12,9,21
TBA200207270,2002,20727,TBA,NYA,STP01,4,7,11
TBA200207280,2002,20728,TBA,NYA,STP01,9,1,10
TBA200207290,2002,20729,TBA,BAL,STP01,1,6,7
TBA200207300,2002,20730,TBA,BAL,STP01,3,10,13
TBA200207310,2002,20731,TBA,BAL,STP01,12,2,14
TBA200208010,2002,20801,TBA,BAL,STP01,4,3,7
TBA200208020,2002,20802,TBA,CHA,STP01,8,5,13
TBA200208030,2002,20803,TBA,CHA,STP01,2,6,8
TBA200208040,2002,20804,TBA,CHA,STP01,3,10,13
TBA200208050,2002,20805,TBA,CHA,STP01,4,3,7
TBA200208130,2002,20813,TBA,CLE,STP01,9,5,14
TBA200208140,2002,20814,TBA,CLE,STP01,6,4,10
TBA200208150,2002,20815,TBA,CLE,STP01,3,4,7
TBA200208160,2002,20816,TBA,KCA,STP01,6,5,11
TBA200208170,2002,20817,TBA,KCA,STP01,7,3,10
TBA200208180,2002,20818,TBA,KCA,STP01,6,8,14
TBA200209030,2002,20903,TBA,ANA,STP01,10,2,12
TBA200209040,2002,20904,TBA,ANA,STP01,4,2,6
TBA200209050,2002,20905,TBA,ANA,STP01,10,1,11
TBA200209060,2002,20906,TBA,TEX,STP01,9,3,12
TBA200209070,2002,20907,TBA,TEX,STP01,11,2,13
TBA200209080,2002,20908,TBA,TEX,STP01,3,6,9
TBA200209090,2002,20909,TBA,BOS,STP01,6,3,9
TBA200209100,2002,20910,TBA,BOS,STP01,12,1,13
TBA200209110,2002,20911,TBA,BOS,STP01,6,3,9
TBA200209120,2002,20912,TBA,BOS,STP01,6,3,9
TBA200209170,2002,20917,TBA,NYA,STP01,7,9,16
TBA200209180,2002,20918,TBA,NYA,STP01,7,1,8
TBA200209190,2002,20919,TBA,NYA,STP01,2,3,5
TBA200209200,2002,20920,TBA,TOR,STP01,7,11,18
TBA200209210,2002,20921,TBA,TOR,STP01,3,4,7
TBA200209220,2002,20922,TBA,TOR,STP01,12,6,18
TBA200303310,2003,30331,TBA,BOS,STP01,4,6,10
TBA200304010,2003,30401,TBA,BOS,STP01,9,8,17
TBA200304020,2003,30402,TBA,BOS,STP01,7,5,12
TBA200304030,2003,30403,TBA,BOS,STP01,14,5,19
TBA200304040,2003,30404,TBA,NYA,STP01,12,2,14
TBA200304050,2003,30405,TBA,NYA,STP01,5,6,11
TBA200304060,2003,30406,TBA,NYA,STP01,10,5,15
TBA200304080,2003,30408,TBA,BAL,STP01,7,8,15
TBA200304090,2003,30409,TBA,BAL,STP01,7,10,17
TBA200304100,2003,30410,TBA,BAL,STP01,4,3,7
TBA200304220,2003,30422,TBA,TOR,STP01,3,4,7
TBA200304230,2003,30423,TBA,TOR,STP01,3,4,7
TBA200304240,2003,30424,TBA,TOR,STP01,5,3,8
TBA200304250,2003,30425,TBA,BAL,STP01,1,2,3
TBA200304260,2003,30426,TBA,BAL,STP01,7,10,17
TBA200304270,2003,30427,TBA,BAL,STP01,7,4,11
TBA200305060,2003,30506,TBA,MIN,STP01,7,3,10
TBA200305070,2003,30507,TBA,MIN,STP01,11,6,17
TBA200305080,2003,30508,TBA,MIN,STP01,5,0,5
TBA200305090,2003,30509,TBA,DET,STP01,0,2,2
TBA200305100,2003,30510,TBA,DET,STP01,1,3,4
TBA200305110,2003,30511,TBA,DET,STP01,9,2,11
TBA200305270,2003,30527,TBA,TEX,STP01,4,2,6
TBA200305280,2003,30528,TBA,TEX,STP01,4,6,10
TBA200305290,2003,30529,TBA,ANA,STP01,2,1,3
TBA200305300,2003,30530,TBA,ANA,STP01,6,8,14
TBA200305310,2003,30531,TBA,ANA,STP01,6,1,7
TBA200306010,2003,30601,TBA,ANA,STP01,9,4,13
TBA200306100,2003,30610,TBA,CIN,STP01,4,2,6
TBA200306110,2003,30611,TBA,CIN,STP01,7,6,13
TBA200306120,2003,30612,TBA,CIN,STP01,2,1,3
TBA200306130,2003,30613,TBA,PIT,STP01,1,7,8
TBA200306140,2003,30614,TBA,PIT,STP01,12,9,21
TBA200306150,2003,30615,TBA,PIT,STP01,9,5,14
TBA200306230,2003,30623,TBA,NYA,STP01,2,4,6
TBA200306240,2003,30624,TBA,NYA,STP01,10,9,19
TBA200306250,2003,30625,TBA,NYA,STP01,8,5,13
TBA200306260,2003,30626,TBA,NYA,STP01,4,3,7
TBA200306270,2003,30627,TBA,ATL,STP01,8,2,10
TBA200306280,2003,30628,TBA,ATL,STP01,7,9,16
TBA200306290,2003,30629,TBA,ATL,STP01,2,0,2
TBA200307010,2003,30701,TBA,BOS,STP01,3,4,7
TBA200307020,2003,30702,TBA,BOS,STP01,5,4,9
TBA200307030,2003,30703,TBA,BOS,STP01,5,6,11
TBA200307040,2003,30704,TBA,CHA,STP01,3,4,7
TBA200307050,2003,30705,TBA,CHA,STP01,2,3,5
TBA200307060,2003,30706,TBA,CHA,STP01,11,3,14
TBA200307170,2003,30717,TBA,TEX,STP01,12,6,18
TBA200307180,2003,30718,TBA,TEX,STP01,0,2,2
TBA200307190,2003,30719,TBA,TEX,STP01,7,3,10
TBA200307200,2003,30720,TBA,TEX,STP01,4,15,19
TBA200307210,2003,30721,TBA,ANA,STP01,2,3,5
TBA200307220,2003,30722,TBA,ANA,STP01,3,1,4
TBA200308040,2003,30804,TBA,TOR,STP01,1,10,11
TBA200308050,2003,30805,TBA,TOR,STP01,4,5,9
TBA200308060,2003,30806,TBA,TOR,STP01,7,3,10
TBA200308070,2003,30807,TBA,KCA,STP01,2,3,5
TBA200308080,2003,30808,TBA,KCA,STP01,0,4,4
TBA200308090,2003,30809,TBA,KCA,STP01,6,2,8
TBA200308100,2003,30810,TBA,KCA,STP01,7,3,10
TBA200308110,2003,30811,TBA,BAL,STP01,3,4,7
TBA200308120,2003,30812,TBA,BAL,STP01,2,4,6
TBA200308130,2003,30813,TBA,BAL,STP01,5,6,11
TBA200308220,2003,30822,TBA,CLE,STP01,8,3,11
TBA200308230,2003,30823,TBA,CLE,STP01,7,5,12
TBA200308240,2003,30824,TBA,CLE,STP01,7,5,12
TBA200309020,2003,30902,TBA,SEA,STP01,10,8,18
TBA200309030,2003,30903,TBA,SEA,STP01,0,7,7
TBA200309040,2003,30904,TBA,SEA,STP01,0,1,1
TBA200309050,2003,30905,TBA,OAK,STP01,3,1,4
TBA200309060,2003,30906,TBA,OAK,STP01,4,7,11
TBA200309070,2003,30907,TBA,OAK,STP01,2,11,13
TBA200309090,2003,30909,TBA,TOR,STP01,6,11,17
TBA200309100,2003,30910,TBA,TOR,STP01,6,5,11
TBA200309110,2003,30911,TBA,TOR,STP01,3,1,4
TBA200309190,2003,30919,TBA,NYA,STP01,2,1,3
TBA200309200,2003,30920,TBA,NYA,STP01,7,1,8
TBA200309210,2003,30921,TBA,NYA,STP01,6,0,6
TBA200309260,2003,30926,TBA,BOS,STP01,7,2,9
TBA200309270,2003,30927,TBA,BOS,STP01,4,5,9
TBA200309280,2003,30928,TBA,BOS,STP01,1,3,4
TBA200403300,2004,40330,TBA,NYA,TOK01,3,8,11
TBA200403310,2004,40331,TBA,NYA,TOK01,12,1,13
TBA200404060,2004,40406,TBA,NYA,STP01,4,9,13
TBA200404070,2004,40407,TBA,NYA,STP01,3,2,5
TBA200404090,2004,40409,TBA,BAL,STP01,3,4,7
TBA200404100,2004,40410,TBA,BAL,STP01,11,3,14
TBA200404110,2004,40411,TBA,BAL,STP01,1,10,11
TBA200404160,2004,40416,TBA,CHA,STP01,0,3,3
TBA200404170,2004,40417,TBA,CHA,STP01,4,1,5
TBA200404180,2004,40418,TBA,CHA,STP01,5,0,5
TBA200404300,2004,40430,TBA,OAK,STP01,4,2,6
TBA200405010,2004,40501,TBA,OAK,STP01,6,5,11
TBA200405020,2004,40502,TBA,OAK,STP01,2,8,10
TBA200405110,2004,40511,TBA,TEX,STP01,5,4,9
TBA200405120,2004,40512,TBA,TEX,STP01,9,8,17
TBA200405130,2004,40513,TBA,TEX,STP01,3,6,9
TBA200405180,2004,40518,TBA,BOS,STP01,7,3,10
TBA200405190,2004,40519,TBA,BOS,STP01,4,1,5
TBA200405200,2004,40520,TBA,BOS,STP01,6,9,15
TBA200405210,2004,40521,TBA,CLE,STP01,3,5,8
TBA200405220,2004,40522,TBA,CLE,STP01,3,6,9
TBA200405230,2004,40523,TBA,CLE,STP01,4,5,9
TBA200405250,2004,40525,TBA,MIN,STP01,1,6,7
TBA200405260,2004,40526,TBA,MIN,STP01,4,2,6
TBA200405270,2004,40527,TBA,MIN,STP01,4,5,9
TBA200405280,2004,40528,TBA,NYA,STP01,7,5,12
TBA200405290,2004,40529,TBA,NYA,STP01,5,3,8
TBA200405300,2004,40530,TBA,NYA,STP01,6,7,13
TBA200406080,2004,40608,TBA,SFN,STP01,7,3,10
TBA200406090,2004,40609,TBA,SFN,STP01,3,4,7
TBA200406100,2004,40610,TBA,SFN,STP01,2,5,7
TBA200406110,2004,40611,TBA,COL,STP01,7,8,15
TBA200406120,2004,40612,TBA,COL,STP01,7,10,17
TBA200406130,2004,40613,TBA,COL,STP01,2,3,5
TBA200406250,2004,40625,TBA,FLO,STP01,0,2,2
TBA200406260,2004,40626,TBA,FLO,STP01,4,6,10
TBA200406270,2004,40627,TBA,FLO,STP01,11,4,15
TBA200406280,2004,40628,TBA,TOR,STP01,2,10,12
TBA200406290,2004,40629,TBA,TOR,STP01,4,0,4
TBA200406300,2004,40630,TBA,TOR,STP01,2,6,8
TBA200407010,2004,40701,TBA,TOR,STP01,14,0,14
TBA200407150,2004,40715,TBA,BAL,STP01,5,4,9
TBA200407160,2004,40716,TBA,BAL,STP01,0,2,2
TBA200407170,2004,40717,TBA,BAL,STP01,3,2,5
TBA200407180,2004,40718,TBA,BAL,STP01,2,7,9
TBA200407190,2004,40719,TBA,NYA,STP01,7,9,16
TBA200407200,2004,40720,TBA,NYA,STP01,4,2,6
TBA200407270,2004,40727,TBA,KCA,STP01,2,6,8
TBA200407280,2004,40728,TBA,KCA,STP01,1,10,11
TBA200407290,2004,40729,TBA,KCA,STP01,0,2,2
TBA200407300,2004,40730,TBA,TOR,STP01,3,0,3
TBA200407310,2004,40731,TBA,TOR,STP01,5,6,11
TBA200408010,2004,40801,TBA,TOR,STP01,3,5,8
TBA200408020,2004,40802,TBA,BOS,STP01,6,3,9
TBA200408030,2004,40803,TBA,BOS,STP01,5,2,7
TBA200408040,2004,40804,TBA,BOS,STP01,4,5,9
TBA200408050,2004,40805,TBA,SEA,STP01,4,2,6
TBA200408060,2004,40806,TBA,SEA,STP01,1,2,3
TBA200408070,2004,40807,TBA,SEA,STP01,5,2,7
TBA200408080,2004,40808,TBA,SEA,STP01,1,5,6
TBA200408170,2004,40817,TBA,ANA,STP01,3,8,11
TBA200408180,2004,40818,TBA,ANA,STP01,6,4,10
TBA200408190,2004,40819,TBA,ANA,STP01,10,7,17
TBA200408200,2004,40820,TBA,OAK,STP01,9,5,14
TBA200408210,2004,40821,TBA,OAK,STP01,5,0,5
TBA200408220,2004,40822,TBA,OAK,STP01,1,2,3
TBA200408310,2004,40831,TBA,BAL,STP01,10,6,16
TBA200409010,2004,40901,TBA,BAL,STP01,8,0,8
TBA200409020,2004,40902,TBA,BAL,STP01,13,2,15
TBA200409030,2004,40903,TBA,DET,STP01,4,2,6
TBA200409200,2004,40920,TBA,KCA,STP01,6,3,9
TBA200409210,2004,40921,TBA,KCA,STP01,4,7,11
TBA200409220,2004,40922,TBA,KCA,STP01,7,6,13
TBA200409240,2004,40924,TBA,TOR,STP01,2,4,6
TBA200409250,2004,40925,TBA,TOR,STP01,5,6,11
TBA200409270,2004,40927,TBA,BOS,STP01,7,3,10
TBA200409280,2004,40928,TBA,BOS,STP01,10,8,18
TBA200409290,2004,40929,TBA,BOS,STP01,4,9,13
TBA200409301,2004,40930,TBA,DET,STP01,8,0,8
TBA200409302,2004,40930,TBA,DET,STP01,4,6,10
TBA200504040,2005,50404,TBA,TOR,STP01,5,2,7
TBA200504050,2005,50405,TBA,TOR,STP01,6,3,9
TBA200504060,2005,50406,TBA,TOR,STP01,5,8,13
TBA200504080,2005,50408,TBA,OAK,STP01,2,3,5
TBA200504090,2005,50409,TBA,OAK,STP01,2,11,13
TBA200504100,2005,50410,TBA,OAK,STP01,6,1,7
TBA200504120,2005,50412,TBA,BAL,STP01,7,6,13
TBA200504130,2005,50413,TBA,BAL,STP01,5,1,6
TBA200504140,2005,50414,TBA,BAL,STP01,7,12,19
TBA200504200,2005,50420,TBA,TEX,STP01,12,10,22
TBA200504210,2005,50421,TBA,TEX,STP01,2,3,5
TBA200504220,2005,50422,TBA,BOS,STP01,4,5,9
TBA200504230,2005,50423,TBA,BOS,STP01,5,6,11
TBA200504240,2005,50424,TBA,BOS,STP01,11,3,14
TBA200505020,2005,50502,TBA,NYA,STP01,6,2,8
TBA200505030,2005,50503,TBA,NYA,STP01,4,11,15
TBA200505040,2005,50504,TBA,NYA,STP01,8,11,19
TBA200505050,2005,50505,TBA,NYA,STP01,2,6,8
TBA200505060,2005,50506,TBA,MIN,STP01,7,1,8
TBA200505070,2005,50507,TBA,MIN,STP01,8,1,9
TBA200505080,2005,50508,TBA,MIN,STP01,9,6,15
TBA200505090,2005,50509,TBA,CHA,STP01,2,4,6
TBA200505100,2005,50510,TBA,CHA,STP01,6,7,13
TBA200505110,2005,50511,TBA,CHA,STP01,5,2,7
TBA200505240,2005,50524,TBA,OAK,STP01,4,5,9
TBA200505250,2005,50525,TBA,OAK,STP01,6,14,20
TBA200505260,2005,50526,TBA,OAK,STP01,1,2,3
TBA200505270,2005,50527,TBA,SEA,STP01,4,5,9
TBA200505280,2005,50528,TBA,SEA,STP01,3,2,5
TBA200505290,2005,50529,TBA,SEA,STP01,10,9,19
TBA200506130,2005,50613,TBA,MIL,STP01,3,5,8
TBA200506140,2005,50614,TBA,MIL,STP01,4,0,4
TBA200506150,2005,50615,TBA,MIL,STP01,3,5,8
TBA200506170,2005,50617,TBA,SLN,STP01,6,4,10
TBA200506180,2005,50618,TBA,SLN,STP01,5,2,7
TBA200506190,2005,50619,TBA,SLN,STP01,8,5,13
TBA200506240,2005,50624,TBA,FLO,STP01,7,4,11
TBA200506250,2005,50625,TBA,FLO,STP01,6,2,8
TBA200506260,2005,50626,TBA,FLO,STP01,1,0,1
TBA200506270,2005,50627,TBA,TOR,STP01,3,4,7
TBA200506280,2005,50628,TBA,TOR,STP01,3,1,4
TBA200506290,2005,50629,TBA,TOR,STP01,12,3,15
TBA200507070,2005,50707,TBA,DET,STP01,6,4,10
TBA200507080,2005,50708,TBA,DET,STP01,7,3,10
TBA200507090,2005,50709,TBA,DET,STP01,4,5,9
TBA200507100,2005,50710,TBA,DET,STP01,9,4,13
TBA200507220,2005,50722,TBA,BAL,STP01,5,7,12
TBA200507230,2005,50723,TBA,BAL,STP01,2,3,5
TBA200507240,2005,50724,TBA,BAL,STP01,2,6,8
TBA200507250,2005,50725,TBA,BOS,STP01,3,4,7
TBA200507260,2005,50726,TBA,BOS,STP01,10,9,19
TBA200507270,2005,50727,TBA,BOS,STP01,4,1,5
TBA200507280,2005,50728,TBA,KCA,STP01,5,10,15
TBA200507290,2005,50729,TBA,KCA,STP01,3,6,9
TBA200507300,2005,50730,TBA,KCA,STP01,3,7,10
TBA200507310,2005,50731,TBA,KCA,STP01,2,6,8
TBA200508150,2005,50815,TBA,NYA,STP01,5,2,7
TBA200508160,2005,50816,TBA,NYA,STP01,3,4,7
TBA200508170,2005,50817,TBA,NYA,STP01,6,7,13
TBA200508190,2005,50819,TBA,TEX,STP01,1,2,3
TBA200508200,2005,50820,TBA,TEX,STP01,2,4,6
TBA200508210,2005,50821,TBA,TEX,STP01,3,6,9
TBA200508220,2005,50822,TBA,CLE,STP01,11,4,15
TBA200508230,2005,50823,TBA,CLE,STP01,5,4,9
TBA200508240,2005,50824,TBA,CLE,STP01,3,13,16
TBA200508250,2005,50825,TBA,CLE,STP01,12,4,16
TBA200508260,2005,50826,TBA,ANA,STP01,8,12,20
TBA200508270,2005,50827,TBA,ANA,STP01,3,6,9
TBA200508280,2005,50828,TBA,ANA,STP01,1,2,3
TBA200509090,2005,50909,TBA,TOR,STP01,7,2,9
TBA200509100,2005,50910,TBA,TOR,STP01,3,2,5
TBA200509110,2005,50911,TBA,TOR,STP01,5,6,11
TBA200509130,2005,50913,TBA,NYA,STP01,17,3,20
TBA200509140,2005,50914,TBA,NYA,STP01,6,5,11
TBA200509150,2005,50915,TBA,NYA,STP01,9,5,14
TBA200509190,2005,50919,TBA,BOS,STP01,7,8,15
TBA200509200,2005,50920,TBA,BOS,STP01,15,2,17
TBA200509210,2005,50921,TBA,BOS,STP01,4,7,11
TBA200509300,2005,50930,TBA,BAL,STP01,7,6,13
TBA200510010,2005,51001,TBA,BAL,STP01,4,3,7
TBA200510020,2005,51002,TBA,BAL,STP01,6,2,8
TBA200604100,2006,60410,TBA,BAL,STP01,6,3,9
TBA200604110,2006,60411,TBA,BAL,STP01,8,4,12
TBA200604120,2006,60412,TBA,BAL,STP01,4,7,11
TBA200604130,2006,60413,TBA,BAL,STP01,6,5,11
TBA200604140,2006,60414,TBA,KCA,STP01,2,7,9
TBA200604150,2006,60415,TBA,KCA,STP01,3,6,9
TBA200604160,2006,60416,TBA,KCA,STP01,5,9,14
TBA200604280,2006,60428,TBA,BOS,STP01,2,5,7
TBA200604290,2006,60429,TBA,BOS,STP01,9,6,15
TBA200604300,2006,60430,TBA,BOS,STP01,4,5,9
TBA200605010,2006,60501,TBA,TEX,STP01,3,0,3
TBA200605020,2006,60502,TBA,TEX,STP01,7,5,12
TBA200605030,2006,60503,TBA,NYA,STP01,4,2,6
TBA200605040,2006,60504,TBA,NYA,STP01,10,5,15
TBA200605120,2006,60512,TBA,TOR,STP01,1,4,5
TBA200605130,2006,60513,TBA,TOR,STP01,8,1,9
TBA200605140,2006,60514,TBA,TOR,STP01,8,3,11
TBA200605160,2006,60516,TBA,CHA,STP01,7,10,17
TBA200605170,2006,60517,TBA,CHA,STP01,5,2,7
TBA200605180,2006,60518,TBA,CHA,STP01,4,5,9
TBA200605190,2006,60519,TBA,FLO,STP01,4,5,9
TBA200605200,2006,60520,TBA,FLO,STP01,3,4,7
TBA200605210,2006,60521,TBA,FLO,STP01,0,3,3
TBA200606020,2006,60602,TBA,TOR,STP01,13,4,17
TBA200606030,2006,60603,TBA,TOR,STP01,6,2,8
TBA200606040,2006,60604,TBA,TOR,STP01,5,10,15
TBA200606050,2006,60605,TBA,ANA,STP01,0,4,4
TBA200606060,2006,60606,TBA,ANA,STP01,12,2,14
TBA200606070,2006,60607,TBA,ANA,STP01,6,2,8
TBA200606200,2006,60620,TBA,ARI,STP01,5,8,13
TBA200606210,2006,60621,TBA,ARI,STP01,2,3,5
TBA200606220,2006,60622,TBA,ARI,STP01,1,4,5
TBA200606230,2006,60623,TBA,ATL,STP01,4,3,7
TBA200606240,2006,60624,TBA,ATL,STP01,2,3,5
TBA200606250,2006,60625,TBA,ATL,STP01,4,1,5
TBA200607030,2006,60703,TBA,BOS,STP01,0,3,3
TBA200607040,2006,60704,TBA,BOS,STP01,6,9,15
TBA200607050,2006,60705,TBA,BOS,STP01,2,5,7
TBA200607060,2006,60706,TBA,BOS,STP01,12,5,17
TBA200607070,2006,60707,TBA,NYA,STP01,1,0,1
TBA200607080,2006,60708,TBA,NYA,STP01,5,1,6
TBA200607090,2006,60709,TBA,NYA,STP01,5,6,11
TBA200607210,2006,60721,TBA,BAL,STP01,7,14,21
TBA200607220,2006,60722,TBA,BAL,STP01,12,13,25
TBA200607230,2006,60723,TBA,BAL,STP01,4,2,6
TBA200607240,2006,60724,TBA,ANA,STP01,8,4,12
TBA200607250,2006,60725,TBA,ANA,STP01,3,6,9
TBA200607260,2006,60726,TBA,ANA,STP01,15,6,21
TBA200607310,2006,60731,TBA,DET,STP01,3,7,10
TBA200608010,2006,60801,TBA,DET,STP01,10,4,14
TBA200608020,2006,60802,TBA,DET,STP01,8,3,11
TBA200608030,2006,60803,TBA,DET,STP01,1,2,3
TBA200608040,2006,60804,TBA,BOS,STP01,3,2,5
TBA200608050,2006,60805,TBA,BOS,STP01,5,8,13
TBA200608060,2006,60806,TBA,BOS,STP01,6,7,13
TBA200608150,2006,60815,TBA,TOR,STP01,4,3,7
TBA200608160,2006,60816,TBA,TOR,STP01,3,8,11
TBA200608170,2006,60817,TBA,TOR,STP01,6,2,8
TBA200608180,2006,60818,TBA,CLE,STP01,5,6,11
TBA200608190,2006,60819,TBA,CLE,STP01,5,3,8
TBA200608200,2006,60820,TBA,CLE,STP01,9,4,13
TBA200608210,2006,60821,TBA,TEX,STP01,3,4,7
TBA200608220,2006,60822,TBA,TEX,STP01,3,5,8
TBA200608230,2006,60823,TBA,TEX,STP01,3,7,10
TBA200608240,2006,60824,TBA,TEX,STP01,4,3,7
TBA200609010,2006,60901,TBA,SEA,STP01,1,2,3
TBA200609020,2006,60902,TBA,SEA,STP01,4,3,7
TBA200609030,2006,60903,TBA,SEA,STP01,6,7,13
TBA200609040,2006,60904,TBA,MIN,STP01,2,1,3
TBA200609050,2006,60905,TBA,MIN,STP01,8,0,8
TBA200609060,2006,60906,TBA,MIN,STP01,2,4,6
TBA200609080,2006,60908,TBA,OAK,STP01,8,6,14
TBA200609090,2006,60909,TBA,OAK,STP01,6,9,15
TBA200609100,2006,60910,TBA,OAK,STP01,9,7,16
TBA200609180,2006,60918,TBA,BAL,STP01,4,1,5
TBA200609190,2006,60919,TBA,BAL,STP01,5,4,9
TBA200609200,2006,60920,TBA,BAL,STP01,2,4,6
TBA200609220,2006,60922,TBA,NYA,STP01,4,1,5
TBA200609230,2006,60923,TBA,NYA,STP01,0,8,8
TBA200609240,2006,60924,TBA,NYA,STP01,4,11,15
TBA200609250,2006,60925,TBA,NYA,STP01,16,1,17
TBA200704060,2007,70406,TBA,TOR,STP01,5,6,11
TBA200704070,2007,70407,TBA,TOR,STP01,8,5,13
TBA200704080,2007,70408,TBA,TOR,STP01,6,3,9
TBA200704160,2007,70416,TBA,BAL,STP01,9,7,16
TBA200704170,2007,70417,TBA,BAL,STP01,4,6,10
TBA200704180,2007,70418,TBA,BAL,STP01,6,4,10
TBA200704200,2007,70420,TBA,CLE,STP01,4,3,7
TBA200704210,2007,70421,TBA,CLE,STP01,5,6,11
TBA200704220,2007,70422,TBA,CLE,STP01,6,4,10
TBA200704230,2007,70423,TBA,NYA,STP01,8,10,18
TBA200704240,2007,70424,TBA,NYA,STP01,4,6,10
TBA200705010,2007,70501,TBA,MIN,STP01,9,1,10
TBA200705020,2007,70502,TBA,MIN,STP01,3,4,7
TBA200705030,2007,70503,TBA,MIN,STP01,4,6,10
TBA200705040,2007,70504,TBA,OAK,STP01,5,2,7
TBA200705050,2007,70505,TBA,OAK,STP01,2,3,5
TBA200705060,2007,70506,TBA,OAK,STP01,5,3,8
TBA200705150,2007,70515,TBA,TEX,LBV01,3,4,7
TBA200705160,2007,70516,TBA,TEX,LBV01,8,11,19
TBA200705170,2007,70517,TBA,TEX,LBV01,6,8,14
TBA200705180,2007,70518,TBA,FLO,STP01,8,4,12
TBA200705190,2007,70519,TBA,FLO,STP01,7,2,9
TBA200705200,2007,70520,TBA,FLO,STP01,4,3,7
TBA200705220,2007,70522,TBA,SEA,STP01,5,2,7
TBA200705230,2007,70523,TBA,SEA,STP01,5,1,6
TBA200705240,2007,70524,TBA,SEA,STP01,12,13,25
TBA200705280,2007,70528,TBA,DET,STP01,5,6,11
TBA200705290,2007,70529,TBA,DET,STP01,14,2,16
TBA200705300,2007,70530,TBA,DET,STP01,3,5,8
TBA200706010,2007,70601,TBA,KCA,STP01,4,1,5
TBA200706020,2007,70602,TBA,KCA,STP01,9,4,13
TBA200706030,2007,70603,TBA,KCA,STP01,1,5,6
TBA200706040,2007,70604,TBA,KCA,STP01,2,4,6
TBA200706120,2007,70612,TBA,SDN,STP01,4,11,15
TBA200706130,2007,70613,TBA,SDN,STP01,9,0,9
TBA200706140,2007,70614,TBA,SDN,STP01,7,1,8
TBA200706220,2007,70622,TBA,LAN,STP01,6,3,9
TBA200706230,2007,70623,TBA,LAN,STP01,3,4,7
TBA200706240,2007,70624,TBA,LAN,STP01,4,9,13
TBA200706250,2007,70625,TBA,CHA,STP01,5,4,9
TBA200706260,2007,70626,TBA,CHA,STP01,6,1,7
TBA200706270,2007,70627,TBA,CHA,STP01,5,3,8
TBA200706280,2007,70628,TBA,CHA,STP01,5,1,6
TBA200707120,2007,70712,TBA,NYA,STP01,7,3,10
TBA200707130,2007,70713,TBA,NYA,STP01,4,6,10
TBA200707140,2007,70714,TBA,NYA,STP01,6,4,10
TBA200707150,2007,70715,TBA,NYA,STP01,7,6,13
TBA200707170,2007,70717,TBA,ANA,STP01,3,8,11
TBA200707180,2007,70718,TBA,ANA,STP01,2,7,9
TBA200707190,2007,70719,TBA,ANA,STP01,3,0,3
TBA200707270,2007,70727,TBA,BOS,STP01,7,1,8
TBA200707280,2007,70728,TBA,BOS,STP01,12,6,18
TBA200707290,2007,70729,TBA,BOS,STP01,2,5,7
TBA200707300,2007,70730,TBA,TOR,STP01,4,5,9
TBA200707310,2007,70731,TBA,TOR,STP01,2,0,2
TBA200708010,2007,70801,TBA,TOR,STP01,2,6,8
TBA200708030,2007,70803,TBA,BAL,STP01,3,1,4
TBA200708040,2007,70804,TBA,BAL,STP01,2,9,11
TBA200708050,2007,70805,TBA,BAL,STP01,11,3,14
TBA200708170,2007,70817,TBA,CLE,STP01,2,1,3
TBA200708180,2007,70818,TBA,CLE,STP01,8,1,9
TBA200708190,2007,70819,TBA,CLE,STP01,3,4,7
TBA200708200,2007,70820,TBA,BOS,STP01,6,0,6
TBA200708210,2007,70821,TBA,BOS,STP01,8,6,14
TBA200708220,2007,70822,TBA,BOS,STP01,1,2,3
TBA200708230,2007,70823,TBA,OAK,STP01,12,2,14
TBA200708240,2007,70824,TBA,OAK,STP01,2,12,14
TBA200708250,2007,70825,TBA,OAK,STP01,3,14,17
TBA200708260,2007,70826,TBA,OAK,STP01,4,7,11
TBA200709030,2007,70903,TBA,BAL,STP01,7,9,16
TBA200709040,2007,70904,TBA,BAL,STP01,8,4,12
TBA200709050,2007,70905,TBA,BAL,STP01,2,17,19
TBA200709070,2007,70907,TBA,TOR,STP01,7,2,9
TBA200709080,2007,70908,TBA,TOR,STP01,4,5,9
TBA200709090,2007,70909,TBA,TOR,STP01,2,3,5
TBA200709210,2007,70921,TBA,BOS,STP01,8,1,9
TBA200709220,2007,70922,TBA,BOS,STP01,8,6,14
TBA200709230,2007,70923,TBA,BOS,STP01,4,5,9
TBA200709250,2007,70925,TBA,NYA,STP01,6,7,13
TBA200709260,2007,70926,TBA,NYA,STP01,12,4,16
TBA200709270,2007,70927,TBA,NYA,STP01,3,1,4
TBA200804080,2008,80408,TBA,SEA,STP01,6,5,11
TBA200804090,2008,80409,TBA,SEA,STP01,7,1,8
TBA200804100,2008,80410,TBA,SEA,STP01,0,7,7
TBA200804110,2008,80411,TBA,BAL,STP01,5,10,15
TBA200804120,2008,80412,TBA,BAL,STP01,3,2,5
TBA200804130,2008,80413,TBA,BAL,STP01,2,6,8
TBA200804140,2008,80414,TBA,NYA,STP01,8,7,15
TBA200804150,2008,80415,TBA,NYA,STP01,5,3,8
TBA200804180,2008,80418,TBA,CHA,STP01,9,2,11
TBA200804190,2008,80419,TBA,CHA,STP01,0,5,5
TBA200804200,2008,80420,TBA,CHA,STP01,6,0,6
TBA200804220,2008,80422,TBA,TOR,LBV01,4,6,10
TBA200804230,2008,80423,TBA,TOR,LBV01,3,5,8
TBA200804240,2008,80424,TBA,TOR,LBV01,3,5,8
TBA200804250,2008,80425,TBA,BOS,STP01,4,5,9
TBA200804260,2008,80426,TBA,BOS,STP01,1,2,3
TBA200804270,2008,80427,TBA,BOS,STP01,0,3,3
TBA200805090,2008,80509,TBA,ANA,STP01,0,2,2
TBA200805100,2008,80510,TBA,ANA,STP01,0,2,2
TBA200805110,2008,80511,TBA,ANA,STP01,5,8,13
TBA200805120,2008,80512,TBA,NYA,STP01,1,7,8
TBA200805130,2008,80513,TBA,NYA,STP01,1,2,3
TBA200805140,2008,80514,TBA,NYA,STP01,2,1,3
TBA200805150,2008,80515,TBA,NYA,STP01,2,5,7
TBA200805230,2008,80523,TBA,BAL,STP01,0,2,2
TBA200805240,2008,80524,TBA,BAL,STP01,4,11,15
TBA200805250,2008,80525,TBA,BAL,STP01,4,5,9
TBA200805260,2008,80526,TBA,TEX,STP01,3,7,10
TBA200805270,2008,80527,TBA,TEX,STP01,12,6,18
TBA200805280,2008,80528,TBA,TEX,STP01,3,5,8
TBA200805290,2008,80529,TBA,CHA,STP01,5,1,6
TBA200805300,2008,80530,TBA,CHA,STP01,1,2,3
TBA200805310,2008,80531,TBA,CHA,STP01,0,2,2
TBA200806010,2008,80601,TBA,CHA,STP01,3,4,7
TBA200806130,2008,80613,TBA,FLO,STP01,3,7,10
TBA200806140,2008,80614,TBA,FLO,STP01,1,4,5
TBA200806150,2008,80615,TBA,FLO,STP01,9,3,12
TBA200806170,2008,80617,TBA,CHN,STP01,2,3,5
TBA200806180,2008,80618,TBA,CHN,STP01,4,5,9
TBA200806190,2008,80619,TBA,CHN,STP01,3,8,11
TBA200806200,2008,80620,TBA,HOU,STP01,4,3,7
TBA200806210,2008,80621,TBA,HOU,STP01,3,4,7
TBA200806220,2008,80622,TBA,HOU,STP01,3,2,5
TBA200806300,2008,80630,TBA,BOS,STP01,4,5,9
TBA200807010,2008,80701,TBA,BOS,STP01,1,3,4
TBA200807020,2008,80702,TBA,BOS,STP01,6,7,13
TBA200807040,2008,80704,TBA,KCA,STP01,2,11,13
TBA200807050,2008,80705,TBA,KCA,STP01,0,3,3
TBA200807060,2008,80706,TBA,KCA,STP01,2,9,11
TBA200807070,2008,80707,TBA,KCA,STP01,7,4,11
TBA200807180,2008,80718,TBA,TOR,STP01,1,2,3
TBA200807190,2008,80719,TBA,TOR,STP01,4,6,10
TBA200807200,2008,80720,TBA,TOR,STP01,9,4,13
TBA200807210,2008,80721,TBA,OAK,STP01,0,4,4
TBA200807220,2008,80722,TBA,OAK,STP01,8,1,9
TBA200807230,2008,80723,TBA,OAK,STP01,3,4,7
TBA200808010,2008,80801,TBA,DET,STP01,2,5,7
TBA200808020,2008,80802,TBA,DET,STP01,3,9,12
TBA200808030,2008,80803,TBA,DET,STP01,5,6,11
TBA200808040,2008,80804,TBA,CLE,STP01,5,2,7
TBA200808050,2008,80805,TBA,CLE,STP01,4,8,12
TBA200808060,2008,80806,TBA,CLE,STP01,7,10,17
TBA200808180,2008,80818,TBA,ANA,STP01,4,6,10
TBA200808190,2008,80819,TBA,ANA,STP01,2,4,6
TBA200808200,2008,80820,TBA,ANA,STP01,5,4,9
TBA200808260,2008,80826,TBA,TOR,STP01,6,2,8
TBA200808270,2008,80827,TBA,TOR,STP01,0,1,1
TBA200808280,2008,80828,TBA,TOR,STP01,2,3,5
TBA200808290,2008,80829,TBA,BAL,STP01,3,14,17
TBA200808300,2008,80830,TBA,BAL,STP01,9,10,19
TBA200808310,2008,80831,TBA,BAL,STP01,4,10,14
TBA200809020,2008,80902,TBA,NYA,STP01,7,2,9
TBA200809030,2008,80903,TBA,NYA,STP01,8,4,12
TBA200809040,2008,80904,TBA,NYA,STP01,5,7,12
TBA200809150,2008,80915,TBA,BOS,STP01,13,5,18
TBA200809160,2008,80916,TBA,BOS,STP01,1,2,3
TBA200809170,2008,80917,TBA,BOS,STP01,3,10,13
TBA200809180,2008,80918,TBA,MIN,STP01,11,8,19
TBA200809190,2008,80919,TBA,MIN,STP01,1,11,12
TBA200809200,2008,80920,TBA,MIN,STP01,2,7,9
TBA200809210,2008,80921,TBA,MIN,STP01,4,1,5
TBA200810020,2008,81002,TBA,CHA,STP01,4,6,10
TBA200810030,2008,81003,TBA,CHA,STP01,2,6,8
TBA200810100,2008,81010,TBA,BOS,STP01,2,0,2
TBA200810110,2008,81011,TBA,BOS,STP01,8,9,17
TBA200810180,2008,81018,TBA,BOS,STP01,4,2,6
TBA200810190,2008,81019,TBA,BOS,STP01,1,3,4
TBA200810220,2008,81022,TBA,PHI,STP01,3,2,5
TBA200810230,2008,81023,TBA,PHI,STP01,2,4,6
TBA200904130,2009,90413,TBA,NYA,STP01,5,15,20
TBA200904140,2009,90414,TBA,NYA,STP01,7,2,9
TBA200904150,2009,90415,TBA,NYA,STP01,4,3,7
TBA200904160,2009,90416,TBA,CHA,STP01,3,2,5
TBA200904170,2009,90417,TBA,CHA,STP01,5,6,11
TBA200904180,2009,90418,TBA,CHA,STP01,8,3,11
TBA200904190,2009,90419,TBA,CHA,STP01,12,2,14
TBA200904300,2009,90430,TBA,BOS,STP01,0,13,13
TBA200905010,2009,90501,TBA,BOS,STP01,2,6,8
TBA200905020,2009,90502,TBA,BOS,STP01,10,6,16
TBA200905030,2009,90503,TBA,BOS,STP01,3,5,8
TBA200905040,2009,90504,TBA,BAL,STP01,8,4,12
TBA200905050,2009,90505,TBA,BAL,STP01,3,6,9
TBA200905140,2009,90514,TBA,CLE,STP01,11,7,18
TBA200905150,2009,90515,TBA,CLE,STP01,7,8,15
TBA200905160,2009,90516,TBA,CLE,STP01,2,4,6
TBA200905170,2009,90517,TBA,CLE,STP01,5,7,12
TBA200905180,2009,90518,TBA,OAK,STP01,4,13,17
TBA200905190,2009,90519,TBA,OAK,STP01,4,1,5
TBA200905200,2009,90520,TBA,OAK,STP01,7,6,13
TBA200905210,2009,90521,TBA,OAK,STP01,5,6,11
TBA200905290,2009,90529,TBA,MIN,STP01,3,5,8
TBA200905300,2009,90530,TBA,MIN,STP01,2,5,7
TBA200905310,2009,90531,TBA,MIN,STP01,3,2,5
TBA200906020,2009,90602,TBA,KCA,STP01,2,6,8
TBA200906030,2009,90603,TBA,KCA,STP01,0,9,9
TBA200906040,2009,90604,TBA,KCA,STP01,2,3,5
TBA200906090,2009,90609,TBA,ANA,STP01,4,3,7
TBA200906100,2009,90610,TBA,ANA,STP01,5,9,14
TBA200906110,2009,90611,TBA,ANA,STP01,1,11,12
TBA200906120,2009,90612,TBA,WAS,STP01,3,4,7
TBA200906130,2009,90613,TBA,WAS,STP01,3,8,11
TBA200906140,2009,90614,TBA,WAS,STP01,4,5,9
TBA200906230,2009,90623,TBA,PHI,STP01,10,1,11
TBA200906240,2009,90624,TBA,PHI,STP01,1,7,8
TBA200906250,2009,90625,TBA,PHI,STP01,4,10,14
TBA200906260,2009,90626,TBA,FLO,STP01,3,7,10
TBA200906270,2009,90627,TBA,FLO,STP01,2,3,5
TBA200906280,2009,90628,TBA,FLO,STP01,2,5,7
TBA200907070,2009,90707,TBA,TOR,STP01,1,3,4
TBA200907080,2009,90708,TBA,TOR,STP01,9,10,19
TBA200907090,2009,90709,TBA,TOR,STP01,2,3,5
TBA200907100,2009,90710,TBA,OAK,STP01,0,6,6
TBA200907110,2009,90711,TBA,OAK,STP01,7,2,9
TBA200907120,2009,90712,TBA,OAK,STP01,7,3,10
TBA200907270,2009,90727,TBA,NYA,STP01,11,4,15
TBA200907280,2009,90728,TBA,NYA,STP01,2,6,8
TBA200907290,2009,90729,TBA,NYA,STP01,6,2,8
TBA200907310,2009,90731,TBA,KCA,STP01,2,8,10
TBA200908010,2009,90801,TBA,KCA,STP01,1,7,8
TBA200908020,2009,90802,TBA,KCA,STP01,4,1,5
TBA200908030,2009,90803,TBA,KCA,STP01,4,10,14
TBA200908040,2009,90804,TBA,BOS,STP01,2,4,6
TBA200908050,2009,90805,TBA,BOS,STP01,4,6,10
TBA200908140,2009,90814,TBA,TOR,STP01,5,2,7
TBA200908150,2009,90815,TBA,TOR,STP01,3,8,11
TBA200908160,2009,90816,TBA,TOR,STP01,2,5,7
TBA200908180,2009,90818,TBA,BAL,STP01,4,5,9
TBA200908190,2009,90819,TBA,BAL,STP01,1,3,4
TBA200908200,2009,90820,TBA,BAL,STP01,8,7,15
TBA200908210,2009,90821,TBA,TEX,STP01,3,5,8
TBA200908220,2009,90822,TBA,TEX,STP01,4,5,9
TBA200908230,2009,90823,TBA,TEX,STP01,4,0,4
TBA200909010,2009,90901,TBA,BOS,STP01,8,4,12
TBA200909020,2009,90902,TBA,BOS,STP01,5,8,13
TBA200909030,2009,90903,TBA,BOS,STP01,6,3,9
TBA200909040,2009,90904,TBA,DET,STP01,4,3,7
TBA200909050,2009,90905,TBA,DET,STP01,8,6,14
TBA200909060,2009,90906,TBA,DET,STP01,5,3,8
TBA200909180,2009,90918,TBA,TOR,STP01,4,11,15
TBA200909190,2009,90919,TBA,TOR,STP01,0,4,4
TBA200909200,2009,90920,TBA,TOR,STP01,1,3,4
TBA200909220,2009,90922,TBA,SEA,STP01,4,3,7
TBA200909230,2009,90923,TBA,SEA,STP01,4,5,9
TBA200909280,2009,90928,TBA,BAL,STP01,6,7,13
TBA200909290,2009,90929,TBA,BAL,STP01,1,3,4
TBA200909300,2009,90930,TBA,BAL,STP01,3,5,8
TBA200910010,2009,91001,TBA,BAL,STP01,3,2,5
TBA200910020,2009,91002,TBA,NYA,STP01,4,13,17
TBA200910030,2009,91003,TBA,NYA,STP01,3,5,8
TBA200910040,2009,91004,TBA,NYA,STP01,10,2,12
TEX200004030,2000,403,TEX,CHA,ARL02,4,10,14
TEX200004040,2000,404,TEX,CHA,ARL02,8,12,20
TEX200004050,2000,405,TEX,CHA,ARL02,12,8,20
TEX200004060,2000,406,TEX,CHA,ARL02,6,2,8
TEX200004070,2000,407,TEX,TOR,ARL02,5,11,16
TEX200004080,2000,408,TEX,TOR,ARL02,4,0,4
TEX200004090,2000,409,TEX,TOR,ARL02,5,7,12
TEX200004170,2000,417,TEX,NYA,ARL02,5,4,9
TEX200004180,2000,418,TEX,NYA,ARL02,6,3,9
TEX200004190,2000,419,TEX,NYA,ARL02,5,4,9
TEX200004210,2000,421,TEX,MIN,ARL02,10,5,15
TEX200004220,2000,422,TEX,MIN,ARL02,3,8,11
TEX200004230,2000,423,TEX,MIN,ARL02,5,4,9
TEX200004240,2000,424,TEX,BOS,ARL02,4,5,9
TEX200004250,2000,425,TEX,BOS,ARL02,6,3,9
TEX200004260,2000,426,TEX,BOS,ARL02,14,4,18
TEX200005050,2000,505,TEX,OAK,ARL02,16,17,33
TEX200005060,2000,506,TEX,OAK,ARL02,10,11,21
TEX200005070,2000,507,TEX,OAK,ARL02,7,6,13
TEX200005080,2000,508,TEX,SEA,ARL02,1,10,11
TEX200005090,2000,509,TEX,SEA,ARL02,13,3,16
TEX200005100,2000,510,TEX,SEA,ARL02,6,7,13
TEX200005150,2000,515,TEX,TBA,ARL02,5,6,11
TEX200005160,2000,516,TEX,TBA,ARL02,7,9,16
TEX200005170,2000,517,TEX,TBA,ARL02,6,11,17
TEX200005180,2000,518,TEX,BAL,ARL02,7,8,15
TEX200005200,2000,520,TEX,BAL,ARL02,1,2,3
TEX200005210,2000,521,TEX,BAL,ARL02,5,6,11
TEX200006020,2000,602,TEX,ARI,ARL02,5,4,9
TEX200006030,2000,603,TEX,ARI,ARL02,3,4,7
TEX200006040,2000,604,TEX,ARI,ARL02,6,7,13
TEX200006050,2000,605,TEX,LAN,ARL02,0,2,2
TEX200006060,2000,606,TEX,LAN,ARL02,7,1,8
TEX200006070,2000,607,TEX,LAN,ARL02,11,6,17
TEX200006200,2000,620,TEX,MIN,ARL02,2,5,7
TEX200006210,2000,621,TEX,MIN,ARL02,5,7,12
TEX200006220,2000,622,TEX,MIN,ARL02,3,2,5
TEX200006230,2000,623,TEX,TBA,ARL02,7,4,11
TEX200006240,2000,624,TEX,TBA,ARL02,9,7,16
TEX200006250,2000,625,TEX,TBA,ARL02,5,9,14
TEX200006300,2000,630,TEX,SEA,ARL02,3,13,16
TEX200007010,2000,701,TEX,SEA,ARL02,6,3,9
TEX200007020,2000,702,TEX,SEA,ARL02,11,4,15
TEX200007030,2000,703,TEX,OAK,ARL02,3,8,11
TEX200007040,2000,704,TEX,OAK,ARL02,7,10,17
TEX200007050,2000,705,TEX,OAK,ARL02,4,9,13
TEX200007070,2000,707,TEX,SDN,ARL02,4,5,9
TEX200007080,2000,708,TEX,SDN,ARL02,1,8,9
TEX200007090,2000,709,TEX,SDN,ARL02,4,3,7
TEX200007240,2000,724,TEX,ANA,ARL02,6,5,11
TEX200007250,2000,725,TEX,ANA,ARL02,6,9,15
TEX200007260,2000,726,TEX,ANA,ARL02,5,6,11
TEX200007270,2000,727,TEX,DET,ARL02,3,7,10
TEX200007280,2000,728,TEX,DET,ARL02,5,11,16
TEX200007290,2000,729,TEX,DET,ARL02,10,2,12
TEX200007300,2000,730,TEX,DET,ARL02,8,7,15
TEX200008010,2000,801,TEX,CHA,ARL02,4,3,7
TEX200008020,2000,802,TEX,CHA,ARL02,2,7,9
TEX200008110,2000,811,TEX,BOS,ARL02,7,3,10
TEX200008120,2000,812,TEX,BOS,ARL02,3,6,9
TEX200008130,2000,813,TEX,BOS,ARL02,4,2,6
TEX200008140,2000,814,TEX,NYA,ARL02,7,3,10
TEX200008150,2000,815,TEX,NYA,ARL02,10,2,12
TEX200008160,2000,816,TEX,NYA,ARL02,0,5,5
TEX200008250,2000,825,TEX,TOR,ARL02,0,1,1
TEX200008260,2000,826,TEX,TOR,ARL02,9,3,12
TEX200008270,2000,827,TEX,TOR,ARL02,6,4,10
TEX200008280,2000,828,TEX,CLE,ARL02,5,2,7
TEX200008290,2000,829,TEX,CLE,ARL02,12,1,13
TEX200008300,2000,830,TEX,CLE,ARL02,5,3,8
TEX200008310,2000,831,TEX,CLE,ARL02,7,14,21
TEX200009121,2000,912,TEX,BAL,ARL02,1,9,10
TEX200009122,2000,912,TEX,BAL,ARL02,5,6,11
TEX200009130,2000,913,TEX,BAL,ARL02,9,4,13
TEX200009140,2000,914,TEX,KCA,ARL02,1,8,9
TEX200009150,2000,915,TEX,KCA,ARL02,11,12,23
TEX200009160,2000,916,TEX,KCA,ARL02,8,5,13
TEX200009170,2000,917,TEX,KCA,ARL02,5,6,11
TEX200009220,2000,922,TEX,ANA,ARL02,2,1,3
TEX200009230,2000,923,TEX,ANA,ARL02,15,4,19
TEX200009240,2000,924,TEX,ANA,ARL02,9,2,11
TEX200104030,2001,10403,TEX,ANA,ARL02,2,3,5
TEX200104040,2001,10404,TEX,ANA,ARL02,3,7,10
TEX200104050,2001,10405,TEX,ANA,ARL02,10,3,13
TEX200104060,2001,10406,TEX,SEA,ARL02,9,7,16
TEX200104070,2001,10407,TEX,SEA,ARL02,6,5,11
TEX200104080,2001,10408,TEX,SEA,ARL02,4,5,9
TEX200104190,2001,10419,TEX,OAK,ARL02,9,5,14
TEX200104200,2001,10420,TEX,OAK,ARL02,6,9,15
TEX200104210,2001,10421,TEX,OAK,ARL02,7,6,13
TEX200104220,2001,10422,TEX,OAK,ARL02,2,11,13
TEX200105010,2001,10501,TEX,DET,ARL02,6,3,9
TEX200105020,2001,10502,TEX,DET,ARL02,8,4,12
TEX200105030,2001,10503,TEX,DET,ARL02,9,4,13
TEX200105050,2001,10505,TEX,CHA,ARL02,0,2,2
TEX200105060,2001,10506,TEX,CHA,ARL02,10,5,15
TEX200105070,2001,10507,TEX,CHA,ARL02,7,4,11
TEX200105150,2001,10515,TEX,CLE,ARL02,8,6,14
TEX200105160,2001,10516,TEX,CLE,ARL02,4,3,7
TEX200105170,2001,10517,TEX,CLE,ARL02,7,12,19
TEX200105180,2001,10518,TEX,TOR,ARL02,9,3,12
TEX200105190,2001,10519,TEX,TOR,ARL02,6,5,11
TEX200105200,2001,10520,TEX,TOR,ARL02,2,3,5
TEX200105290,2001,10529,TEX,KCA,ARL02,2,8,10
TEX200105300,2001,10530,TEX,KCA,ARL02,11,2,13
TEX200105310,2001,10531,TEX,KCA,ARL02,8,2,10
TEX200106010,2001,10601,TEX,MIN,ARL02,10,7,17
TEX200106020,2001,10602,TEX,MIN,ARL02,2,3,5
TEX200106030,2001,10603,TEX,MIN,ARL02,6,3,9
TEX200106080,2001,10608,TEX,HOU,ARL02,5,4,9
TEX200106090,2001,10609,TEX,HOU,ARL02,4,16,20
TEX200106100,2001,10610,TEX,HOU,ARL02,6,5,11
TEX200106190,2001,10619,TEX,ANA,ARL02,5,7,12
TEX200106200,2001,10620,TEX,ANA,ARL02,4,3,7
TEX200106210,2001,10621,TEX,ANA,ARL02,3,4,7
TEX200106290,2001,10629,TEX,OAK,ARL02,6,9,15
TEX200106300,2001,10630,TEX,OAK,ARL02,15,4,19
TEX200107010,2001,10701,TEX,OAK,ARL02,1,3,4
TEX200107020,2001,10702,TEX,SEA,ARL02,9,7,16
TEX200107030,2001,10703,TEX,SEA,ARL02,8,4,12
TEX200107040,2001,10704,TEX,SEA,ARL02,3,6,9
TEX200107050,2001,10705,TEX,SEA,ARL02,2,14,16
TEX200107120,2001,10712,TEX,COL,ARL02,3,6,9
TEX200107130,2001,10713,TEX,COL,ARL02,2,10,12
TEX200107140,2001,10714,TEX,COL,ARL02,11,2,13
TEX200107150,2001,10715,TEX,SFN,ARL02,7,6,13
TEX200107160,2001,10716,TEX,SFN,ARL02,0,2,2
TEX200107170,2001,10717,TEX,SFN,ARL02,10,2,12
TEX200107240,2001,10724,TEX,BAL,ARL02,7,8,15
TEX200107251,2001,10725,TEX,BAL,ARL02,5,6,11
TEX200107252,2001,10725,TEX,BAL,ARL02,2,5,7
TEX200107260,2001,10726,TEX,BAL,ARL02,7,9,16
TEX200107270,2001,10727,TEX,TBA,ARL02,7,13,20
TEX200107280,2001,10728,TEX,TBA,ARL02,7,3,10
TEX200107290,2001,10729,TEX,TBA,ARL02,0,2,2
TEX200108070,2001,10807,TEX,DET,ARL02,7,3,10
TEX200108080,2001,10808,TEX,DET,ARL02,19,6,25
TEX200108090,2001,10809,TEX,DET,ARL02,3,7,10
TEX200108100,2001,10810,TEX,CLE,ARL02,2,7,9
TEX200108110,2001,10811,TEX,CLE,ARL02,5,6,11
TEX200108120,2001,10812,TEX,CLE,ARL02,13,2,15
TEX200108200,2001,10820,TEX,NYA,ARL02,9,5,14
TEX200108210,2001,10821,TEX,NYA,ARL02,3,13,16
TEX200108220,2001,10822,TEX,NYA,ARL02,1,8,9
TEX200108230,2001,10823,TEX,NYA,ARL02,5,2,7
TEX200108240,2001,10824,TEX,BOS,ARL02,7,4,11
TEX200108250,2001,10825,TEX,BOS,ARL02,7,8,15
TEX200108260,2001,10826,TEX,BOS,ARL02,4,5,9
TEX200109040,2001,10904,TEX,MIN,ARL02,5,6,11
TEX200109050,2001,10905,TEX,MIN,ARL02,12,2,14
TEX200109060,2001,10906,TEX,MIN,ARL02,3,4,7
TEX200109070,2001,10907,TEX,KCA,ARL02,2,8,10
TEX200109080,2001,10908,TEX,KCA,ARL02,8,3,11
TEX200109090,2001,10909,TEX,KCA,ARL02,3,4,7
TEX200109180,2001,10918,TEX,OAK,ARL02,6,5,11
TEX200109190,2001,10919,TEX,OAK,ARL02,4,10,14
TEX200109200,2001,10920,TEX,OAK,ARL02,7,2,9
TEX200109210,2001,10921,TEX,ANA,ARL02,8,9,17
TEX200109220,2001,10922,TEX,ANA,ARL02,4,5,9
TEX200109230,2001,10923,TEX,ANA,ARL02,2,5,7
TEX200109240,2001,10924,TEX,SEA,ARL02,9,3,12
TEX200109250,2001,10925,TEX,SEA,ARL02,13,2,15
TEX200109260,2001,10926,TEX,SEA,ARL02,7,5,12
TEX200204050,2002,20405,TEX,ANA,ARL02,3,1,4
TEX200204060,2002,20406,TEX,ANA,ARL02,6,3,9
TEX200204090,2002,20409,TEX,OAK,ARL02,5,4,9
TEX200204100,2002,20410,TEX,OAK,ARL02,2,4,6
TEX200204110,2002,20411,TEX,OAK,ARL02,0,7,7
TEX200204120,2002,20412,TEX,SEA,ARL02,7,3,10
TEX200204130,2002,20413,TEX,SEA,ARL02,9,4,13
TEX200204140,2002,20414,TEX,SEA,ARL02,9,7,16
TEX200204150,2002,20415,TEX,SEA,ARL02,13,11,24
TEX200204230,2002,20423,TEX,TOR,ARL02,2,1,3
TEX200204240,2002,20424,TEX,TOR,ARL02,2,3,5
TEX200204250,2002,20425,TEX,TOR,ARL02,9,11,20
TEX200204260,2002,20426,TEX,CLE,ARL02,7,4,11
TEX200204270,2002,20427,TEX,CLE,ARL02,2,4,6
TEX200204280,2002,20428,TEX,CLE,ARL02,1,2,3
TEX200205060,2002,20506,TEX,CHA,ARL02,5,6,11
TEX200205070,2002,20507,TEX,CHA,ARL02,11,6,17
TEX200205080,2002,20508,TEX,CHA,ARL02,5,3,8
TEX200205090,2002,20509,TEX,CHA,ARL02,1,4,5
TEX200205100,2002,20510,TEX,DET,ARL02,0,2,2
TEX200205110,2002,20511,TEX,DET,ARL02,6,10,16
TEX200205120,2002,20512,TEX,DET,ARL02,1,5,6
TEX200205270,2002,20527,TEX,MIN,ARL02,5,2,7
TEX200205280,2002,20528,TEX,MIN,ARL02,11,4,15
TEX200205290,2002,20529,TEX,MIN,ARL02,8,9,17
TEX200205310,2002,20531,TEX,KCA,ARL02,10,7,17
TEX200206010,2002,20601,TEX,KCA,ARL02,1,3,4
TEX200206020,2002,20602,TEX,KCA,ARL02,6,8,14
TEX200206070,2002,20607,TEX,ATL,ARL02,13,7,20
TEX200206080,2002,20608,TEX,ATL,ARL02,6,3,9
TEX200206090,2002,20609,TEX,ATL,ARL02,9,3,12
TEX200206100,2002,20610,TEX,CIN,ARL02,2,8,10
TEX200206110,2002,20611,TEX,CIN,ARL02,8,5,13
TEX200206120,2002,20612,TEX,CIN,ARL02,4,10,14
TEX200206241,2002,20624,TEX,ANA,ARL02,5,8,13
TEX200206242,2002,20624,TEX,ANA,ARL02,2,3,5
TEX200206250,2002,20625,TEX,ANA,ARL02,5,11,16
TEX200206260,2002,20626,TEX,ANA,ARL02,7,6,13
TEX200206270,2002,20627,TEX,ANA,ARL02,6,3,9
TEX200206280,2002,20628,TEX,HOU,ARL02,6,5,11
TEX200206290,2002,20629,TEX,HOU,ARL02,8,5,13
TEX200207020,2002,20702,TEX,TBA,ARL02,1,3,4
TEX200207030,2002,20703,TEX,TBA,ARL02,5,6,11
TEX200207040,2002,20704,TEX,TBA,ARL02,8,11,19
TEX200207050,2002,20705,TEX,BAL,ARL02,6,7,13
TEX200207060,2002,20706,TEX,BAL,ARL02,7,5,12
TEX200207070,2002,20707,TEX,BAL,ARL02,10,4,14
TEX200207170,2002,20717,TEX,SEA,ARL02,6,3,9
TEX200207180,2002,20718,TEX,SEA,ARL02,5,3,8
TEX200207260,2002,20726,TEX,OAK,ARL02,4,12,16
TEX200207270,2002,20727,TEX,OAK,ARL02,6,10,16
TEX200207280,2002,20728,TEX,OAK,ARL02,12,2,14
TEX200207290,2002,20729,TEX,NYA,ARL02,9,2,11
TEX200207300,2002,20730,TEX,NYA,ARL02,9,6,15
TEX200207310,2002,20731,TEX,NYA,ARL02,6,17,23
TEX200208010,2002,20801,TEX,BOS,ARL02,7,19,26
TEX200208020,2002,20802,TEX,BOS,ARL02,13,0,13
TEX200208030,2002,20803,TEX,BOS,ARL02,6,8,14
TEX200208040,2002,20804,TEX,BOS,ARL02,11,3,14
TEX200208130,2002,20813,TEX,CHA,ARL02,12,3,15
TEX200208140,2002,20814,TEX,CHA,ARL02,6,11,17
TEX200208160,2002,20816,TEX,TOR,ARL02,5,6,11
TEX200208170,2002,20817,TEX,TOR,ARL02,5,9,14
TEX200208180,2002,20818,TEX,TOR,ARL02,7,10,17
TEX200208270,2002,20827,TEX,BAL,ARL02,4,9,13
TEX200208280,2002,20828,TEX,BAL,ARL02,3,5,8
TEX200208290,2002,20829,TEX,BAL,ARL02,6,9,15
TEX200208300,2002,20830,TEX,TBA,ARL02,9,7,16
TEX200208310,2002,20831,TEX,TBA,ARL02,7,5,12
TEX200209010,2002,20901,TEX,TBA,ARL02,8,3,11
TEX200209020,2002,20902,TEX,HOU,ARL02,2,7,9
TEX200209090,2002,20909,TEX,SEA,ARL02,7,12,19
TEX200209100,2002,20910,TEX,SEA,ARL02,2,3,5
TEX200209110,2002,20911,TEX,SEA,ARL02,3,4,7
TEX200209120,2002,20912,TEX,SEA,ARL02,3,7,10
TEX200209240,2002,20924,TEX,ANA,ARL02,1,2,3
TEX200209250,2002,20925,TEX,ANA,ARL02,3,4,7
TEX200209260,2002,20926,TEX,ANA,ARL02,10,5,15
TEX200209270,2002,20927,TEX,OAK,ARL02,3,2,5
TEX200209280,2002,20928,TEX,OAK,ARL02,10,8,18
TEX200209290,2002,20929,TEX,OAK,ARL02,8,7,15
TEX200304040,2003,30404,TEX,SEA,ARL02,6,4,10
TEX200304050,2003,30405,TEX,SEA,ARL02,4,8,12
TEX200304060,2003,30406,TEX,SEA,ARL02,11,2,13
TEX200304080,2003,30408,TEX,OAK,ARL02,2,1,3
TEX200304090,2003,30409,TEX,OAK,ARL02,13,5,18
TEX200304100,2003,30410,TEX,OAK,ARL02,4,5,9
TEX200304140,2003,30414,TEX,ANA,ARL02,0,4,4
TEX200304150,2003,30415,TEX,ANA,ARL02,4,5,9
TEX200304160,2003,30416,TEX,ANA,ARL02,9,8,17
TEX200304170,2003,30417,TEX,ANA,ARL02,7,9,16
TEX200304220,2003,30422,TEX,BOS,ARL02,5,4,9
TEX200304230,2003,30423,TEX,BOS,ARL02,1,6,7
TEX200304240,2003,30424,TEX,BOS,ARL02,5,16,21
TEX200304250,2003,30425,TEX,NYA,ARL02,3,2,5
TEX200304260,2003,30426,TEX,NYA,ARL02,7,5,12
TEX200304270,2003,30427,TEX,NYA,ARL02,7,10,17
TEX200305060,2003,30506,TEX,TOR,ARL02,15,5,20
TEX200305070,2003,30507,TEX,TOR,ARL02,4,5,9
TEX200305080,2003,30508,TEX,TOR,ARL02,8,6,14
TEX200305090,2003,30509,TEX,CLE,ARL02,9,5,14
TEX200305100,2003,30510,TEX,CLE,ARL02,6,4,10
TEX200305110,2003,30511,TEX,CLE,ARL02,10,17,27
TEX200305200,2003,30520,TEX,TBA,ARL02,2,5,7
TEX200305210,2003,30521,TEX,TBA,ARL02,7,8,15
TEX200305220,2003,30522,TEX,TBA,ARL02,8,10,18
TEX200305230,2003,30523,TEX,BAL,ARL02,3,5,8
TEX200305240,2003,30524,TEX,BAL,ARL02,10,3,13
TEX200305250,2003,30525,TEX,BAL,ARL02,13,10,23
TEX200306100,2003,30610,TEX,NYN,ARL02,7,9,16
TEX200306110,2003,30611,TEX,NYN,ARL02,8,2,10
TEX200306120,2003,30612,TEX,NYN,ARL02,11,0,11
TEX200306130,2003,30613,TEX,FLO,ARL02,8,0,8
TEX200306140,2003,30614,TEX,FLO,ARL02,2,13,15
TEX200306150,2003,30615,TEX,FLO,ARL02,10,4,14
TEX200306200,2003,30620,TEX,HOU,ARL02,12,3,15
TEX200306210,2003,30621,TEX,HOU,ARL02,9,5,14
TEX200306220,2003,30622,TEX,HOU,ARL02,3,1,4
TEX200306230,2003,30623,TEX,OAK,ARL02,3,1,4
TEX200306240,2003,30624,TEX,OAK,ARL02,6,7,13
TEX200306250,2003,30625,TEX,OAK,ARL02,8,9,17
TEX200306260,2003,30626,TEX,OAK,ARL02,13,0,13
TEX200307040,2003,30704,TEX,SEA,ARL02,3,7,10
TEX200307050,2003,30705,TEX,SEA,ARL02,3,2,5
TEX200307060,2003,30706,TEX,SEA,ARL02,1,5,6
TEX200307080,2003,30708,TEX,MIN,ARL02,6,8,14
TEX200307090,2003,30709,TEX,MIN,ARL02,1,4,5
TEX200307100,2003,30710,TEX,MIN,ARL02,4,9,13
TEX200307110,2003,30711,TEX,KCA,ARL02,13,3,16
TEX200307120,2003,30712,TEX,KCA,ARL02,8,2,10
TEX200307130,2003,30713,TEX,KCA,ARL02,8,2,10
TEX200307230,2003,30723,TEX,ANA,ARL02,9,12,21
TEX200307240,2003,30724,TEX,ANA,ARL02,10,6,16
TEX200307290,2003,30729,TEX,BOS,ARL02,14,7,21
TEX200307300,2003,30730,TEX,BOS,ARL02,2,9,11
TEX200307310,2003,30731,TEX,BOS,ARL02,3,7,10
TEX200308010,2003,30801,TEX,CLE,ARL02,3,10,13
TEX200308020,2003,30802,TEX,CLE,ARL02,7,9,16
TEX200308030,2003,30803,TEX,CLE,ARL02,5,8,13
TEX200308110,2003,30811,TEX,DET,ARL02,3,9,12
TEX200308120,2003,30812,TEX,DET,ARL02,7,4,11
TEX200308130,2003,30813,TEX,DET,ARL02,3,7,10
TEX200308140,2003,30814,TEX,DET,ARL02,3,6,9
TEX200308150,2003,30815,TEX,CHA,ARL02,5,11,16
TEX200308160,2003,30816,TEX,CHA,ARL02,8,12,20
TEX200308170,2003,30817,TEX,CHA,ARL02,4,6,10
TEX200308290,2003,30829,TEX,MIN,ARL02,8,5,13
TEX200308300,2003,30830,TEX,MIN,ARL02,2,0,2
TEX200308310,2003,30831,TEX,MIN,ARL02,10,11,21
TEX200309010,2003,30901,TEX,KCA,ARL02,3,7,10
TEX200309020,2003,30902,TEX,KCA,ARL02,7,8,15
TEX200309030,2003,30903,TEX,KCA,ARL02,3,1,4
TEX200309120,2003,30912,TEX,OAK,ARL02,9,3,12
TEX200309130,2003,30913,TEX,OAK,ARL02,9,3,12
TEX200309140,2003,30914,TEX,OAK,ARL02,6,5,11
TEX200309150,2003,30915,TEX,SEA,ARL02,4,6,10
TEX200309160,2003,30916,TEX,SEA,ARL02,5,10,15
TEX200309170,2003,30917,TEX,SEA,ARL02,5,1,6
TEX200309180,2003,30918,TEX,SEA,ARL02,1,2,3
TEX200309190,2003,30919,TEX,ANA,ARL02,2,3,5
TEX200309200,2003,30920,TEX,ANA,ARL02,4,13,17
TEX200309210,2003,30921,TEX,ANA,ARL02,11,6,17
TEX200404090,2004,40409,TEX,ANA,ARL02,4,12,16
TEX200404100,2004,40410,TEX,ANA,ARL02,6,12,18
TEX200404110,2004,40411,TEX,ANA,ARL02,7,2,9
TEX200404120,2004,40412,TEX,ANA,ARL02,6,7,13
TEX200404130,2004,40413,TEX,OAK,ARL02,10,9,19
TEX200404140,2004,40414,TEX,OAK,ARL02,9,4,13
TEX200404150,2004,40415,TEX,OAK,ARL02,2,7,9
TEX200404230,2004,40423,TEX,SEA,ARL02,8,10,18
TEX200404240,2004,40424,TEX,SEA,ARL02,0,3,3
TEX200404250,2004,40425,TEX,SEA,ARL02,6,14,20
TEX200405011,2004,40501,TEX,BOS,ARL02,3,4,7
TEX200405012,2004,40501,TEX,BOS,ARL02,5,8,13
TEX200405020,2004,40502,TEX,BOS,ARL02,1,4,5
TEX200405030,2004,40503,TEX,TBA,ARL02,0,9,9
TEX200405040,2004,40504,TEX,TBA,ARL02,5,4,9
TEX200405050,2004,40505,TEX,TBA,ARL02,1,6,7
TEX200405070,2004,40507,TEX,DET,ARL02,8,7,15
TEX200405080,2004,40508,TEX,DET,ARL02,15,16,31
TEX200405090,2004,40509,TEX,DET,ARL02,5,3,8
TEX200405180,2004,40518,TEX,KCA,ARL02,7,6,13
TEX200405190,2004,40519,TEX,KCA,ARL02,5,3,8
TEX200405200,2004,40520,TEX,KCA,ARL02,3,6,9
TEX200405210,2004,40521,TEX,NYA,ARL02,7,9,16
TEX200405220,2004,40522,TEX,NYA,ARL02,3,4,7
TEX200405230,2004,40523,TEX,NYA,ARL02,8,3,11
TEX200406070,2004,40607,TEX,PIT,ARL02,5,6,11
TEX200406101,2004,40610,TEX,PIT,ARL02,7,9,16
TEX200406102,2004,40610,TEX,PIT,ARL02,4,10,14
TEX200406110,2004,40611,TEX,SLN,ARL02,12,7,19
TEX200406120,2004,40612,TEX,SLN,ARL02,2,7,9
TEX200406130,2004,40613,TEX,SLN,ARL02,13,2,15
TEX200406220,2004,40622,TEX,SEA,ARL02,2,10,12
TEX200406230,2004,40623,TEX,SEA,ARL02,3,6,9
TEX200406240,2004,40624,TEX,SEA,ARL02,7,9,16
TEX200406250,2004,40625,TEX,HOU,ARL02,1,3,4
TEX200406260,2004,40626,TEX,HOU,ARL02,7,8,15
TEX200406270,2004,40627,TEX,HOU,ARL02,1,0,1
TEX200407160,2004,40716,TEX,TOR,ARL02,2,11,13
TEX200407170,2004,40717,TEX,TOR,ARL02,0,4,4
TEX200407180,2004,40718,TEX,TOR,ARL02,5,7,12
TEX200407190,2004,40719,TEX,CHA,ARL02,12,6,18
TEX200407200,2004,40720,TEX,CHA,ARL02,4,6,10
TEX200407210,2004,40721,TEX,ANA,ARL02,2,3,5
TEX200407220,2004,40722,TEX,ANA,ARL02,11,1,12
TEX200407290,2004,40729,TEX,OAK,ARL02,7,6,13
TEX200407300,2004,40730,TEX,OAK,ARL02,5,7,12
TEX200407310,2004,40731,TEX,OAK,ARL02,9,4,13
TEX200408010,2004,40801,TEX,OAK,ARL02,4,1,5
TEX200408100,2004,40810,TEX,NYA,ARL02,1,7,8
TEX200408110,2004,40811,TEX,NYA,ARL02,4,2,6
TEX200408120,2004,40812,TEX,NYA,ARL02,5,1,6
TEX200408130,2004,40813,TEX,TBA,ARL02,3,5,8
TEX200408140,2004,40814,TEX,TBA,ARL02,5,6,11
TEX200408150,2004,40815,TEX,TBA,ARL02,2,6,8
TEX200408160,2004,40816,TEX,CLE,ARL02,2,5,7
TEX200408170,2004,40817,TEX,CLE,ARL02,4,16,20
TEX200408180,2004,40818,TEX,CLE,ARL02,2,5,7
TEX200408230,2004,40823,TEX,MIN,ARL02,7,4,11
TEX200408240,2004,40824,TEX,MIN,ARL02,4,5,9
TEX200408250,2004,40825,TEX,MIN,ARL02,8,5,13
TEX200408260,2004,40826,TEX,MIN,ARL02,3,8,11
TEX200408270,2004,40827,TEX,BAL,ARL02,4,6,10
TEX200408280,2004,40828,TEX,BAL,ARL02,3,4,7
TEX200408290,2004,40829,TEX,BAL,ARL02,7,6,13
TEX200409060,2004,40906,TEX,CHA,ARL02,7,4,11
TEX200409070,2004,40907,TEX,CHA,ARL02,3,10,13
TEX200409080,2004,40908,TEX,CHA,ARL02,5,2,7
TEX200409090,2004,40909,TEX,CHA,ARL02,7,3,10
TEX200409100,2004,40910,TEX,TOR,ARL02,3,10,13
TEX200409110,2004,40911,TEX,TOR,ARL02,7,10,17
TEX200409120,2004,40912,TEX,TOR,ARL02,6,7,13
TEX200409210,2004,40921,TEX,OAK,ARL02,4,9,13
TEX200409220,2004,40922,TEX,OAK,ARL02,3,5,8
TEX200409230,2004,40923,TEX,OAK,ARL02,4,5,9
TEX200409240,2004,40924,TEX,SEA,ARL02,8,7,15
TEX200409250,2004,40925,TEX,SEA,ARL02,4,5,9
TEX200409260,2004,40926,TEX,SEA,ARL02,9,0,9
TEX200409270,2004,40927,TEX,ANA,ARL02,5,3,8
TEX200409280,2004,40928,TEX,ANA,ARL02,8,2,10
TEX200409290,2004,40929,TEX,ANA,ARL02,8,7,15
TEX200409300,2004,40930,TEX,ANA,ARL02,3,6,9
TEX200504110,2005,50411,TEX,ANA,ARL02,7,6,13
TEX200504120,2005,50412,TEX,ANA,ARL02,13,8,21
TEX200504130,2005,50413,TEX,ANA,ARL02,5,7,12
TEX200504140,2005,50414,TEX,TOR,ARL02,2,1,3
TEX200504150,2005,50415,TEX,TOR,ARL02,2,4,6
TEX200504160,2005,50416,TEX,TOR,ARL02,8,0,8
TEX200504170,2005,50417,TEX,TOR,ARL02,5,6,11
TEX200504180,2005,50418,TEX,OAK,ARL02,8,5,13
TEX200504190,2005,50419,TEX,OAK,ARL02,0,3,3
TEX200504260,2005,50426,TEX,SEA,ARL02,7,4,11
TEX200504270,2005,50427,TEX,SEA,ARL02,2,8,10
TEX200504280,2005,50428,TEX,SEA,ARL02,4,1,5
TEX200504290,2005,50429,TEX,BOS,ARL02,2,7,9
TEX200504300,2005,50430,TEX,BOS,ARL02,9,2,11
TEX200505010,2005,50501,TEX,BOS,ARL02,6,5,11
TEX200505060,2005,50506,TEX,CLE,ARL02,8,6,14
TEX200505070,2005,50507,TEX,CLE,ARL02,1,6,7
TEX200505080,2005,50508,TEX,CLE,ARL02,2,7,9
TEX200505090,2005,50509,TEX,DET,ARL02,2,0,2
TEX200505100,2005,50510,TEX,DET,ARL02,4,5,9
TEX200505110,2005,50511,TEX,DET,ARL02,6,5,11
TEX200505200,2005,50520,TEX,HOU,ARL02,3,7,10
TEX200505210,2005,50521,TEX,HOU,ARL02,3,18,21
TEX200505220,2005,50522,TEX,HOU,ARL02,0,2,2
TEX200505240,2005,50524,TEX,KCA,ARL02,3,4,7
TEX200505250,2005,50525,TEX,KCA,ARL02,3,7,10
TEX200505260,2005,50526,TEX,KCA,ARL02,1,8,9
TEX200505270,2005,50527,TEX,CHA,ARL02,2,6,8
TEX200505290,2005,50529,TEX,CHA,ARL02,4,12,16
TEX200506130,2005,50613,TEX,ATL,ARL02,3,7,10
TEX200506140,2005,50614,TEX,ATL,ARL02,7,2,9
TEX200506150,2005,50615,TEX,ATL,ARL02,5,9,14
TEX200506170,2005,50617,TEX,WAS,ARL02,1,8,9
TEX200506180,2005,50618,TEX,WAS,ARL02,4,7,11
TEX200506190,2005,50619,TEX,WAS,ARL02,8,2,10
TEX200506270,2005,50627,TEX,ANA,ARL02,13,3,16
TEX200506280,2005,50628,TEX,ANA,ARL02,5,1,6
TEX200506290,2005,50629,TEX,ANA,ARL02,6,7,13
TEX200506300,2005,50630,TEX,ANA,ARL02,5,18,23
TEX200507040,2005,50704,TEX,BOS,ARL02,5,6,11
TEX200507050,2005,50705,TEX,BOS,ARL02,7,4,11
TEX200507060,2005,50706,TEX,BOS,ARL02,7,4,11
TEX200507080,2005,50708,TEX,TOR,ARL02,6,7,13
TEX200507090,2005,50709,TEX,TOR,ARL02,10,12,22
TEX200507100,2005,50710,TEX,TOR,ARL02,8,9,17
TEX200507180,2005,50718,TEX,NYA,ARL02,11,10,21
TEX200507190,2005,50719,TEX,NYA,ARL02,1,2,3
TEX200507200,2005,50720,TEX,NYA,ARL02,8,4,12
TEX200507210,2005,50721,TEX,OAK,ARL02,6,4,10
TEX200507220,2005,50722,TEX,OAK,ARL02,11,10,21
TEX200507230,2005,50723,TEX,OAK,ARL02,5,4,9
TEX200507240,2005,50724,TEX,OAK,ARL02,8,3,11
TEX200508020,2005,50802,TEX,TBA,ARL02,10,8,18
TEX200508030,2005,50803,TEX,TBA,ARL02,8,5,13
TEX200508040,2005,50804,TEX,TBA,ARL02,5,13,18
TEX200508050,2005,50805,TEX,BAL,ARL02,10,5,15
TEX200508060,2005,50806,TEX,BAL,ARL02,3,10,13
TEX200508070,2005,50807,TEX,BAL,ARL02,3,9,12
TEX200508230,2005,50823,TEX,SEA,ARL02,4,6,10
TEX200508240,2005,50824,TEX,SEA,ARL02,1,8,9
TEX200508250,2005,50825,TEX,SEA,ARL02,8,2,10
TEX200508260,2005,50826,TEX,MIN,ARL02,0,6,6
TEX200508270,2005,50827,TEX,MIN,ARL02,7,2,9
TEX200508280,2005,50828,TEX,MIN,ARL02,1,2,3
TEX200508290,2005,50829,TEX,CHA,ARL02,5,7,12
TEX200508301,2005,50830,TEX,CHA,ARL02,6,8,14
TEX200508302,2005,50830,TEX,CHA,ARL02,8,0,8
TEX200508310,2005,50831,TEX,CHA,ARL02,2,9,11
TEX200509090,2005,50909,TEX,OAK,ARL02,9,8,17
TEX200509100,2005,50910,TEX,OAK,ARL02,5,4,9
TEX200509110,2005,50911,TEX,OAK,ARL02,4,7,11
TEX200509120,2005,50912,TEX,BAL,ARL02,4,2,6
TEX200509130,2005,50913,TEX,BAL,ARL02,4,3,7
TEX200509140,2005,50914,TEX,BAL,ARL02,6,7,13
TEX200509150,2005,50915,TEX,SEA,ARL02,3,4,7
TEX200509160,2005,50916,TEX,SEA,ARL02,3,5,8
TEX200509170,2005,50917,TEX,SEA,ARL02,6,7,13
TEX200509180,2005,50918,TEX,SEA,ARL02,6,8,14
TEX200509300,2005,50930,TEX,ANA,ARL02,7,1,8
TEX200510010,2005,51001,TEX,ANA,ARL02,7,6,13
TEX200510020,2005,51002,TEX,ANA,ARL02,7,4,11
TEX200604030,2006,60403,TEX,BOS,ARL02,7,3,10
TEX200604040,2006,60404,TEX,BOS,ARL02,4,10,14
TEX200604050,2006,60405,TEX,BOS,ARL02,2,1,3
TEX200604060,2006,60406,TEX,DET,ARL02,10,6,16
TEX200604070,2006,60407,TEX,DET,ARL02,5,2,7
TEX200604080,2006,60408,TEX,DET,ARL02,7,0,7
TEX200604090,2006,60409,TEX,DET,ARL02,3,5,8
TEX200604210,2006,60421,TEX,TBA,ARL02,7,13,20
TEX200604220,2006,60422,TEX,TBA,ARL02,5,6,11
TEX200604230,2006,60423,TEX,TBA,ARL02,3,8,11
TEX200604240,2006,60424,TEX,OAK,ARL02,3,2,5
TEX200604250,2006,60425,TEX,OAK,ARL02,5,6,11
TEX200604260,2006,60426,TEX,OAK,ARL02,6,4,10
TEX200605030,2006,60503,TEX,BAL,ARL02,1,2,3
TEX200605040,2006,60504,TEX,BAL,ARL02,2,8,10
TEX200605050,2006,60505,TEX,NYA,ARL02,8,7,15
TEX200605060,2006,60506,TEX,NYA,ARL02,6,1,7
TEX200605070,2006,60507,TEX,NYA,ARL02,8,5,13
TEX200605080,2006,60508,TEX,MIN,ARL02,4,6,10
TEX200605090,2006,60509,TEX,MIN,ARL02,15,5,20
TEX200605100,2006,60510,TEX,MIN,ARL02,4,3,7
TEX200605220,2006,60522,TEX,ANA,ARL02,2,3,5
TEX200605230,2006,60523,TEX,ANA,ARL02,7,6,13
TEX200605240,2006,60524,TEX,ANA,ARL02,8,5,13
TEX200605250,2006,60525,TEX,OAK,ARL02,7,8,15
TEX200605260,2006,60526,TEX,OAK,ARL02,3,5,8
TEX200605270,2006,60527,TEX,OAK,ARL02,6,3,9
TEX200605280,2006,60528,TEX,OAK,ARL02,3,4,7
TEX200605290,2006,60529,TEX,SEA,ARL02,0,2,2
TEX200605300,2006,60530,TEX,SEA,ARL02,4,6,10
TEX200605310,2006,60531,TEX,SEA,ARL02,14,5,19
TEX200606120,2006,60612,TEX,CHA,ARL02,8,3,11
TEX200606130,2006,60613,TEX,CHA,ARL02,5,2,7
TEX200606140,2006,60614,TEX,CHA,ARL02,0,8,8
TEX200606150,2006,60615,TEX,CHA,ARL02,8,2,10
TEX200606160,2006,60616,TEX,ARI,ARL02,3,5,8
TEX200606170,2006,60617,TEX,ARI,ARL02,4,8,12
TEX200606180,2006,60618,TEX,ARI,ARL02,7,10,17
TEX200606200,2006,60620,TEX,SDN,ARL02,6,5,11
TEX200606210,2006,60621,TEX,SDN,ARL02,3,2,5
TEX200606220,2006,60622,TEX,SDN,ARL02,3,5,8
TEX200606300,2006,60630,TEX,HOU,ARL02,1,3,4
TEX200607010,2006,60701,TEX,HOU,ARL02,7,0,7
TEX200607020,2006,60702,TEX,HOU,ARL02,9,5,14
TEX200607030,2006,60703,TEX,TOR,ARL02,1,6,7
TEX200607040,2006,60704,TEX,TOR,ARL02,3,2,5
TEX200607050,2006,60705,TEX,TOR,ARL02,3,9,12
TEX200607070,2006,60707,TEX,MIN,ARL02,4,9,13
TEX200607080,2006,60708,TEX,MIN,ARL02,4,0,4
TEX200607090,2006,60709,TEX,MIN,ARL02,2,5,7
TEX200607240,2006,60724,TEX,NYA,ARL02,6,2,8
TEX200607250,2006,60725,TEX,NYA,ARL02,7,4,11
TEX200607260,2006,60726,TEX,NYA,ARL02,8,7,15
TEX200607280,2006,60728,TEX,KCA,ARL02,11,3,14
TEX200607290,2006,60729,TEX,KCA,ARL02,5,3,8
TEX200607300,2006,60730,TEX,KCA,ARL02,2,15,17
TEX200608100,2006,60810,TEX,SEA,ARL02,2,8,10
TEX200608110,2006,60811,TEX,SEA,ARL02,7,14,21
TEX200608120,2006,60812,TEX,SEA,ARL02,4,5,9
TEX200608130,2006,60813,TEX,SEA,ARL02,6,10,16
TEX200608150,2006,60815,TEX,ANA,ARL02,9,7,16
TEX200608160,2006,60816,TEX,ANA,ARL02,3,9,12
TEX200608250,2006,60825,TEX,OAK,ARL02,9,3,12
TEX200608260,2006,60826,TEX,OAK,ARL02,5,3,8
TEX200608270,2006,60827,TEX,OAK,ARL02,0,3,3
TEX200608290,2006,60829,TEX,BAL,ARL02,4,9,13
TEX200608300,2006,60830,TEX,BAL,ARL02,7,4,11
TEX200608310,2006,60831,TEX,BAL,ARL02,5,7,12
TEX200609010,2006,60901,TEX,CLE,ARL02,7,2,9
TEX200609020,2006,60902,TEX,CLE,ARL02,6,5,11
TEX200609030,2006,60903,TEX,CLE,ARL02,2,5,7
TEX200609140,2006,60914,TEX,ANA,ARL02,2,1,3
TEX200609150,2006,60915,TEX,ANA,ARL02,2,1,3
TEX200609160,2006,60916,TEX,ANA,ARL02,6,12,18
TEX200609170,2006,60917,TEX,ANA,ARL02,1,8,9
TEX200609180,2006,60918,TEX,SEA,ARL02,1,8,9
TEX200609190,2006,60919,TEX,SEA,ARL02,9,7,16
TEX200609200,2006,60920,TEX,SEA,ARL02,6,3,9
TEX200609220,2006,60922,TEX,CLE,ARL02,4,12,16
TEX200609230,2006,60923,TEX,CLE,ARL02,6,3,9
TEX200609240,2006,60924,TEX,CLE,ARL02,11,6,17
TEX200704060,2007,70406,TEX,BOS,ARL02,0,2,2
TEX200704070,2007,70407,TEX,BOS,ARL02,4,8,12
TEX200704080,2007,70408,TEX,BOS,ARL02,3,2,5
TEX200704090,2007,70409,TEX,TBA,ARL02,4,8,12
TEX200704100,2007,70410,TEX,TBA,ARL02,9,12,21
TEX200704110,2007,70411,TEX,TBA,ARL02,6,5,11
TEX200704200,2007,70420,TEX,OAK,ARL02,16,4,20
TEX200704210,2007,70421,TEX,OAK,ARL02,0,7,7
TEX200704220,2007,70422,TEX,OAK,ARL02,3,4,7
TEX200704230,2007,70423,TEX,SEA,ARL02,5,4,9
TEX200705010,2007,70501,TEX,NYA,ARL02,10,1,11
TEX200705031,2007,70503,TEX,NYA,ARL02,4,3,7
TEX200705032,2007,70503,TEX,NYA,ARL02,5,2,7
TEX200705040,2007,70504,TEX,TOR,ARL02,1,7,8
TEX200705050,2007,70505,TEX,TOR,ARL02,4,11,15
TEX200705060,2007,70506,TEX,TOR,ARL02,2,3,5
TEX200705110,2007,70511,TEX,ANA,ARL02,6,3,9
TEX200705120,2007,70512,TEX,ANA,ARL02,6,3,9
TEX200705130,2007,70513,TEX,ANA,ARL02,6,7,13
TEX200705140,2007,70514,TEX,ANA,ARL02,7,2,9
TEX200705210,2007,70521,TEX,MIN,ARL02,4,14,18
TEX200705220,2007,70522,TEX,MIN,ARL02,7,1,8
TEX200705230,2007,70523,TEX,MIN,ARL02,5,3,8
TEX200705250,2007,70525,TEX,BOS,ARL02,10,6,16
TEX200705260,2007,70526,TEX,BOS,ARL02,7,4,11
TEX200705270,2007,70527,TEX,BOS,ARL02,6,5,11
TEX200706050,2007,70605,TEX,DET,ARL02,4,7,11
TEX200706060,2007,70606,TEX,DET,ARL02,10,0,10
TEX200706070,2007,70607,TEX,DET,ARL02,11,4,15
TEX200706080,2007,70608,TEX,MIL,ARL02,6,9,15
TEX200706090,2007,70609,TEX,MIL,ARL02,3,4,7
TEX200706100,2007,70610,TEX,MIL,ARL02,9,6,15
TEX200706190,2007,70619,TEX,CHN,ARL02,5,4,9
TEX200706200,2007,70620,TEX,CHN,ARL02,3,7,10
TEX200706210,2007,70621,TEX,CHN,ARL02,5,6,11
TEX200706220,2007,70622,TEX,HOU,ARL02,3,11,14
TEX200706230,2007,70623,TEX,HOU,ARL02,2,7,9
TEX200706240,2007,70624,TEX,HOU,ARL02,12,9,21
TEX200707030,2007,70703,TEX,ANA,ARL02,3,8,11
TEX200707040,2007,70704,TEX,ANA,ARL02,2,4,6
TEX200707050,2007,70705,TEX,ANA,ARL02,5,2,7
TEX200707060,2007,70706,TEX,BAL,ARL02,3,4,7
TEX200707070,2007,70707,TEX,BAL,ARL02,3,0,3
TEX200707080,2007,70708,TEX,BAL,ARL02,1,2,3
TEX200707190,2007,70719,TEX,CLE,ARL02,7,5,12
TEX200707200,2007,70720,TEX,CLE,ARL02,3,2,5
TEX200707210,2007,70721,TEX,CLE,ARL02,5,8,13
TEX200707220,2007,70722,TEX,CLE,ARL02,8,3,11
TEX200707230,2007,70723,TEX,SEA,ARL02,7,8,15
TEX200707241,2007,70724,TEX,SEA,ARL02,1,2,3
TEX200707242,2007,70724,TEX,SEA,ARL02,3,4,7
TEX200707250,2007,70725,TEX,SEA,ARL02,6,7,13
TEX200708060,2007,70806,TEX,OAK,ARL02,9,7,16
TEX200708070,2007,70807,TEX,OAK,ARL02,6,8,14
TEX200708080,2007,70808,TEX,OAK,ARL02,6,3,9
TEX200708100,2007,70810,TEX,TBA,ARL02,4,7,11
TEX200708110,2007,70811,TEX,TBA,ARL02,3,0,3
TEX200708120,2007,70812,TEX,TBA,ARL02,1,9,10
TEX200708140,2007,70814,TEX,KCA,ARL02,3,5,8
TEX200708150,2007,70815,TEX,KCA,ARL02,3,4,7
TEX200708160,2007,70816,TEX,KCA,ARL02,6,2,8
TEX200708230,2007,70823,TEX,SEA,ARL02,9,4,13
TEX200708240,2007,70824,TEX,SEA,ARL02,4,2,6
TEX200708250,2007,70825,TEX,SEA,ARL02,3,5,8
TEX200708260,2007,70826,TEX,SEA,ARL02,3,5,8
TEX200708280,2007,70828,TEX,CHA,ARL02,3,4,7
TEX200708290,2007,70829,TEX,CHA,ARL02,4,5,9
TEX200708300,2007,70830,TEX,CHA,ARL02,1,5,6
TEX200709030,2007,70903,TEX,KCA,ARL02,8,1,9
TEX200709040,2007,70904,TEX,KCA,ARL02,8,9,17
TEX200709050,2007,70905,TEX,KCA,ARL02,2,3,5
TEX200709070,2007,70907,TEX,OAK,ARL02,3,5,8
TEX200709080,2007,70908,TEX,OAK,ARL02,3,7,10
TEX200709090,2007,70909,TEX,OAK,ARL02,9,12,21
TEX200709200,2007,70920,TEX,BAL,ARL02,6,3,9
TEX200709210,2007,70921,TEX,BAL,ARL02,2,3,5
TEX200709220,2007,70922,TEX,BAL,ARL02,11,9,20
TEX200709230,2007,70923,TEX,BAL,ARL02,0,3,3
TEX200709240,2007,70924,TEX,ANA,ARL02,7,8,15
TEX200709250,2007,70925,TEX,ANA,ARL02,1,3,4
TEX200709260,2007,70926,TEX,ANA,ARL02,2,16,18
TEX200804080,2008,80408,TEX,BAL,ARL02,8,1,9
TEX200804101,2008,80410,TEX,BAL,ARL02,1,3,4
TEX200804102,2008,80410,TEX,BAL,ARL02,4,5,9
TEX200804110,2008,80411,TEX,TOR,ARL02,8,5,13
TEX200804120,2008,80412,TEX,TOR,ARL02,4,1,5
TEX200804130,2008,80413,TEX,TOR,ARL02,5,4,9
TEX200804140,2008,80414,TEX,ANA,ARL02,7,4,11
TEX200804150,2008,80415,TEX,ANA,ARL02,7,4,11
TEX200804250,2008,80425,TEX,MIN,ARL02,5,6,11
TEX200804260,2008,80426,TEX,MIN,ARL02,12,6,18
TEX200804270,2008,80427,TEX,MIN,ARL02,0,10,10
TEX200804290,2008,80429,TEX,KCA,ARL02,9,5,14
TEX200804300,2008,80430,TEX,KCA,ARL02,9,11,20
TEX200805010,2008,80501,TEX,KCA,ARL02,1,2,3
TEX200805090,2008,80509,TEX,OAK,ARL02,0,4,4
TEX200805100,2008,80510,TEX,OAK,ARL02,4,6,10
TEX200805110,2008,80511,TEX,OAK,ARL02,12,6,18
TEX200805120,2008,80512,TEX,SEA,ARL02,12,13,25
TEX200805130,2008,80513,TEX,SEA,ARL02,2,5,7
TEX200805140,2008,80514,TEX,SEA,ARL02,4,3,7
TEX200805160,2008,80516,TEX,HOU,ARL02,8,16,24
TEX200805170,2008,80517,TEX,HOU,ARL02,2,6,8
TEX200805180,2008,80518,TEX,HOU,ARL02,5,4,9
TEX200805300,2008,80530,TEX,OAK,ARL02,1,3,4
TEX200805310,2008,80531,TEX,OAK,ARL02,4,8,12
TEX200806010,2008,80601,TEX,OAK,ARL02,13,8,21
TEX200806020,2008,80602,TEX,CLE,ARL02,13,9,22
TEX200806030,2008,80603,TEX,CLE,ARL02,7,12,19
TEX200806040,2008,80604,TEX,CLE,ARL02,15,9,24
TEX200806050,2008,80605,TEX,CLE,ARL02,4,9,13
TEX200806060,2008,80606,TEX,TBA,ARL02,12,4,16
TEX200806070,2008,80607,TEX,TBA,ARL02,5,4,9
TEX200806080,2008,80608,TEX,TBA,ARL02,3,6,9
TEX200806170,2008,80617,TEX,ATL,ARL02,5,7,12
TEX200806180,2008,80618,TEX,ATL,ARL02,5,2,7
TEX200806190,2008,80619,TEX,ATL,ARL02,4,5,9
TEX200806270,2008,80627,TEX,PHI,ARL02,7,8,15
TEX200806280,2008,80628,TEX,PHI,ARL02,8,6,14
TEX200806290,2008,80629,TEX,PHI,ARL02,1,5,6
TEX200807070,2008,80707,TEX,ANA,ARL02,9,6,15
TEX200807080,2008,80708,TEX,ANA,ARL02,2,3,5
TEX200807090,2008,80709,TEX,ANA,ARL02,4,5,9
TEX200807100,2008,80710,TEX,ANA,ARL02,11,10,21
TEX200807110,2008,80711,TEX,CHA,ARL02,2,7,9
TEX200807120,2008,80712,TEX,CHA,ARL02,9,7,16
TEX200807130,2008,80713,TEX,CHA,ARL02,11,12,23
TEX200807280,2008,80728,TEX,SEA,ARL02,7,5,12
TEX200807290,2008,80729,TEX,SEA,ARL02,10,11,21
TEX200807300,2008,80730,TEX,SEA,ARL02,3,4,7
TEX200807310,2008,80731,TEX,SEA,ARL02,8,5,13
TEX200808010,2008,80801,TEX,TOR,ARL02,8,9,17
TEX200808020,2008,80802,TEX,TOR,ARL02,6,4,10
TEX200808030,2008,80803,TEX,TOR,ARL02,4,8,12
TEX200808040,2008,80804,TEX,NYA,ARL02,5,9,14
TEX200808050,2008,80805,TEX,NYA,ARL02,6,8,14
TEX200808060,2008,80806,TEX,NYA,ARL02,5,3,8
TEX200808070,2008,80807,TEX,NYA,ARL02,3,0,3
TEX200808150,2008,80815,TEX,TBA,ARL02,7,0,7
TEX200808160,2008,80816,TEX,TBA,ARL02,0,3,3
TEX200808170,2008,80817,TEX,TBA,ARL02,7,4,11
TEX200808180,2008,80818,TEX,DET,ARL02,8,7,15
TEX200808190,2008,80819,TEX,DET,ARL02,11,3,14
TEX200808200,2008,80820,TEX,DET,ARL02,1,9,10
TEX200808220,2008,80822,TEX,CLE,ARL02,7,5,12
TEX200808230,2008,80823,TEX,CLE,ARL02,8,7,15
TEX200808240,2008,80824,TEX,CLE,ARL02,4,3,7
TEX200809010,2008,80901,TEX,SEA,ARL02,12,6,18
TEX200809020,2008,80902,TEX,SEA,ARL02,4,6,10
TEX200809030,2008,80903,TEX,SEA,ARL02,0,1,1
TEX200809050,2008,80905,TEX,BOS,ARL02,8,1,9
TEX200809060,2008,80906,TEX,BOS,ARL02,8,15,23
TEX200809070,2008,80907,TEX,BOS,ARL02,7,2,9
TEX200809150,2008,80915,TEX,DET,ARL02,8,11,19
TEX200809160,2008,80916,TEX,DET,ARL02,4,5,9
TEX200809170,2008,80917,TEX,DET,ARL02,17,4,21
TEX200809190,2008,80919,TEX,ANA,ARL02,15,13,28
TEX200809200,2008,80920,TEX,ANA,ARL02,7,3,10
TEX200809210,2008,80921,TEX,ANA,ARL02,7,3,10
TEX200809220,2008,80922,TEX,OAK,ARL02,4,3,7
TEX200809230,2008,80923,TEX,OAK,ARL02,4,6,10
TEX200809240,2008,80924,TEX,OAK,ARL02,4,14,18
TEX200904060,2009,90406,TEX,CLE,ARL02,1,9,10
TEX200904080,2009,90408,TEX,CLE,ARL02,5,8,13
TEX200904090,2009,90409,TEX,CLE,ARL02,8,12,20
TEX200904130,2009,90413,TEX,BAL,ARL02,10,9,19
TEX200904140,2009,90414,TEX,BAL,ARL02,7,5,12
TEX200904150,2009,90415,TEX,BAL,ARL02,6,19,25
TEX200904170,2009,90417,TEX,KCA,ARL02,12,3,15
TEX200904180,2009,90418,TEX,KCA,ARL02,2,0,2
TEX200904190,2009,90419,TEX,KCA,ARL02,5,6,11
TEX200904280,2009,90428,TEX,OAK,ARL02,4,5,9
TEX200904300,2009,90430,TEX,OAK,ARL02,4,2,6
TEX200905010,2009,90501,TEX,CHA,ARL02,4,3,7
TEX200905020,2009,90502,TEX,CHA,ARL02,6,9,15
TEX200905030,2009,90503,TEX,CHA,ARL02,1,5,6
TEX200905120,2009,90512,TEX,SEA,ARL02,1,7,8
TEX200905130,2009,90513,TEX,SEA,ARL02,5,6,11
TEX200905140,2009,90514,TEX,SEA,ARL02,2,3,5
TEX200905150,2009,90515,TEX,ANA,ARL02,8,10,18
TEX200905160,2009,90516,TEX,ANA,ARL02,3,5,8
TEX200905170,2009,90517,TEX,ANA,ARL02,0,3,3
TEX200905250,2009,90525,TEX,NYA,ARL02,11,1,12
TEX200905260,2009,90526,TEX,NYA,ARL02,3,7,10
TEX200905270,2009,90527,TEX,NYA,ARL02,9,2,11
TEX200905291,2009,90529,TEX,OAK,ARL02,3,6,9
TEX200905292,2009,90529,TEX,OAK,ARL02,2,5,7
TEX200905300,2009,90530,TEX,OAK,ARL02,1,14,15
TEX200905310,2009,90531,TEX,OAK,ARL02,5,4,9
TEX200906080,2009,90608,TEX,TOR,ARL02,6,3,9
TEX200906090,2009,90609,TEX,TOR,ARL02,9,0,9
TEX200906110,2009,90611,TEX,TOR,ARL02,0,1,1
TEX200906120,2009,90612,TEX,LAN,ARL02,0,6,6
TEX200906130,2009,90613,TEX,LAN,ARL02,3,1,4
TEX200906140,2009,90614,TEX,LAN,ARL02,6,3,9
TEX200906160,2009,90616,TEX,HOU,ARL02,1,6,7
TEX200906170,2009,90617,TEX,HOU,ARL02,4,5,9
TEX200906180,2009,90618,TEX,HOU,ARL02,5,3,8
TEX200906260,2009,90626,TEX,SDN,ARL02,2,12,14
TEX200906270,2009,90627,TEX,SDN,ARL02,7,3,10
TEX200906280,2009,90628,TEX,SDN,ARL02,2,0,2
TEX200906290,2009,90629,TEX,ANA,ARL02,5,2,7
TEX200906300,2009,90630,TEX,ANA,ARL02,5,9,14
TEX200907010,2009,90701,TEX,ANA,ARL02,7,9,16
TEX200907030,2009,90703,TEX,TBA,ARL02,1,3,4
TEX200907040,2009,90704,TEX,TBA,ARL02,4,12,16
TEX200907050,2009,90705,TEX,TBA,ARL02,2,5,7
TEX200907170,2009,90717,TEX,MIN,ARL02,5,3,8
TEX200907180,2009,90718,TEX,MIN,ARL02,4,1,5
TEX200907190,2009,90719,TEX,MIN,ARL02,3,5,8
TEX200907200,2009,90720,TEX,BOS,ARL02,3,6,9
TEX200907210,2009,90721,TEX,BOS,ARL02,2,4,6
TEX200907220,2009,90722,TEX,BOS,ARL02,1,3,4
TEX200907270,2009,90727,TEX,DET,ARL02,2,5,7
TEX200907280,2009,90728,TEX,DET,ARL02,3,7,10
TEX200907290,2009,90729,TEX,DET,ARL02,13,5,18
TEX200907300,2009,90730,TEX,SEA,ARL02,1,7,8
TEX200907310,2009,90731,TEX,SEA,ARL02,4,5,9
TEX200908010,2009,90801,TEX,SEA,ARL02,7,2,9
TEX200908020,2009,90802,TEX,SEA,ARL02,2,4,6
TEX200908140,2009,90814,TEX,BOS,ARL02,8,4,12
TEX200908150,2009,90815,TEX,BOS,ARL02,2,7,9
TEX200908160,2009,90816,TEX,BOS,ARL02,3,4,7
TEX200908170,2009,90817,TEX,MIN,ARL02,5,8,13
TEX200908180,2009,90818,TEX,MIN,ARL02,9,6,15
TEX200908190,2009,90819,TEX,MIN,ARL02,5,4,9
TEX200908200,2009,90820,TEX,MIN,ARL02,1,11,12
TEX200908310,2009,90831,TEX,TOR,ARL02,18,10,28
TEX200909011,2009,90901,TEX,TOR,ARL02,2,5,7
TEX200909012,2009,90901,TEX,TOR,ARL02,2,5,7
TEX200909020,2009,90902,TEX,TOR,ARL02,4,6,10
TEX200909120,2009,90912,TEX,SEA,ARL02,8,3,11
TEX200909131,2009,90913,TEX,SEA,ARL02,2,7,9
TEX200909132,2009,90913,TEX,SEA,ARL02,5,0,5
TEX200909140,2009,90914,TEX,OAK,ARL02,9,0,9
TEX200909150,2009,90915,TEX,OAK,ARL02,6,1,7
TEX200909160,2009,90916,TEX,OAK,ARL02,4,0,4
TEX200909180,2009,90918,TEX,ANA,ARL02,2,0,2
TEX200909190,2009,90919,TEX,ANA,ARL02,2,3,5
TEX200909200,2009,90920,TEX,ANA,ARL02,10,5,15
TEX200909250,2009,90925,TEX,TBA,ARL02,3,8,11
TEX200909260,2009,90926,TEX,TBA,ARL02,3,15,18
TEX200909270,2009,90927,TEX,TBA,ARL02,7,6,13
TOR200004030,2000,403,TOR,KCA,TOR02,4,5,9
TOR200004040,2000,404,TOR,KCA,TOR02,3,6,9
TOR200004050,2000,405,TOR,KCA,TOR02,4,3,7
TOR200004060,2000,406,TOR,KCA,TOR02,9,3,12
TOR200004140,2000,414,TOR,SEA,TOR02,11,9,20
TOR200004150,2000,415,TOR,SEA,TOR02,17,6,23
TOR200004160,2000,416,TOR,SEA,TOR02,19,7,26
TOR200004170,2000,417,TOR,ANA,TOR02,1,7,8
TOR200004180,2000,418,TOR,ANA,TOR02,16,10,26
TOR200004190,2000,419,TOR,ANA,TOR02,4,12,16
TOR200004200,2000,420,TOR,ANA,TOR02,11,12,23
TOR200004210,2000,421,TOR,NYA,TOR02,3,8,11
TOR200004220,2000,422,TOR,NYA,TOR02,2,8,10
TOR200004230,2000,423,TOR,NYA,TOR02,10,7,17
TOR200005040,2000,504,TOR,CLE,TOR02,1,8,9
TOR200005050,2000,505,TOR,CLE,TOR02,10,11,21
TOR200005060,2000,506,TOR,CLE,TOR02,8,6,14
TOR200005070,2000,507,TOR,CLE,TOR02,10,8,18
TOR200005080,2000,508,TOR,BAL,TOR02,5,6,11
TOR200005090,2000,509,TOR,BAL,TOR02,4,6,10
TOR200005100,2000,510,TOR,BAL,TOR02,2,7,9
TOR200005150,2000,515,TOR,BOS,TOR02,8,1,9
TOR200005160,2000,516,TOR,BOS,TOR02,6,7,13
TOR200005170,2000,517,TOR,BOS,TOR02,8,0,8
TOR200005190,2000,519,TOR,CHA,TOR02,5,3,8
TOR200005200,2000,520,TOR,CHA,TOR02,6,2,8
TOR200005210,2000,521,TOR,CHA,TOR02,2,1,3
TOR200005220,2000,522,TOR,CHA,TOR02,3,4,7
TOR200005300,2000,530,TOR,MIN,TOR02,4,1,5
TOR200005310,2000,531,TOR,MIN,TOR02,2,4,6
TOR200006010,2000,601,TOR,MIN,TOR02,5,1,6
TOR200006090,2000,609,TOR,MON,TOR02,3,13,16
TOR200006100,2000,610,TOR,MON,TOR02,11,2,13
TOR200006110,2000,611,TOR,MON,TOR02,3,8,11
TOR200006200,2000,620,TOR,DET,TOR02,18,6,24
TOR200006210,2000,621,TOR,DET,TOR02,0,6,6
TOR200006220,2000,622,TOR,DET,TOR02,4,7,11
TOR200006230,2000,623,TOR,BOS,TOR02,4,5,9
TOR200006240,2000,624,TOR,BOS,TOR02,4,6,10
TOR200006250,2000,625,TOR,BOS,TOR02,5,6,11
TOR200007130,2000,713,TOR,PHI,TOR02,8,5,13
TOR200007140,2000,714,TOR,PHI,TOR02,2,3,5
TOR200007150,2000,715,TOR,PHI,TOR02,7,3,10
TOR200007160,2000,716,TOR,NYN,TOR02,3,7,10
TOR200007170,2000,717,TOR,NYN,TOR02,7,5,12
TOR200007180,2000,718,TOR,NYN,TOR02,11,7,18
TOR200007190,2000,719,TOR,TBA,TOR02,2,5,7
TOR200007200,2000,720,TOR,TBA,TOR02,5,6,11
TOR200007210,2000,721,TOR,BAL,TOR02,9,5,14
TOR200007220,2000,722,TOR,BAL,TOR02,8,2,10
TOR200007230,2000,723,TOR,BAL,TOR02,1,4,5
TOR200007250,2000,725,TOR,CLE,TOR02,10,3,13
TOR200007260,2000,726,TOR,CLE,TOR02,1,8,9
TOR200008030,2000,803,TOR,TEX,TOR02,1,3,4
TOR200008040,2000,804,TOR,TEX,TOR02,8,10,18
TOR200008050,2000,805,TOR,TEX,TOR02,5,8,13
TOR200008060,2000,806,TOR,TEX,TOR02,11,6,17
TOR200008150,2000,815,TOR,ANA,TOR02,8,4,12
TOR200008160,2000,816,TOR,ANA,TOR02,6,8,14
TOR200008180,2000,818,TOR,MIN,TOR02,2,3,5
TOR200008190,2000,819,TOR,MIN,TOR02,5,1,6
TOR200008200,2000,820,TOR,MIN,TOR02,3,6,9
TOR200008220,2000,822,TOR,KCA,TOR02,5,7,12
TOR200008230,2000,823,TOR,KCA,TOR02,8,9,17
TOR200009010,2000,901,TOR,OAK,TOR02,3,4,7
TOR200009020,2000,902,TOR,OAK,TOR02,8,0,8
TOR200009030,2000,903,TOR,OAK,TOR02,4,3,7
TOR200009040,2000,904,TOR,OAK,TOR02,10,0,10
TOR200009050,2000,905,TOR,SEA,TOR02,4,3,7
TOR200009060,2000,906,TOR,SEA,TOR02,3,7,10
TOR200009070,2000,907,TOR,SEA,TOR02,8,1,9
TOR200009080,2000,908,TOR,DET,TOR02,0,3,3
TOR200009090,2000,909,TOR,DET,TOR02,5,6,11
TOR200009100,2000,910,TOR,DET,TOR02,2,6,8
TOR200009190,2000,919,TOR,NYA,TOR02,3,16,19
TOR200009200,2000,920,TOR,NYA,TOR02,2,7,9
TOR200009210,2000,921,TOR,NYA,TOR02,1,3,4
TOR200009220,2000,922,TOR,TBA,TOR02,3,2,5
TOR200009230,2000,923,TOR,TBA,TOR02,6,7,13
TOR200009240,2000,924,TOR,TBA,TOR02,6,0,6
TOR200009250,2000,925,TOR,TBA,TOR02,5,1,6
TOR200104010,2001,10401,TOR,TEX,SJU01,1,8,9
TOR200104090,2001,10409,TOR,TBA,TOR02,1,8,9
TOR200104100,2001,10410,TOR,TBA,TOR02,2,3,5
TOR200104110,2001,10411,TOR,TBA,TOR02,4,3,7
TOR200104130,2001,10413,TOR,KCA,TOR02,1,2,3
TOR200104140,2001,10414,TOR,KCA,TOR02,4,5,9
TOR200104150,2001,10415,TOR,KCA,TOR02,4,2,6
TOR200104170,2001,10417,TOR,NYA,TOR02,5,6,11
TOR200104180,2001,10418,TOR,NYA,TOR02,2,7,9
TOR200104190,2001,10419,TOR,NYA,TOR02,6,5,11
TOR200104240,2001,10424,TOR,TEX,TOR02,5,7,12
TOR200104250,2001,10425,TOR,TEX,TOR02,5,8,13
TOR200104270,2001,10427,TOR,ANA,TOR02,4,12,16
TOR200104280,2001,10428,TOR,ANA,TOR02,4,1,5
TOR200104290,2001,10429,TOR,ANA,TOR02,0,2,2
TOR200104300,2001,10430,TOR,KCA,TOR02,6,3,9
TOR200105080,2001,10508,TOR,OAK,TOR02,8,5,13
TOR200105090,2001,10509,TOR,OAK,TOR02,8,5,13
TOR200105100,2001,10510,TOR,OAK,TOR02,14,8,22
TOR200105110,2001,10511,TOR,SEA,TOR02,7,2,9
TOR200105120,2001,10512,TOR,SEA,TOR02,11,7,18
TOR200105130,2001,10513,TOR,SEA,TOR02,7,5,12
TOR200105210,2001,10521,TOR,CHA,TOR02,3,10,13
TOR200105230,2001,10523,TOR,CHA,TOR02,6,9,15
TOR200105240,2001,10524,TOR,CHA,TOR02,3,1,4
TOR200105310,2001,10531,TOR,BOS,TOR02,11,5,16
TOR200106010,2001,10601,TOR,BOS,TOR02,6,4,10
TOR200106020,2001,10602,TOR,BOS,TOR02,2,1,3
TOR200106030,2001,10603,TOR,BOS,TOR02,5,4,9
TOR200106050,2001,10605,TOR,TBA,TOR02,1,13,14
TOR200106060,2001,10606,TOR,TBA,TOR02,6,2,8
TOR200106070,2001,10607,TOR,TBA,TOR02,7,8,15
TOR200106080,2001,10608,TOR,FLO,TOR02,6,7,13
TOR200106090,2001,10609,TOR,FLO,TOR02,6,1,7
TOR200106100,2001,10610,TOR,FLO,TOR02,7,2,9
TOR200106110,2001,10611,TOR,ATL,TOR02,4,9,13
TOR200106120,2001,10612,TOR,ATL,TOR02,3,0,3
TOR200106130,2001,10613,TOR,ATL,TOR02,5,12,17
TOR200106250,2001,10625,TOR,BAL,TOR02,8,2,10
TOR200106260,2001,10626,TOR,BAL,TOR02,1,3,4
TOR200106270,2001,10627,TOR,BAL,TOR02,7,3,10
TOR200106280,2001,10628,TOR,BAL,TOR02,5,0,5
TOR200106290,2001,10629,TOR,BOS,TOR02,4,8,12
TOR200106300,2001,10630,TOR,BOS,TOR02,7,5,12
TOR200107010,2001,10701,TOR,BOS,TOR02,4,0,4
TOR200107020,2001,10702,TOR,BOS,TOR02,16,4,20
TOR200107060,2001,10706,TOR,MON,TOR02,10,7,17
TOR200107070,2001,10707,TOR,MON,TOR02,8,9,17
TOR200107080,2001,10708,TOR,MON,TOR02,3,9,12
TOR200107180,2001,10718,TOR,BOS,TOR02,5,4,9
TOR200107190,2001,10719,TOR,BOS,TOR02,3,4,7
TOR200107270,2001,10727,TOR,NYA,TOR02,9,1,10
TOR200107280,2001,10728,TOR,NYA,TOR02,12,1,13
TOR200107290,2001,10729,TOR,NYA,TOR02,9,3,12
TOR200107310,2001,10731,TOR,MIN,TOR02,1,3,4
TOR200108010,2001,10801,TOR,MIN,TOR02,1,3,4
TOR200108020,2001,10802,TOR,MIN,TOR02,9,4,13
TOR200108030,2001,10803,TOR,BAL,TOR02,1,10,11
TOR200108040,2001,10804,TOR,BAL,TOR02,1,2,3
TOR200108050,2001,10805,TOR,BAL,TOR02,4,5,9
TOR200108140,2001,10814,TOR,OAK,TOR02,3,6,9
TOR200108150,2001,10815,TOR,OAK,TOR02,2,5,7
TOR200108160,2001,10816,TOR,OAK,TOR02,8,4,12
TOR200108170,2001,10817,TOR,TEX,TOR02,3,11,14
TOR200108180,2001,10818,TOR,TEX,TOR02,12,5,17
TOR200108190,2001,10819,TOR,TEX,TOR02,8,4,12
TOR200108310,2001,10831,TOR,DET,TOR02,4,3,7
TOR200109010,2001,10901,TOR,DET,TOR02,1,3,4
TOR200109020,2001,10902,TOR,DET,TOR02,0,11,11
TOR200109030,2001,10903,TOR,NYA,TOR02,7,5,12
TOR200109040,2001,10904,TOR,NYA,TOR02,0,14,14
TOR200109050,2001,10905,TOR,NYA,TOR02,4,3,7
TOR200109180,2001,10918,TOR,BAL,TOR02,5,8,13
TOR200109190,2001,10919,TOR,BAL,TOR02,1,4,5
TOR200109200,2001,10920,TOR,BAL,TOR02,12,6,18
TOR200109210,2001,10921,TOR,TBA,TOR02,7,4,11
TOR200109220,2001,10922,TOR,TBA,TOR02,7,8,15
TOR200109230,2001,10923,TOR,TBA,TOR02,1,0,1
TOR200110051,2001,11005,TOR,CLE,TOR02,0,5,5
TOR200110052,2001,11005,TOR,CLE,TOR02,3,4,7
TOR200110060,2001,11006,TOR,CLE,TOR02,2,5,7
TOR200110070,2001,11007,TOR,CLE,TOR02,3,2,5
TOR200204040,2002,20404,TOR,MIN,TOR02,2,7,9
TOR200204050,2002,20405,TOR,MIN,TOR02,4,3,7
TOR200204060,2002,20406,TOR,MIN,TOR02,7,5,12
TOR200204070,2002,20407,TOR,MIN,TOR02,10,6,16
TOR200204080,2002,20408,TOR,NYA,TOR02,16,3,19
TOR200204090,2002,20409,TOR,NYA,TOR02,5,2,7
TOR200204100,2002,20410,TOR,NYA,TOR02,7,9,16
TOR200204110,2002,20411,TOR,NYA,TOR02,3,11,14
TOR200204160,2002,20416,TOR,BOS,TOR02,14,3,17
TOR200204170,2002,20417,TOR,BOS,TOR02,10,3,13
TOR200204300,2002,20430,TOR,TEX,TOR02,10,3,13
TOR200205010,2002,20501,TOR,TEX,TOR02,8,1,9
TOR200205020,2002,20502,TOR,TEX,TOR02,5,3,8
TOR200205030,2002,20503,TOR,ANA,TOR02,6,4,10
TOR200205040,2002,20504,TOR,ANA,TOR02,1,4,5
TOR200205050,2002,20505,TOR,ANA,TOR02,8,2,10
TOR200205140,2002,20514,TOR,SEA,TOR02,3,6,9
TOR200205150,2002,20515,TOR,SEA,TOR02,8,6,14
TOR200205160,2002,20516,TOR,SEA,TOR02,15,2,17
TOR200205170,2002,20517,TOR,OAK,TOR02,1,7,8
TOR200205180,2002,20518,TOR,OAK,TOR02,3,6,9
TOR200205190,2002,20519,TOR,OAK,TOR02,0,11,11
TOR200205240,2002,20524,TOR,CLE,TOR02,5,2,7
TOR200205250,2002,20525,TOR,CLE,TOR02,3,0,3
TOR200205260,2002,20526,TOR,CLE,TOR02,3,1,4
TOR200205270,2002,20527,TOR,BOS,TOR02,8,6,14
TOR200205280,2002,20528,TOR,BOS,TOR02,6,4,10
TOR200205290,2002,20529,TOR,BOS,TOR02,7,4,11
TOR200206030,2002,20603,TOR,TBA,TOR02,1,6,7
TOR200206040,2002,20604,TOR,TBA,TOR02,1,3,4
TOR200206050,2002,20605,TOR,TBA,TOR02,8,6,14
TOR200206060,2002,20606,TOR,TBA,TOR02,4,5,9
TOR200206070,2002,20607,TOR,COL,TOR02,0,8,8
TOR200206080,2002,20608,TOR,COL,TOR02,1,3,4
TOR200206090,2002,20609,TOR,COL,TOR02,2,3,5
TOR200206100,2002,20610,TOR,SFN,TOR02,5,6,11
TOR200206110,2002,20611,TOR,SFN,TOR02,9,2,11
TOR200206120,2002,20612,TOR,SFN,TOR02,6,3,9
TOR200206280,2002,20628,TOR,MON,TOR02,2,1,3
TOR200206290,2002,20629,TOR,MON,TOR02,4,5,9
TOR200206300,2002,20630,TOR,MON,TOR02,5,7,12
TOR200207110,2002,20711,TOR,BOS,TOR02,10,3,13
TOR200207120,2002,20712,TOR,BOS,TOR02,0,5,5
TOR200207130,2002,20713,TOR,BOS,TOR02,1,4,5
TOR200207140,2002,20714,TOR,BOS,TOR02,5,6,11
TOR200207150,2002,20715,TOR,NYA,TOR02,5,8,13
TOR200207160,2002,20716,TOR,NYA,TOR02,7,6,13
TOR200207170,2002,20717,TOR,BAL,TOR02,1,7,8
TOR200207180,2002,20718,TOR,BAL,TOR02,4,5,9
TOR200207190,2002,20719,TOR,TBA,TOR02,8,11,19
TOR200207200,2002,20720,TOR,TBA,TOR02,10,12,22
TOR200207210,2002,20721,TOR,TBA,TOR02,7,5,12
TOR200208020,2002,20802,TOR,BAL,TOR02,9,8,17
TOR200208030,2002,20803,TOR,BAL,TOR02,8,4,12
TOR200208040,2002,20804,TOR,BAL,TOR02,4,5,9
TOR200208050,2002,20805,TOR,BAL,TOR02,1,7,8
TOR200208060,2002,20806,TOR,SEA,TOR02,12,14,26
TOR200208070,2002,20807,TOR,SEA,TOR02,5,4,9
TOR200208080,2002,20808,TOR,SEA,TOR02,3,1,4
TOR200208090,2002,20809,TOR,ANA,TOR02,4,5,9
TOR200208100,2002,20810,TOR,ANA,TOR02,11,4,15
TOR200208110,2002,20811,TOR,ANA,TOR02,1,0,1
TOR200208190,2002,20819,TOR,KCA,TOR02,0,2,2
TOR200208200,2002,20820,TOR,KCA,TOR02,6,5,11
TOR200208210,2002,20821,TOR,KCA,TOR02,7,4,11
TOR200208290,2002,20829,TOR,NYA,TOR02,4,7,11
TOR200208300,2002,20830,TOR,NYA,TOR02,9,7,16
TOR200208310,2002,20831,TOR,NYA,TOR02,1,5,6
TOR200209010,2002,20901,TOR,NYA,TOR02,6,7,13
TOR200209020,2002,20902,TOR,CHA,TOR02,5,3,8
TOR200209030,2002,20903,TOR,CHA,TOR02,5,4,9
TOR200209040,2002,20904,TOR,CHA,TOR02,2,6,8
TOR200209130,2002,20913,TOR,TBA,TOR02,2,5,7
TOR200209140,2002,20914,TOR,TBA,TOR02,4,8,12
TOR200209150,2002,20915,TOR,TBA,TOR02,7,4,11
TOR200209240,2002,20924,TOR,BAL,TOR02,1,11,12
TOR200209250,2002,20925,TOR,BAL,TOR02,2,3,5
TOR200209260,2002,20926,TOR,BAL,TOR02,1,5,6
TOR200209270,2002,20927,TOR,DET,TOR02,2,5,7
TOR200209280,2002,20928,TOR,DET,TOR02,2,10,12
TOR200209290,2002,20929,TOR,DET,TOR02,0,1,1
TOR200303310,2003,30331,TOR,NYA,TOR02,8,4,12
TOR200304010,2003,30401,TOR,NYA,TOR02,10,1,11
TOR200304020,2003,30402,TOR,NYA,TOR02,9,7,16
TOR200304080,2003,30408,TOR,BOS,TOR02,4,8,12
TOR200304090,2003,30409,TOR,BOS,TOR02,5,10,15
TOR200304100,2003,30410,TOR,BOS,TOR02,8,7,15
TOR200304110,2003,30411,TOR,MIN,TOR02,6,4,10
TOR200304120,2003,30412,TOR,MIN,TOR02,9,6,15
TOR200304130,2003,30413,TOR,MIN,TOR02,9,3,12
TOR200304250,2003,30425,TOR,KCA,TOR02,5,6,11
TOR200304260,2003,30426,TOR,KCA,TOR02,9,6,15
TOR200304270,2003,30427,TOR,KCA,TOR02,9,10,19
TOR200304290,2003,30429,TOR,TEX,TOR02,16,11,27
TOR200304300,2003,30430,TOR,TEX,TOR02,11,3,14
TOR200305010,2003,30501,TOR,TEX,TOR02,6,7,13
TOR200305020,2003,30502,TOR,ANA,TOR02,1,3,4
TOR200305030,2003,30503,TOR,ANA,TOR02,1,7,8
TOR200305040,2003,30504,TOR,ANA,TOR02,2,8,10
TOR200305130,2003,30513,TOR,TBA,TOR02,7,5,12
TOR200305140,2003,30514,TOR,TBA,TOR02,6,7,13
TOR200305150,2003,30515,TOR,TBA,TOR02,9,5,14
TOR200305260,2003,30526,TOR,CHA,TOR02,5,11,16
TOR200305270,2003,30527,TOR,CHA,TOR02,1,5,6
TOR200305280,2003,30528,TOR,CHA,TOR02,8,0,8
TOR200305290,2003,30529,TOR,CHA,TOR02,3,2,5
TOR200305300,2003,30530,TOR,BOS,TOR02,2,13,15
TOR200305310,2003,30531,TOR,BOS,TOR02,7,10,17
TOR200306010,2003,30601,TOR,BOS,TOR02,8,11,19
TOR200306100,2003,30610,TOR,PIT,TOR02,8,13,21
TOR200306110,2003,30611,TOR,PIT,TOR02,5,8,13
TOR200306120,2003,30612,TOR,PIT,TOR02,4,5,9
TOR200306130,2003,30613,TOR,CHN,TOR02,1,5,6
TOR200306140,2003,30614,TOR,CHN,TOR02,4,2,6
TOR200306150,2003,30615,TOR,CHN,TOR02,4,5,9
TOR200306230,2003,30623,TOR,BAL,TOR02,4,13,17
TOR200306240,2003,30624,TOR,BAL,TOR02,6,4,10
TOR200306250,2003,30625,TOR,BAL,TOR02,9,2,11
TOR200306260,2003,30626,TOR,BAL,TOR02,8,13,21
TOR200306270,2003,30627,TOR,MON,TOR02,5,6,11
TOR200306280,2003,30628,TOR,MON,TOR02,4,2,6
TOR200306290,2003,30629,TOR,MON,TOR02,10,2,12
TOR200307080,2003,30708,TOR,BOS,TOR02,2,1,3
TOR200307090,2003,30709,TOR,BOS,TOR02,8,7,15
TOR200307100,2003,30710,TOR,BOS,TOR02,7,1,8
TOR200307110,2003,30711,TOR,NYA,TOR02,8,5,13
TOR200307120,2003,30712,TOR,NYA,TOR02,3,10,13
TOR200307130,2003,30713,TOR,NYA,TOR02,6,2,8
TOR200307230,2003,30723,TOR,CHA,TOR02,7,6,13
TOR200307240,2003,30724,TOR,CHA,TOR02,4,3,7
TOR200307250,2003,30725,TOR,BAL,TOR02,3,5,8
TOR200307260,2003,30726,TOR,BAL,TOR02,7,2,9
TOR200307270,2003,30727,TOR,BAL,TOR02,1,10,11
TOR200307290,2003,30729,TOR,TBA,TOR02,9,8,17
TOR200307300,2003,30730,TOR,TBA,TOR02,5,3,8
TOR200307310,2003,30731,TOR,TBA,TOR02,7,6,13
TOR200308080,2003,30808,TOR,TEX,TOR02,5,3,8
TOR200308090,2003,30809,TOR,TEX,TOR02,3,5,8
TOR200308100,2003,30810,TOR,TEX,TOR02,5,4,9
TOR200308190,2003,30819,TOR,SEA,TOR02,9,1,10
TOR200308200,2003,30820,TOR,SEA,TOR02,2,5,7
TOR200308210,2003,30821,TOR,SEA,TOR02,3,7,10
TOR200308220,2003,30822,TOR,OAK,TOR02,3,6,9
TOR200308230,2003,30823,TOR,OAK,TOR02,11,5,16
TOR200308240,2003,30824,TOR,OAK,TOR02,17,2,19
TOR200308250,2003,30825,TOR,OAK,TOR02,8,6,14
TOR200309010,2003,30901,TOR,NYA,TOR02,1,8,9
TOR200309030,2003,30903,TOR,NYA,TOR02,3,4,7
TOR200309040,2003,30904,TOR,NYA,TOR02,3,2,5
TOR200309050,2003,30905,TOR,DET,TOR02,6,8,14
TOR200309060,2003,30906,TOR,DET,TOR02,0,1,1
TOR200309070,2003,30907,TOR,DET,TOR02,0,8,8
TOR200309120,2003,30912,TOR,BAL,TOR02,2,4,6
TOR200309130,2003,30913,TOR,BAL,TOR02,1,6,7
TOR200309140,2003,30914,TOR,BAL,TOR02,5,3,8
TOR200309220,2003,30922,TOR,TBA,TOR02,5,2,7
TOR200309230,2003,30923,TOR,TBA,TOR02,5,8,13
TOR200309240,2003,30924,TOR,TBA,TOR02,3,5,8
TOR200309250,2003,30925,TOR,TBA,TOR02,8,10,18
TOR200309260,2003,30926,TOR,CLE,TOR02,2,1,3
TOR200309270,2003,30927,TOR,CLE,TOR02,4,5,9
TOR200309280,2003,30928,TOR,CLE,TOR02,2,6,8
TOR200404050,2004,40405,TOR,DET,TOR02,7,0,7
TOR200404060,2004,40406,TOR,DET,TOR02,7,3,10
TOR200404070,2004,40407,TOR,DET,TOR02,6,3,9
TOR200404160,2004,40416,TOR,BAL,TOR02,11,2,13
TOR200404170,2004,40417,TOR,BAL,TOR02,5,3,8
TOR200404180,2004,40418,TOR,BAL,TOR02,7,0,7
TOR200404200,2004,40420,TOR,BOS,TOR02,4,2,6
TOR200404210,2004,40421,TOR,BOS,TOR02,4,2,6
TOR200404220,2004,40422,TOR,BOS,TOR02,3,7,10
TOR200405030,2004,40503,TOR,KCA,TOR02,3,2,5
TOR200405040,2004,40504,TOR,KCA,TOR02,4,5,9
TOR200405050,2004,40505,TOR,KCA,TOR02,3,10,13
TOR200405070,2004,40507,TOR,CHA,TOR02,4,5,9
TOR200405080,2004,40508,TOR,CHA,TOR02,2,4,6
TOR200405090,2004,40509,TOR,CHA,TOR02,2,5,7
TOR200405130,2004,40513,TOR,BOS,TOR02,6,12,18
TOR200405140,2004,40514,TOR,BOS,TOR02,9,3,12
TOR200405150,2004,40515,TOR,BOS,TOR02,4,0,4
TOR200405160,2004,40516,TOR,BOS,TOR02,1,3,4
TOR200405170,2004,40517,TOR,MIN,TOR02,9,5,14
TOR200405180,2004,40518,TOR,MIN,TOR02,3,5,8
TOR200405190,2004,40519,TOR,MIN,TOR02,6,5,11
TOR200405240,2004,40524,TOR,ANA,TOR02,5,6,11
TOR200405260,2004,40526,TOR,ANA,TOR02,5,6,11
TOR200405270,2004,40527,TOR,ANA,TOR02,2,3,5
TOR200405280,2004,40528,TOR,TEX,TOR02,4,5,9
TOR200405290,2004,40529,TOR,TEX,TOR02,2,6,8
TOR200405300,2004,40530,TOR,TEX,TOR02,4,2,6
TOR200406080,2004,40608,TOR,LAN,TOR02,1,7,8
TOR200406090,2004,40609,TOR,LAN,TOR02,0,4,4
TOR200406100,2004,40610,TOR,LAN,TOR02,6,1,7
TOR200406110,2004,40611,TOR,ARI,TOR02,3,2,5
TOR200406120,2004,40612,TOR,ARI,TOR02,4,15,19
TOR200406130,2004,40613,TOR,ARI,TOR02,5,3,8
TOR200406220,2004,40622,TOR,TBA,TOR02,5,1,6
TOR200406230,2004,40623,TOR,TBA,TOR02,1,2,3
TOR200406240,2004,40624,TOR,TBA,TOR02,19,13,32
TOR200406250,2004,40625,TOR,MON,TOR02,1,3,4
TOR200406260,2004,40626,TOR,MON,TOR02,5,10,15
TOR200406270,2004,40627,TOR,MON,TOR02,9,4,13
TOR200407060,2004,40706,TOR,SEA,TOR02,6,7,13
TOR200407070,2004,40707,TOR,SEA,TOR02,4,12,16
TOR200407080,2004,40708,TOR,SEA,TOR02,8,10,18
TOR200407090,2004,40709,TOR,ANA,TOR02,5,4,9
TOR200407100,2004,40710,TOR,ANA,TOR02,11,2,13
TOR200407110,2004,40711,TOR,ANA,TOR02,5,2,7
TOR200407230,2004,40723,TOR,TBA,TOR02,4,7,11
TOR200407240,2004,40724,TOR,TBA,TOR02,2,4,6
TOR200407250,2004,40725,TOR,TBA,TOR02,3,5,8
TOR200407260,2004,40726,TOR,NYA,TOR02,6,5,11
TOR200407270,2004,40727,TOR,NYA,TOR02,7,4,11
TOR200407280,2004,40728,TOR,NYA,TOR02,2,3,5
TOR200408020,2004,40802,TOR,CLE,TOR02,1,6,7
TOR200408030,2004,40803,TOR,CLE,TOR02,6,7,13
TOR200408040,2004,40804,TOR,CLE,TOR02,14,5,19
TOR200408050,2004,40805,TOR,CLE,TOR02,6,3,9
TOR200408130,2004,40813,TOR,BAL,TOR02,4,0,4
TOR200408140,2004,40814,TOR,BAL,TOR02,2,7,9
TOR200408150,2004,40815,TOR,BAL,TOR02,11,7,18
TOR200408230,2004,40823,TOR,BOS,TOR02,0,3,3
TOR200408240,2004,40824,TOR,BOS,TOR02,5,4,9
TOR200408250,2004,40825,TOR,BOS,TOR02,11,5,16
TOR200408260,2004,40826,TOR,NYA,TOR02,7,4,11
TOR200408270,2004,40827,TOR,NYA,TOR02,8,7,15
TOR200408280,2004,40828,TOR,NYA,TOR02,18,6,24
TOR200408290,2004,40829,TOR,NYA,TOR02,4,6,10
TOR200408310,2004,40831,TOR,SEA,TOR02,7,5,12
TOR200409010,2004,40901,TOR,SEA,TOR02,2,4,6
TOR200409020,2004,40902,TOR,SEA,TOR02,6,8,14
TOR200409030,2004,40903,TOR,OAK,TOR02,7,4,11
TOR200409040,2004,40904,TOR,OAK,TOR02,9,5,14
TOR200409050,2004,40905,TOR,OAK,TOR02,5,13,18
TOR200409130,2004,40913,TOR,BAL,TOR02,9,1,10
TOR200409150,2004,40915,TOR,BAL,TOR02,0,3,3
TOR200409160,2004,40916,TOR,BAL,TOR02,9,5,14
TOR200409170,2004,40917,TOR,TBA,TOR02,11,4,15
TOR200409180,2004,40918,TOR,TBA,TOR02,2,4,6
TOR200409190,2004,40919,TOR,TBA,TOR02,7,9,16
TOR200410010,2004,41001,TOR,NYA,TOR02,0,7,7
TOR200410020,2004,41002,TOR,NYA,TOR02,2,4,6
TOR200410030,2004,41003,TOR,NYA,TOR02,3,2,5
TOR200504080,2005,50408,TOR,BOS,TOR02,6,5,11
TOR200504090,2005,50409,TOR,BOS,TOR02,5,12,17
TOR200504100,2005,50410,TOR,BOS,TOR02,3,4,7
TOR200504200,2005,50420,TOR,NYA,TOR02,11,2,13
TOR200504210,2005,50421,TOR,NYA,TOR02,4,3,7
TOR200504220,2005,50422,TOR,BAL,TOR02,13,5,18
TOR200504230,2005,50423,TOR,BAL,TOR02,4,1,5
TOR200504240,2005,50424,TOR,BAL,TOR02,7,1,8
TOR200504260,2005,50426,TOR,TBA,TOR02,5,7,12
TOR200504270,2005,50427,TOR,TBA,TOR02,2,8,10
TOR200504280,2005,50428,TOR,TBA,TOR02,4,7,11
TOR200505060,2005,50506,TOR,CHA,TOR02,5,3,8
TOR200505070,2005,50507,TOR,CHA,TOR02,10,7,17
TOR200505080,2005,50508,TOR,CHA,TOR02,5,4,9
TOR200505090,2005,50509,TOR,KCA,TOR02,1,6,7
TOR200505100,2005,50510,TOR,KCA,TOR02,1,3,4
TOR200505110,2005,50511,TOR,KCA,TOR02,9,12,21
TOR200505200,2005,50520,TOR,WAS,TOR02,1,6,7
TOR200505210,2005,50521,TOR,WAS,TOR02,0,7,7
TOR200505220,2005,50522,TOR,WAS,TOR02,9,2,11
TOR200505240,2005,50524,TOR,BOS,TOR02,6,9,15
TOR200505250,2005,50525,TOR,BOS,TOR02,1,6,7
TOR200505260,2005,50526,TOR,BOS,TOR02,1,8,9
TOR200505270,2005,50527,TOR,MIN,TOR02,7,2,9
TOR200505280,2005,50528,TOR,MIN,TOR02,4,3,7
TOR200505290,2005,50529,TOR,MIN,TOR02,0,4,4
TOR200506130,2005,50613,TOR,SLN,TOR02,1,4,5
TOR200506140,2005,50614,TOR,SLN,TOR02,7,0,7
TOR200506150,2005,50615,TOR,SLN,TOR02,2,5,7
TOR200506170,2005,50617,TOR,MIL,TOR02,5,9,14
TOR200506180,2005,50618,TOR,MIL,TOR02,5,2,7
TOR200506190,2005,50619,TOR,MIL,TOR02,5,2,7
TOR200506200,2005,50620,TOR,BAL,TOR02,2,11,13
TOR200506210,2005,50621,TOR,BAL,TOR02,9,5,14
TOR200506220,2005,50622,TOR,BAL,TOR02,2,3,5
TOR200506230,2005,50623,TOR,BAL,TOR02,2,6,8
TOR200507050,2005,50705,TOR,OAK,TOR02,10,7,17
TOR200507060,2005,50706,TOR,OAK,TOR02,0,8,8
TOR200507070,2005,50707,TOR,OAK,TOR02,2,4,6
TOR200507140,2005,50714,TOR,TBA,TOR02,3,0,3
TOR200507150,2005,50715,TOR,TBA,TOR02,6,11,17
TOR200507160,2005,50716,TOR,TBA,TOR02,6,5,11
TOR200507170,2005,50717,TOR,TBA,TOR02,5,4,9
TOR200507190,2005,50719,TOR,SEA,TOR02,10,12,22
TOR200507200,2005,50720,TOR,SEA,TOR02,4,9,13
TOR200507210,2005,50721,TOR,SEA,TOR02,3,6,9
TOR200507260,2005,50726,TOR,ANA,TOR02,0,8,8
TOR200507270,2005,50727,TOR,ANA,TOR02,2,3,5
TOR200507280,2005,50728,TOR,ANA,TOR02,1,2,3
TOR200507290,2005,50729,TOR,TEX,TOR02,4,1,5
TOR200507300,2005,50730,TOR,TEX,TOR02,3,2,5
TOR200507310,2005,50731,TOR,TEX,TOR02,1,5,6
TOR200508050,2005,50805,TOR,NYA,TOR02,6,2,8
TOR200508060,2005,50806,TOR,NYA,TOR02,5,8,13
TOR200508070,2005,50807,TOR,NYA,TOR02,6,2,8
TOR200508080,2005,50808,TOR,DET,TOR02,9,8,17
TOR200508090,2005,50809,TOR,DET,TOR02,4,6,10
TOR200508100,2005,50810,TOR,DET,TOR02,3,4,7
TOR200508110,2005,50811,TOR,DET,TOR02,1,2,3
TOR200508260,2005,50826,TOR,CLE,TOR02,9,3,12
TOR200508270,2005,50827,TOR,CLE,TOR02,1,2,3
TOR200508280,2005,50828,TOR,CLE,TOR02,4,1,5
TOR200508300,2005,50830,TOR,BAL,TOR02,2,7,9
TOR200508310,2005,50831,TOR,BAL,TOR02,7,0,7
TOR200509010,2005,50901,TOR,BAL,TOR02,5,3,8
TOR200509020,2005,50902,TOR,TBA,TOR02,3,4,7
TOR200509030,2005,50903,TOR,TBA,TOR02,3,2,5
TOR200509040,2005,50904,TOR,TBA,TOR02,1,0,1
TOR200509120,2005,50912,TOR,BOS,TOR02,6,5,11
TOR200509130,2005,50913,TOR,BOS,TOR02,3,9,12
TOR200509140,2005,50914,TOR,BOS,TOR02,5,3,8
TOR200509160,2005,50916,TOR,NYA,TOR02,11,10,21
TOR200509170,2005,50917,TOR,NYA,TOR02,1,0,1
TOR200509180,2005,50918,TOR,NYA,TOR02,5,6,11
TOR200509190,2005,50919,TOR,SEA,TOR02,7,5,12
TOR200509200,2005,50920,TOR,SEA,TOR02,4,6,10
TOR200509210,2005,50921,TOR,SEA,TOR02,3,2,5
TOR200509220,2005,50922,TOR,SEA,TOR02,5,7,12
TOR200509300,2005,50930,TOR,KCA,TOR02,1,10,11
TOR200510010,2005,51001,TOR,KCA,TOR02,7,6,13
TOR200510020,2005,51002,TOR,KCA,TOR02,2,7,9
TOR200604040,2006,60404,TOR,MIN,TOR02,3,6,9
TOR200604050,2006,60405,TOR,MIN,TOR02,13,4,17
TOR200604060,2006,60406,TOR,MIN,TOR02,3,6,9
TOR200604070,2006,60407,TOR,TBA,TOR02,9,8,17
TOR200604080,2006,60408,TOR,TBA,TOR02,4,8,12
TOR200604090,2006,60409,TOR,TBA,TOR02,5,2,7
TOR200604180,2006,60418,TOR,NYA,TOR02,5,10,15
TOR200604190,2006,60419,TOR,NYA,TOR02,3,1,4
TOR200604210,2006,60421,TOR,BOS,TOR02,6,7,13
TOR200604220,2006,60422,TOR,BOS,TOR02,1,8,9
TOR200604230,2006,60423,TOR,BOS,TOR02,6,3,9
TOR200604250,2006,60425,TOR,BAL,TOR02,3,7,10
TOR200604260,2006,60426,TOR,BAL,TOR02,2,8,10
TOR200604270,2006,60427,TOR,BAL,TOR02,7,5,12
TOR200605050,2006,60505,TOR,ANA,TOR02,3,13,16
TOR200605060,2006,60506,TOR,ANA,TOR02,3,0,3
TOR200605070,2006,60507,TOR,ANA,TOR02,1,3,4
TOR200605080,2006,60508,TOR,ANA,TOR02,1,5,6
TOR200605090,2006,60509,TOR,OAK,TOR02,6,5,11
TOR200605100,2006,60510,TOR,OAK,TOR02,7,9,16
TOR200605110,2006,60511,TOR,OAK,TOR02,3,8,11
TOR200605220,2006,60522,TOR,TBA,TOR02,4,6,10
TOR200605230,2006,60523,TOR,TBA,TOR02,1,4,5
TOR200605240,2006,60524,TOR,TBA,TOR02,10,8,18
TOR200605260,2006,60526,TOR,CHA,TOR02,2,8,10
TOR200605270,2006,60527,TOR,CHA,TOR02,2,3,5
TOR200605280,2006,60528,TOR,CHA,TOR02,7,5,12
TOR200605290,2006,60529,TOR,BOS,TOR02,6,7,13
TOR200605300,2006,60530,TOR,BOS,TOR02,5,8,13
TOR200605310,2006,60531,TOR,BOS,TOR02,8,6,14
TOR200606090,2006,60609,TOR,DET,TOR02,5,10,15
TOR200606100,2006,60610,TOR,DET,TOR02,5,3,8
TOR200606110,2006,60611,TOR,DET,TOR02,10,5,15
TOR200606120,2006,60612,TOR,BAL,TOR02,6,4,10
TOR200606130,2006,60613,TOR,BAL,TOR02,1,7,8
TOR200606140,2006,60614,TOR,BAL,TOR02,3,6,9
TOR200606150,2006,60615,TOR,BAL,TOR02,2,4,6
TOR200606230,2006,60623,TOR,NYN,TOR02,6,1,7
TOR200606240,2006,60624,TOR,NYN,TOR02,4,7,11
TOR200606250,2006,60625,TOR,NYN,TOR02,7,4,11
TOR200606270,2006,60627,TOR,WAS,TOR02,0,6,6
TOR200606280,2006,60628,TOR,WAS,TOR02,1,6,7
TOR200606290,2006,60629,TOR,WAS,TOR02,4,8,12
TOR200606300,2006,60630,TOR,PHI,TOR02,1,8,9
TOR200607010,2006,60701,TOR,PHI,TOR02,2,5,7
TOR200607020,2006,60702,TOR,PHI,TOR02,11,6,17
TOR200607140,2006,60714,TOR,SEA,TOR02,5,3,8
TOR200607150,2006,60715,TOR,SEA,TOR02,6,7,13
TOR200607160,2006,60716,TOR,SEA,TOR02,3,4,7
TOR200607170,2006,60717,TOR,TEX,TOR02,1,10,11
TOR200607180,2006,60718,TOR,TEX,TOR02,5,2,7
TOR200607190,2006,60719,TOR,TEX,TOR02,5,4,9
TOR200607200,2006,60720,TOR,NYA,TOR02,4,5,9
TOR200607210,2006,60721,TOR,NYA,TOR02,3,7,10
TOR200607220,2006,60722,TOR,NYA,TOR02,5,4,9
TOR200607230,2006,60723,TOR,NYA,TOR02,5,13,18
TOR200608040,2006,60804,TOR,CHA,TOR02,6,4,10
TOR200608050,2006,60805,TOR,CHA,TOR02,7,1,8
TOR200608060,2006,60806,TOR,CHA,TOR02,3,7,10
TOR200608070,2006,60807,TOR,BAL,TOR02,1,8,9
TOR200608080,2006,60808,TOR,BAL,TOR02,8,4,12
TOR200608090,2006,60809,TOR,BAL,TOR02,3,4,7
TOR200608210,2006,60821,TOR,OAK,TOR02,12,10,22
TOR200608220,2006,60822,TOR,OAK,TOR02,3,4,7
TOR200608230,2006,60823,TOR,OAK,TOR02,6,0,6
TOR200608250,2006,60825,TOR,KCA,TOR02,3,6,9
TOR200608260,2006,60826,TOR,KCA,TOR02,2,0,2
TOR200608270,2006,60827,TOR,KCA,TOR02,6,10,16
TOR200609040,2006,60904,TOR,CLE,TOR02,3,4,7
TOR200609050,2006,60905,TOR,CLE,TOR02,7,2,9
TOR200609060,2006,60906,TOR,CLE,TOR02,2,3,5
TOR200609150,2006,60915,TOR,TBA,TOR02,4,5,9
TOR200609160,2006,60916,TOR,TBA,TOR02,1,6,7
TOR200609170,2006,60917,TOR,TBA,TOR02,3,5,8
TOR200609180,2006,60918,TOR,NYA,TOR02,7,6,13
TOR200609190,2006,60919,TOR,NYA,TOR02,6,3,9
TOR200609200,2006,60920,TOR,NYA,TOR02,2,3,5
TOR200609220,2006,60922,TOR,BOS,TOR02,7,1,8
TOR200609230,2006,60923,TOR,BOS,TOR02,3,5,8
TOR200609240,2006,60924,TOR,BOS,TOR02,4,13,17
TOR200609250,2006,60925,TOR,BOS,TOR02,0,5,5
TOR200704090,2007,70409,TOR,KCA,TOR02,1,9,10
TOR200704100,2007,70410,TOR,KCA,TOR02,6,3,9
TOR200704110,2007,70411,TOR,KCA,TOR02,4,7,11
TOR200704120,2007,70412,TOR,DET,TOR02,5,4,9
TOR200704130,2007,70413,TOR,DET,TOR02,1,2,3
TOR200704140,2007,70414,TOR,DET,TOR02,10,7,17
TOR200704150,2007,70415,TOR,DET,TOR02,1,2,3
TOR200704170,2007,70417,TOR,BOS,TOR02,1,2,3
TOR200704180,2007,70418,TOR,BOS,TOR02,4,1,5
TOR200704190,2007,70419,TOR,BOS,TOR02,5,3,8
TOR200704270,2007,70427,TOR,TEX,TOR02,5,3,8
TOR200704280,2007,70428,TOR,TEX,TOR02,9,8,17
TOR200704290,2007,70429,TOR,TEX,TOR02,3,7,10
TOR200704300,2007,70430,TOR,TEX,TOR02,1,6,7
TOR200705080,2007,70508,TOR,BOS,TOR02,9,2,11
TOR200705090,2007,70509,TOR,BOS,TOR02,9,3,12
TOR200705100,2007,70510,TOR,BOS,TOR02,8,0,8
TOR200705110,2007,70511,TOR,TBA,TOR02,1,5,6
TOR200705120,2007,70512,TOR,TBA,TOR02,4,5,9
TOR200705130,2007,70513,TOR,TBA,TOR02,2,1,3
TOR200705140,2007,70514,TOR,BAL,TOR02,3,5,8
TOR200705150,2007,70515,TOR,BAL,TOR02,1,2,3
TOR200705160,2007,70516,TOR,BAL,TOR02,1,2,3
TOR200705280,2007,70528,TOR,NYA,TOR02,2,7,9
TOR200705290,2007,70529,TOR,NYA,TOR02,2,3,5
TOR200705300,2007,70530,TOR,NYA,TOR02,10,5,15
TOR200705310,2007,70531,TOR,CHA,TOR02,0,2,2
TOR200706010,2007,70601,TOR,CHA,TOR02,3,0,3
TOR200706020,2007,70602,TOR,CHA,TOR02,3,9,12
TOR200706030,2007,70603,TOR,CHA,TOR02,3,4,7
TOR200706050,2007,70605,TOR,TBA,TOR02,11,12,23
TOR200706060,2007,70606,TOR,TBA,TOR02,6,2,8
TOR200706070,2007,70607,TOR,TBA,TOR02,5,3,8
TOR200706150,2007,70615,TOR,WAS,TOR02,2,7,9
TOR200706160,2007,70616,TOR,WAS,TOR02,3,7,10
TOR200706170,2007,70617,TOR,WAS,TOR02,4,2,6
TOR200706190,2007,70619,TOR,LAN,TOR02,10,1,11
TOR200706200,2007,70620,TOR,LAN,TOR02,1,12,13
TOR200706210,2007,70621,TOR,LAN,TOR02,8,4,12
TOR200706220,2007,70622,TOR,COL,TOR02,8,9,17
TOR200706230,2007,70623,TOR,COL,TOR02,6,11,17
TOR200706240,2007,70624,TOR,COL,TOR02,0,5,5
TOR200707060,2007,70706,TOR,CLE,TOR02,6,8,14
TOR200707070,2007,70707,TOR,CLE,TOR02,9,4,13
TOR200707080,2007,70708,TOR,CLE,TOR02,0,1,1
TOR200707200,2007,70720,TOR,SEA,TOR02,4,2,6
TOR200707210,2007,70721,TOR,SEA,TOR02,0,1,1
TOR200707220,2007,70722,TOR,SEA,TOR02,0,8,8
TOR200707230,2007,70723,TOR,MIN,TOR02,4,6,10
TOR200707240,2007,70724,TOR,MIN,TOR02,0,7,7
TOR200707250,2007,70725,TOR,MIN,TOR02,1,13,14
TOR200708030,2007,70803,TOR,TEX,TOR02,4,6,10
TOR200708040,2007,70804,TOR,TEX,TOR02,5,9,14
TOR200708050,2007,70805,TOR,TEX,TOR02,1,4,5
TOR200708060,2007,70806,TOR,NYA,TOR02,5,4,9
TOR200708070,2007,70807,TOR,NYA,TOR02,9,2,11
TOR200708080,2007,70808,TOR,NYA,TOR02,4,15,19
TOR200708140,2007,70814,TOR,ANA,TOR02,1,4,5
TOR200708150,2007,70815,TOR,ANA,TOR02,1,2,3
TOR200708160,2007,70816,TOR,ANA,TOR02,4,3,7
TOR200708170,2007,70817,TOR,BAL,TOR02,2,5,7
TOR200708180,2007,70818,TOR,BAL,TOR02,5,3,8
TOR200708190,2007,70819,TOR,BAL,TOR02,2,3,5
TOR200708200,2007,70820,TOR,OAK,TOR02,6,4,10
TOR200708210,2007,70821,TOR,OAK,TOR02,6,4,10
TOR200708220,2007,70822,TOR,OAK,TOR02,4,1,5
TOR200708310,2007,70831,TOR,SEA,TOR02,5,7,12
TOR200709010,2007,70901,TOR,SEA,TOR02,1,2,3
TOR200709020,2007,70902,TOR,SEA,TOR02,4,6,10
TOR200709110,2007,70911,TOR,NYA,TOR02,9,2,11
TOR200709120,2007,70912,TOR,NYA,TOR02,4,1,5
TOR200709130,2007,70913,TOR,NYA,TOR02,1,2,3
TOR200709140,2007,70914,TOR,BAL,TOR02,6,2,8
TOR200709150,2007,70915,TOR,BAL,TOR02,3,8,11
TOR200709160,2007,70916,TOR,BAL,TOR02,8,6,14
TOR200709170,2007,70917,TOR,BOS,TOR02,1,6,7
TOR200709180,2007,70918,TOR,BOS,TOR02,3,4,7
TOR200709190,2007,70919,TOR,BOS,TOR02,1,6,7
TOR200709280,2007,70928,TOR,TBA,TOR02,4,5,9
TOR200709290,2007,70929,TOR,TBA,TOR02,3,5,8
TOR200709300,2007,70930,TOR,TBA,TOR02,8,5,13
TOR200804040,2008,80404,TOR,BOS,TOR02,3,6,9
TOR200804050,2008,80405,TOR,BOS,TOR02,2,10,12
TOR200804060,2008,80406,TOR,BOS,TOR02,4,7,11
TOR200804080,2008,80408,TOR,OAK,TOR02,9,8,17
TOR200804090,2008,80409,TOR,OAK,TOR02,6,3,9
TOR200804100,2008,80410,TOR,OAK,TOR02,3,2,5
TOR200804160,2008,80416,TOR,TEX,TOR02,7,5,12
TOR200804170,2008,80417,TOR,TEX,TOR02,4,1,5
TOR200804180,2008,80418,TOR,DET,TOR02,8,4,12
TOR200804190,2008,80419,TOR,DET,TOR02,2,3,5
TOR200804200,2008,80420,TOR,DET,TOR02,3,5,8
TOR200804210,2008,80421,TOR,DET,TOR02,5,1,6
TOR200805020,2008,80502,TOR,CHA,TOR02,0,2,2
TOR200805030,2008,80503,TOR,CHA,TOR02,2,5,7
TOR200805040,2008,80504,TOR,CHA,TOR02,3,4,7
TOR200805050,2008,80505,TOR,CHA,TOR02,0,1,1
TOR200805060,2008,80506,TOR,TBA,TOR02,5,4,9
TOR200805070,2008,80507,TOR,TBA,TOR02,2,6,8
TOR200805080,2008,80508,TOR,TBA,TOR02,8,3,11
TOR200805200,2008,80520,TOR,ANA,TOR02,3,1,4
TOR200805210,2008,80521,TOR,ANA,TOR02,4,3,7
TOR200805220,2008,80522,TOR,ANA,TOR02,3,4,7
TOR200805230,2008,80523,TOR,KCA,TOR02,1,7,8
TOR200805240,2008,80524,TOR,KCA,TOR02,0,6,6
TOR200805250,2008,80525,TOR,KCA,TOR02,1,3,4
TOR200805260,2008,80526,TOR,KCA,TOR02,2,7,9
TOR200806060,2008,80606,TOR,BAL,TOR02,6,5,11
TOR200806070,2008,80607,TOR,BAL,TOR02,9,5,14
TOR200806080,2008,80608,TOR,BAL,TOR02,4,5,9
TOR200806090,2008,80609,TOR,SEA,TOR02,3,2,5
TOR200806100,2008,80610,TOR,SEA,TOR02,1,3,4
TOR200806110,2008,80611,TOR,SEA,TOR02,2,1,3
TOR200806130,2008,80613,TOR,CHN,TOR02,2,3,5
TOR200806140,2008,80614,TOR,CHN,TOR02,6,2,8
TOR200806150,2008,80615,TOR,CHN,TOR02,7,4,11
TOR200806240,2008,80624,TOR,CIN,TOR02,1,14,15
TOR200806250,2008,80625,TOR,CIN,TOR02,6,5,11
TOR200806260,2008,80626,TOR,CIN,TOR02,1,7,8
TOR200806270,2008,80627,TOR,ATL,TOR02,4,0,4
TOR200806280,2008,80628,TOR,ATL,TOR02,5,9,14
TOR200806290,2008,80629,TOR,ATL,TOR02,0,1,1
TOR200807080,2008,80708,TOR,BAL,TOR02,6,7,13
TOR200807090,2008,80709,TOR,BAL,TOR02,8,9,17
TOR200807100,2008,80710,TOR,BAL,TOR02,5,6,11
TOR200807110,2008,80711,TOR,NYA,TOR02,0,5,5
TOR200807120,2008,80712,TOR,NYA,TOR02,9,4,13
TOR200807130,2008,80713,TOR,NYA,TOR02,1,4,5
TOR200807250,2008,80725,TOR,SEA,TOR02,4,5,9
TOR200807260,2008,80726,TOR,SEA,TOR02,3,8,11
TOR200807270,2008,80727,TOR,SEA,TOR02,5,1,6
TOR200807280,2008,80728,TOR,TBA,TOR02,1,3,4
TOR200807290,2008,80729,TOR,TBA,TOR02,3,0,3
TOR200807300,2008,80730,TOR,TBA,TOR02,3,2,5
TOR200808040,2008,80804,TOR,OAK,TOR02,1,6,7
TOR200808050,2008,80805,TOR,OAK,TOR02,3,4,7
TOR200808060,2008,80806,TOR,OAK,TOR02,1,5,6
TOR200808070,2008,80807,TOR,OAK,TOR02,4,6,10
TOR200808080,2008,80808,TOR,CLE,TOR02,5,2,7
TOR200808090,2008,80809,TOR,CLE,TOR02,4,2,6
TOR200808100,2008,80810,TOR,CLE,TOR02,4,0,4
TOR200808190,2008,80819,TOR,NYA,TOR02,1,2,3
TOR200808200,2008,80820,TOR,NYA,TOR02,5,1,6
TOR200808210,2008,80821,TOR,NYA,TOR02,3,14,17
TOR200808220,2008,80822,TOR,BOS,TOR02,8,4,12
TOR200808230,2008,80823,TOR,BOS,TOR02,0,11,11
TOR200808240,2008,80824,TOR,BOS,TOR02,6,5,11
TOR200809020,2008,80902,TOR,MIN,TOR02,5,7,12
TOR200809030,2008,80903,TOR,MIN,TOR02,4,5,9
TOR200809040,2008,80904,TOR,MIN,TOR02,0,9,9
TOR200809050,2008,80905,TOR,TBA,TOR02,4,6,10
TOR200809060,2008,80906,TOR,TBA,TOR02,4,7,11
TOR200809070,2008,80907,TOR,TBA,TOR02,0,1,1
TOR200809160,2008,80916,TOR,BAL,TOR02,2,0,2
TOR200809170,2008,80917,TOR,BAL,TOR02,7,8,15
TOR200809180,2008,80918,TOR,BAL,TOR02,2,3,5
TOR200809190,2008,80919,TOR,BOS,TOR02,4,3,7
TOR200809200,2008,80920,TOR,BOS,TOR02,3,6,9
TOR200809210,2008,80921,TOR,BOS,TOR02,3,0,3
TOR200809230,2008,80923,TOR,NYA,TOR02,3,1,4
TOR200809240,2008,80924,TOR,NYA,TOR02,6,2,8
TOR200809250,2008,80925,TOR,NYA,TOR02,2,8,10
TOR200904060,2009,90406,TOR,DET,TOR02,5,12,17
TOR200904070,2009,90407,TOR,DET,TOR02,4,5,9
TOR200904080,2009,90408,TOR,DET,TOR02,5,1,6
TOR200904090,2009,90409,TOR,DET,TOR02,2,6,8
TOR200904170,2009,90417,TOR,OAK,TOR02,8,5,13
TOR200904180,2009,90418,TOR,OAK,TOR02,2,4,6
TOR200904190,2009,90419,TOR,OAK,TOR02,0,1,1
TOR200904210,2009,90421,TOR,TEX,TOR02,5,4,9
TOR200904220,2009,90422,TOR,TEX,TOR02,7,8,15
TOR200904230,2009,90423,TOR,TEX,TOR02,2,5,7
TOR200905010,2009,90501,TOR,BAL,TOR02,4,8,12
TOR200905020,2009,90502,TOR,BAL,TOR02,4,5,9
TOR200905030,2009,90503,TOR,BAL,TOR02,3,4,7
TOR200905040,2009,90504,TOR,CLE,TOR02,9,7,16
TOR200905050,2009,90505,TOR,CLE,TOR02,6,10,16
TOR200905120,2009,90512,TOR,NYA,TOR02,1,5,6
TOR200905130,2009,90513,TOR,NYA,TOR02,8,2,10
TOR200905140,2009,90514,TOR,NYA,TOR02,3,2,5
TOR200905150,2009,90515,TOR,CHA,TOR02,3,8,11
TOR200905160,2009,90516,TOR,CHA,TOR02,1,2,3
TOR200905170,2009,90517,TOR,CHA,TOR02,2,8,10
TOR200905180,2009,90518,TOR,CHA,TOR02,2,3,5
TOR200905290,2009,90529,TOR,BOS,TOR02,3,6,9
TOR200905300,2009,90530,TOR,BOS,TOR02,3,5,8
TOR200905310,2009,90531,TOR,BOS,TOR02,8,2,10
TOR200906020,2009,90602,TOR,ANA,TOR02,4,6,10
TOR200906030,2009,90603,TOR,ANA,TOR02,8,1,9
TOR200906040,2009,90604,TOR,ANA,TOR02,6,5,11
TOR200906050,2009,90605,TOR,KCA,TOR02,3,9,12
TOR200906060,2009,90606,TOR,KCA,TOR02,6,2,8
TOR200906070,2009,90607,TOR,KCA,TOR02,0,4,4
TOR200906120,2009,90612,TOR,FLO,TOR02,7,3,10
TOR200906130,2009,90613,TOR,FLO,TOR02,6,5,11
TOR200906140,2009,90614,TOR,FLO,TOR02,11,3,14
TOR200906230,2009,90623,TOR,CIN,TOR02,5,7,12
TOR200906240,2009,90624,TOR,CIN,TOR02,2,8,10
TOR200906250,2009,90625,TOR,CIN,TOR02,7,5,12
TOR200906260,2009,90626,TOR,PHI,TOR02,1,6,7
TOR200906270,2009,90627,TOR,PHI,TOR02,10,0,10
TOR200906280,2009,90628,TOR,PHI,TOR02,5,4,9
TOR200906290,2009,90629,TOR,TBA,TOR02,4,1,5
TOR200906300,2009,90630,TOR,TBA,TOR02,4,1,5
TOR200907010,2009,90701,TOR,TBA,TOR02,0,5,5
TOR200907170,2009,90717,TOR,BOS,TOR02,4,1,5
TOR200907180,2009,90718,TOR,BOS,TOR02,2,6,8
TOR200907190,2009,90719,TOR,BOS,TOR02,1,3,4
TOR200907210,2009,90721,TOR,CLE,TOR02,2,1,3
TOR200907220,2009,90722,TOR,CLE,TOR02,6,10,16
TOR200907230,2009,90723,TOR,CLE,TOR02,5,4,9
TOR200907240,2009,90724,TOR,TBA,TOR02,4,2,6
TOR200907250,2009,90725,TOR,TBA,TOR02,10,9,19
TOR200907260,2009,90726,TOR,TBA,TOR02,1,5,6
TOR200908040,2009,90804,TOR,NYA,TOR02,5,3,8
TOR200908050,2009,90805,TOR,NYA,TOR02,8,4,12
TOR200908070,2009,90807,TOR,BAL,TOR02,7,5,12
TOR200908080,2009,90808,TOR,BAL,TOR02,2,3,5
TOR200908090,2009,90809,TOR,BAL,TOR02,3,7,10
TOR200908180,2009,90818,TOR,BOS,TOR02,10,9,19
TOR200908190,2009,90819,TOR,BOS,TOR02,6,1,7
TOR200908200,2009,90820,TOR,BOS,TOR02,8,1,9
TOR200908210,2009,90821,TOR,ANA,TOR02,4,5,9
TOR200908220,2009,90822,TOR,ANA,TOR02,7,3,10
TOR200908230,2009,90823,TOR,ANA,TOR02,3,8,11
TOR200908240,2009,90824,TOR,TBA,TOR02,12,7,19
TOR200908250,2009,90825,TOR,TBA,TOR02,7,3,10
TOR200908260,2009,90826,TOR,TBA,TOR02,2,3,5
TOR200909030,2009,90903,TOR,NYA,TOR02,10,5,15
TOR200909040,2009,90904,TOR,NYA,TOR02,0,6,6
TOR200909050,2009,90905,TOR,NYA,TOR02,6,4,10
TOR200909060,2009,90906,TOR,NYA,TOR02,8,14,22
TOR200909070,2009,90907,TOR,MIN,TOR02,6,3,9
TOR200909080,2009,90908,TOR,MIN,TOR02,3,6,9
TOR200909090,2009,90909,TOR,MIN,TOR02,4,1,5
TOR200909100,2009,90910,TOR,MIN,TOR02,2,3,5
TOR200909210,2009,90921,TOR,BAL,TOR02,2,9,11
TOR200909220,2009,90922,TOR,BAL,TOR02,5,6,11
TOR200909230,2009,90923,TOR,BAL,TOR02,3,7,10
TOR200909240,2009,90924,TOR,SEA,TOR02,5,4,9
TOR200909250,2009,90925,TOR,SEA,TOR02,0,5,5
TOR200909260,2009,90926,TOR,SEA,TOR02,4,5,9
TOR200909270,2009,90927,TOR,SEA,TOR02,4,5,9
WAS200504140,2005,50414,WAS,ARI,WAS10,3,5,8
WAS200504160,2005,50416,WAS,ARI,WAS10,3,9,12
WAS200504170,2005,50417,WAS,ARI,WAS10,3,7,10
WAS200504180,2005,50418,WAS,FLO,WAS10,9,4,13
WAS200504190,2005,50419,WAS,FLO,WAS10,6,3,9
WAS200504200,2005,50420,WAS,ATL,WAS10,0,2,2
WAS200504210,2005,50421,WAS,ATL,WAS10,2,1,3
WAS200504250,2005,50425,WAS,PHI,WAS10,5,4,9
WAS200504260,2005,50426,WAS,PHI,WAS10,1,3,4
WAS200504270,2005,50427,WAS,PHI,WAS10,3,0,3
WAS200504290,2005,50429,WAS,NYN,WAS10,1,5,6
WAS200504300,2005,50430,WAS,NYN,WAS10,3,5,8
WAS200505010,2005,50501,WAS,NYN,WAS10,6,3,9
WAS200505130,2005,50513,WAS,CHN,WAS10,6,3,9
WAS200505140,2005,50514,WAS,CHN,WAS10,3,4,7
WAS200505150,2005,50515,WAS,CHN,WAS10,4,5,9
WAS200505160,2005,50516,WAS,MIL,WAS10,2,5,7
WAS200505170,2005,50517,WAS,MIL,WAS10,8,2,10
WAS200505180,2005,50518,WAS,MIL,WAS10,0,1,1
WAS200505190,2005,50519,WAS,MIL,WAS10,2,3,5
WAS200505300,2005,50530,WAS,ATL,WAS10,2,3,5
WAS200505310,2005,50531,WAS,ATL,WAS10,4,5,9
WAS200506010,2005,50601,WAS,ATL,WAS10,5,4,9
WAS200506020,2005,50602,WAS,ATL,WAS10,6,8,14
WAS200506030,2005,50603,WAS,FLO,WAS10,2,3,5
WAS200506040,2005,50604,WAS,FLO,WAS10,3,7,10
WAS200506050,2005,50605,WAS,FLO,WAS10,3,6,9
WAS200506070,2005,50607,WAS,OAK,WAS10,1,2,3
WAS200506080,2005,50608,WAS,OAK,WAS10,2,7,9
WAS200506090,2005,50609,WAS,OAK,WAS10,3,4,7
WAS200506100,2005,50610,WAS,SEA,WAS10,3,9,12
WAS200506110,2005,50611,WAS,SEA,WAS10,1,2,3
WAS200506120,2005,50612,WAS,SEA,WAS10,2,3,5
WAS200506240,2005,50624,WAS,TOR,WAS10,0,3,3
WAS200506250,2005,50625,WAS,TOR,WAS10,2,5,7
WAS200506260,2005,50626,WAS,TOR,WAS10,9,5,14
WAS200506280,2005,50628,WAS,PIT,WAS10,1,2,3
WAS200506290,2005,50629,WAS,PIT,WAS10,2,3,5
WAS200506300,2005,50630,WAS,PIT,WAS10,5,7,12
WAS200507040,2005,50704,WAS,NYN,WAS10,5,2,7
WAS200507050,2005,50705,WAS,NYN,WAS10,2,3,5
WAS200507060,2005,50706,WAS,NYN,WAS10,5,3,8
WAS200507070,2005,50707,WAS,NYN,WAS10,3,2,5
WAS200507180,2005,50718,WAS,COL,WAS10,5,4,9
WAS200507190,2005,50719,WAS,COL,WAS10,0,4,4
WAS200507200,2005,50720,WAS,COL,WAS10,3,2,5
WAS200507210,2005,50721,WAS,HOU,WAS10,3,2,5
WAS200507220,2005,50722,WAS,HOU,WAS10,14,1,15
WAS200507230,2005,50723,WAS,HOU,WAS10,2,4,6
WAS200507240,2005,50724,WAS,HOU,WAS10,4,1,5
WAS200508020,2005,50802,WAS,LAN,WAS10,5,4,9
WAS200508030,2005,50803,WAS,LAN,WAS10,1,3,4
WAS200508040,2005,50804,WAS,LAN,WAS10,0,7,7
WAS200508050,2005,50805,WAS,SDN,WAS10,6,5,11
WAS200508060,2005,50806,WAS,SDN,WAS10,3,2,5
WAS200508070,2005,50807,WAS,SDN,WAS10,3,0,3
WAS200508230,2005,50823,WAS,CIN,WAS10,6,2,8
WAS200508240,2005,50824,WAS,CIN,WAS10,3,5,8
WAS200508250,2005,50825,WAS,CIN,WAS10,5,3,8
WAS200508260,2005,50826,WAS,SLN,WAS10,1,4,5
WAS200508270,2005,50827,WAS,SLN,WAS10,6,0,6
WAS200508280,2005,50828,WAS,SLN,WAS10,6,0,6
WAS200509020,2005,50902,WAS,PHI,WAS10,7,1,8
WAS200509030,2005,50903,WAS,PHI,WAS10,4,5,9
WAS200509040,2005,50904,WAS,PHI,WAS10,1,6,7
WAS200509050,2005,50905,WAS,FLO,WAS10,2,5,7
WAS200509060,2005,50906,WAS,FLO,WAS10,4,2,6
WAS200509070,2005,50907,WAS,FLO,WAS10,12,1,13
WAS200509080,2005,50908,WAS,FLO,WAS10,8,4,12
WAS200509090,2005,50909,WAS,ATL,WAS10,6,8,14
WAS200509100,2005,50910,WAS,ATL,WAS10,4,0,4
WAS200509110,2005,50911,WAS,ATL,WAS10,9,7,16
WAS200509200,2005,50920,WAS,SFN,WAS10,4,3,7
WAS200509210,2005,50921,WAS,SFN,WAS10,5,1,6
WAS200509220,2005,50922,WAS,SFN,WAS10,0,2,2
WAS200509230,2005,50923,WAS,NYN,WAS10,5,2,7
WAS200509240,2005,50924,WAS,NYN,WAS10,5,2,7
WAS200509250,2005,50925,WAS,NYN,WAS10,6,5,11
WAS200509300,2005,50930,WAS,PHI,WAS10,4,3,7
WAS200510010,2005,51001,WAS,PHI,WAS10,8,4,12
WAS200510020,2005,51002,WAS,PHI,WAS10,9,3,12
WAS200604110,2006,60411,WAS,NYN,WAS10,7,1,8
WAS200604120,2006,60412,WAS,NYN,WAS10,3,1,4
WAS200604130,2006,60413,WAS,NYN,WAS10,13,4,17
WAS200604210,2006,60421,WAS,ATL,WAS10,3,7,10
WAS200604230,2006,60423,WAS,ATL,WAS10,3,1,4
WAS200604240,2006,60424,WAS,CIN,WAS10,4,2,6
WAS200604250,2006,60425,WAS,CIN,WAS10,6,5,11
WAS200604260,2006,60426,WAS,CIN,WAS10,5,0,5
WAS200605030,2006,60503,WAS,FLO,WAS10,6,5,11
WAS200605040,2006,60504,WAS,FLO,WAS10,11,3,14
WAS200605050,2006,60505,WAS,PIT,WAS10,0,6,6
WAS200605060,2006,60506,WAS,PIT,WAS10,5,4,9
WAS200605070,2006,60507,WAS,PIT,WAS10,4,5,9
WAS200605190,2006,60519,WAS,BAL,WAS10,5,1,6
WAS200605200,2006,60520,WAS,BAL,WAS10,3,8,11
WAS200605210,2006,60521,WAS,BAL,WAS10,1,3,4
WAS200605220,2006,60522,WAS,HOU,WAS10,10,3,13
WAS200605230,2006,60523,WAS,HOU,WAS10,1,4,5
WAS200605240,2006,60524,WAS,HOU,WAS10,1,5,6
WAS200605250,2006,60525,WAS,HOU,WAS10,5,8,13
WAS200605260,2006,60526,WAS,LAN,WAS10,4,10,14
WAS200605270,2006,60527,WAS,LAN,WAS10,3,1,4
WAS200605280,2006,60528,WAS,LAN,WAS10,4,10,14
WAS200606080,2006,60608,WAS,PHI,WAS10,2,5,7
WAS200606090,2006,60609,WAS,PHI,WAS10,8,9,17
WAS200606100,2006,60610,WAS,PHI,WAS10,6,2,8
WAS200606110,2006,60611,WAS,PHI,WAS10,0,6,6
WAS200606120,2006,60612,WAS,COL,WAS10,4,3,7
WAS200606130,2006,60613,WAS,COL,WAS10,9,2,11
WAS200606140,2006,60614,WAS,COL,WAS10,14,8,22
WAS200606150,2006,60615,WAS,COL,WAS10,8,1,9
WAS200606160,2006,60616,WAS,NYA,WAS10,7,5,12
WAS200606170,2006,60617,WAS,NYA,WAS10,9,11,20
WAS200606180,2006,60618,WAS,NYA,WAS10,2,3,5
WAS200606300,2006,60630,WAS,TBA,WAS10,11,1,12
WAS200607010,2006,60701,WAS,TBA,WAS10,3,4,7
WAS200607020,2006,60702,WAS,TBA,WAS10,2,6,8
WAS200607030,2006,60703,WAS,FLO,WAS10,1,9,10
WAS200607040,2006,60704,WAS,FLO,WAS10,4,6,10
WAS200607050,2006,60705,WAS,FLO,WAS10,18,9,27
WAS200607060,2006,60706,WAS,FLO,WAS10,7,8,15
WAS200607070,2006,60707,WAS,SDN,WAS10,3,2,5
WAS200607080,2006,60708,WAS,SDN,WAS10,5,2,7
WAS200607090,2006,60709,WAS,SDN,WAS10,10,9,19
WAS200607210,2006,60721,WAS,CHN,WAS10,6,7,13
WAS200607220,2006,60722,WAS,CHN,WAS10,3,7,10
WAS200607230,2006,60723,WAS,CHN,WAS10,1,7,8
WAS200607250,2006,60725,WAS,SFN,WAS10,6,8,14
WAS200607260,2006,60726,WAS,SFN,WAS10,3,4,7
WAS200607270,2006,60727,WAS,SFN,WAS10,5,6,11
WAS200608080,2006,60808,WAS,FLO,WAS10,4,2,6
WAS200608090,2006,60809,WAS,FLO,WAS10,2,5,7
WAS200608100,2006,60810,WAS,FLO,WAS10,9,6,15
WAS200608110,2006,60811,WAS,NYN,WAS10,1,2,3
WAS200608120,2006,60812,WAS,NYN,WAS10,6,4,10
WAS200608130,2006,60813,WAS,NYN,WAS10,3,1,4
WAS200608140,2006,60814,WAS,ATL,WAS10,10,4,14
WAS200608150,2006,60815,WAS,ATL,WAS10,0,5,5
WAS200608160,2006,60816,WAS,ATL,WAS10,6,9,15
WAS200608170,2006,60817,WAS,ATL,WAS10,5,0,5
WAS200608290,2006,60829,WAS,PHI,WAS10,10,6,16
WAS200608300,2006,60830,WAS,PHI,WAS10,5,1,6
WAS200608310,2006,60831,WAS,PHI,WAS10,5,6,11
WAS200609021,2006,60902,WAS,ARI,WAS10,6,7,13
WAS200609022,2006,60902,WAS,ARI,WAS10,3,4,7
WAS200609030,2006,60903,WAS,ARI,WAS10,3,5,8
WAS200609040,2006,60904,WAS,SLN,WAS10,1,4,5
WAS200609050,2006,60905,WAS,SLN,WAS10,2,0,2
WAS200609060,2006,60906,WAS,SLN,WAS10,6,7,13
WAS200609150,2006,60915,WAS,MIL,WAS10,5,2,7
WAS200609160,2006,60916,WAS,MIL,WAS10,5,8,13
WAS200609170,2006,60917,WAS,MIL,WAS10,1,6,7
WAS200609180,2006,60918,WAS,ATL,WAS10,6,1,7
WAS200609190,2006,60919,WAS,ATL,WAS10,2,9,11
WAS200609200,2006,60920,WAS,ATL,WAS10,7,3,10
WAS200609260,2006,60926,WAS,PHI,WAS10,3,4,7
WAS200609270,2006,60927,WAS,PHI,WAS10,8,7,15
WAS200609280,2006,60928,WAS,PHI,WAS10,1,3,4
WAS200609290,2006,60929,WAS,NYN,WAS10,4,3,7
WAS200609300,2006,60930,WAS,NYN,WAS10,13,0,13
WAS200610010,2006,61001,WAS,NYN,WAS10,6,2,8
WAS200704020,2007,70402,WAS,FLO,WAS10,9,2,11
WAS200704030,2007,70403,WAS,FLO,WAS10,9,3,12
WAS200704040,2007,70404,WAS,FLO,WAS10,6,7,13
WAS200704050,2007,70405,WAS,ARI,WAS10,4,3,7
WAS200704060,2007,70406,WAS,ARI,WAS10,7,1,8
WAS200704070,2007,70407,WAS,ARI,WAS10,7,1,8
WAS200704080,2007,70408,WAS,ARI,WAS10,3,1,4
WAS200704160,2007,70416,WAS,ATL,WAS10,1,5,6
WAS200704170,2007,70417,WAS,ATL,WAS10,6,4,10
WAS200704180,2007,70418,WAS,PHI,WAS10,4,5,9
WAS200704190,2007,70419,WAS,PHI,WAS10,4,2,6
WAS200704270,2007,70427,WAS,NYN,WAS10,3,4,7
WAS200704280,2007,70428,WAS,NYN,WAS10,6,2,8
WAS200704290,2007,70429,WAS,NYN,WAS10,1,0,1
WAS200705110,2007,70511,WAS,FLO,WAS10,0,6,6
WAS200705120,2007,70512,WAS,FLO,WAS10,3,7,10
WAS200705130,2007,70513,WAS,FLO,WAS10,4,6,10
WAS200705140,2007,70514,WAS,ATL,WAS10,1,2,3
WAS200705150,2007,70515,WAS,ATL,WAS10,6,2,8
WAS200705160,2007,70516,WAS,ATL,WAS10,4,6,10
WAS200705170,2007,70517,WAS,ATL,WAS10,3,4,7
WAS200705180,2007,70518,WAS,BAL,WAS10,5,4,9
WAS200705190,2007,70519,WAS,BAL,WAS10,3,2,5
WAS200705200,2007,70520,WAS,BAL,WAS10,3,4,7
WAS200705290,2007,70529,WAS,LAN,WAS10,10,0,10
WAS200705300,2007,70530,WAS,LAN,WAS10,5,0,5
WAS200705310,2007,70531,WAS,LAN,WAS10,4,11,15
WAS200706010,2007,70601,WAS,SDN,WAS10,3,4,7
WAS200706020,2007,70602,WAS,SDN,WAS10,11,3,14
WAS200706030,2007,70603,WAS,SDN,WAS10,7,3,10
WAS200706050,2007,70605,WAS,PIT,WAS10,7,6,13
WAS200706060,2007,70606,WAS,PIT,WAS10,5,6,11
WAS200706070,2007,70607,WAS,PIT,WAS10,3,2,5
WAS200706180,2007,70618,WAS,DET,WAS10,9,8,17
WAS200706190,2007,70619,WAS,DET,WAS10,15,1,16
WAS200706200,2007,70620,WAS,DET,WAS10,8,4,12
WAS200706220,2007,70622,WAS,CLE,WAS10,1,4,5
WAS200706230,2007,70623,WAS,CLE,WAS10,4,3,7
WAS200706240,2007,70624,WAS,CLE,WAS10,1,3,4
WAS200707020,2007,70702,WAS,CHN,WAS10,7,2,9
WAS200707030,2007,70703,WAS,CHN,WAS10,3,1,4
WAS200707040,2007,70704,WAS,CHN,WAS10,0,6,6
WAS200707050,2007,70705,WAS,CHN,WAS10,4,2,6
WAS200707060,2007,70706,WAS,MIL,WAS10,6,2,8
WAS200707070,2007,70707,WAS,MIL,WAS10,4,5,9
WAS200707080,2007,70708,WAS,MIL,WAS10,2,7,9
WAS200707160,2007,70716,WAS,HOU,WAS10,3,4,7
WAS200707170,2007,70717,WAS,HOU,WAS10,4,2,6
WAS200707180,2007,70718,WAS,HOU,WAS10,6,7,13
WAS200707190,2007,70719,WAS,COL,WAS10,4,5,9
WAS200707200,2007,70720,WAS,COL,WAS10,3,1,4
WAS200707210,2007,70721,WAS,COL,WAS10,0,3,3
WAS200707220,2007,70722,WAS,COL,WAS10,0,3,3
WAS200707310,2007,70731,WAS,CIN,WAS10,3,6,9
WAS200708010,2007,70801,WAS,CIN,WAS10,2,7,9
WAS200708020,2007,70802,WAS,CIN,WAS10,3,7,10
WAS200708030,2007,70803,WAS,SLN,WAS10,2,3,5
WAS200708040,2007,70804,WAS,SLN,WAS10,1,12,13
WAS200708050,2007,70805,WAS,SLN,WAS10,3,6,9
WAS200708140,2007,70814,WAS,PHI,WAS10,3,2,5
WAS200708150,2007,70815,WAS,PHI,WAS10,2,4,6
WAS200708160,2007,70816,WAS,PHI,WAS10,4,2,6
WAS200708170,2007,70817,WAS,NYN,WAS10,6,2,8
WAS200708180,2007,70818,WAS,NYN,WAS10,7,4,11
WAS200708190,2007,70819,WAS,NYN,WAS10,8,2,10
WAS200708310,2007,70831,WAS,SFN,WAS10,3,2,5
WAS200709010,2007,70901,WAS,SFN,WAS10,1,4,5
WAS200709020,2007,70902,WAS,SFN,WAS10,1,2,3
WAS200709030,2007,70903,WAS,FLO,WAS10,3,6,9
WAS200709040,2007,70904,WAS,FLO,WAS10,3,4,7
WAS200709050,2007,70905,WAS,FLO,WAS10,4,6,10
WAS200709140,2007,70914,WAS,ATL,WAS10,8,5,13
WAS200709150,2007,70915,WAS,ATL,WAS10,4,7,11
WAS200709160,2007,70916,WAS,ATL,WAS10,3,0,3
WAS200709170,2007,70917,WAS,NYN,WAS10,4,12,16
WAS200709180,2007,70918,WAS,NYN,WAS10,8,9,17
WAS200709190,2007,70919,WAS,NYN,WAS10,8,4,12
WAS200709200,2007,70920,WAS,PHI,WAS10,7,6,13
WAS200709210,2007,70921,WAS,PHI,WAS10,6,3,9
WAS200709220,2007,70922,WAS,PHI,WAS10,4,1,5
WAS200709230,2007,70923,WAS,PHI,WAS10,3,5,8
WAS200803300,2008,80330,WAS,ATL,WAS11,2,3,5
WAS200804070,2008,80407,WAS,FLO,WAS11,10,7,17
WAS200804090,2008,80409,WAS,FLO,WAS11,10,4,14
WAS200804100,2008,80410,WAS,FLO,WAS11,4,3,7
WAS200804110,2008,80411,WAS,ATL,WAS11,3,0,3
WAS200804120,2008,80412,WAS,ATL,WAS11,10,2,12
WAS200804130,2008,80413,WAS,ATL,WAS11,4,5,9
WAS200804230,2008,80423,WAS,NYN,WAS11,7,2,9
WAS200804240,2008,80424,WAS,NYN,WAS11,5,10,15
WAS200804250,2008,80425,WAS,CHN,WAS11,3,5,8
WAS200804260,2008,80426,WAS,CHN,WAS11,7,0,7
WAS200804270,2008,80427,WAS,CHN,WAS11,0,2,2
WAS200804290,2008,80429,WAS,ATL,WAS11,3,6,9
WAS200804300,2008,80430,WAS,ATL,WAS11,2,3,5
WAS200805010,2008,80501,WAS,PIT,WAS11,2,3,5
WAS200805020,2008,80502,WAS,PIT,WAS11,11,4,15
WAS200805030,2008,80503,WAS,PIT,WAS11,8,9,17
WAS200805040,2008,80504,WAS,PIT,WAS11,2,5,7
WAS200805090,2008,80509,WAS,FLO,WAS11,7,3,10
WAS200805100,2008,80510,WAS,FLO,WAS11,11,0,11
WAS200805110,2008,80511,WAS,FLO,WAS11,5,4,9
WAS200805190,2008,80519,WAS,PHI,WAS11,0,4,4
WAS200805200,2008,80520,WAS,PHI,WAS11,1,0,1
WAS200805210,2008,80521,WAS,PHI,WAS11,12,2,14
WAS200805230,2008,80523,WAS,MIL,WAS11,1,5,6
WAS200805240,2008,80524,WAS,MIL,WAS11,5,2,7
WAS200805250,2008,80525,WAS,MIL,WAS11,6,7,13
WAS200805260,2008,80526,WAS,MIL,WAS11,4,3,7
WAS200806030,2008,80603,WAS,SLN,WAS11,6,1,7
WAS200806051,2008,80605,WAS,SLN,WAS11,4,1,5
WAS200806052,2008,80605,WAS,SLN,WAS11,9,10,19
WAS200806060,2008,80606,WAS,SFN,WAS11,10,1,11
WAS200806070,2008,80607,WAS,SFN,WAS11,6,0,6
WAS200806080,2008,80608,WAS,SFN,WAS11,6,3,9
WAS200806090,2008,80609,WAS,SFN,WAS11,3,2,5
WAS200806200,2008,80620,WAS,TEX,WAS11,3,4,7
WAS200806210,2008,80621,WAS,TEX,WAS11,13,3,16
WAS200806220,2008,80622,WAS,TEX,WAS11,5,3,8
WAS200806230,2008,80623,WAS,ANA,WAS11,3,2,5
WAS200806240,2008,80624,WAS,ANA,WAS11,8,3,11
WAS200806250,2008,80625,WAS,ANA,WAS11,4,5,9
WAS200806270,2008,80627,WAS,BAL,WAS11,2,4,6
WAS200806280,2008,80628,WAS,BAL,WAS11,9,1,10
WAS200806290,2008,80629,WAS,BAL,WAS11,2,3,5
WAS200807080,2008,80708,WAS,ARI,WAS11,2,0,2
WAS200807090,2008,80709,WAS,ARI,WAS11,0,5,5
WAS200807100,2008,80710,WAS,ARI,WAS11,7,5,12
WAS200807110,2008,80711,WAS,HOU,WAS11,0,10,10
WAS200807120,2008,80712,WAS,HOU,WAS11,6,4,10
WAS200807130,2008,80713,WAS,HOU,WAS11,5,0,5
WAS200807290,2008,80729,WAS,PHI,WAS11,2,1,3
WAS200807300,2008,80730,WAS,PHI,WAS11,8,5,13
WAS200807310,2008,80731,WAS,PHI,WAS11,8,4,12
WAS200808010,2008,80801,WAS,CIN,WAS11,2,5,7
WAS200808020,2008,80802,WAS,CIN,WAS11,6,10,16
WAS200808030,2008,80803,WAS,CIN,WAS11,2,4,6
WAS200808120,2008,80812,WAS,NYN,WAS11,4,3,7
WAS200808130,2008,80813,WAS,NYN,WAS11,12,0,12
WAS200808140,2008,80814,WAS,NYN,WAS11,9,3,12
WAS200808150,2008,80815,WAS,COL,WAS11,4,3,7
WAS200808160,2008,80816,WAS,COL,WAS11,13,6,19
WAS200808170,2008,80817,WAS,COL,WAS11,7,2,9
WAS200808260,2008,80826,WAS,LAN,WAS11,1,2,3
WAS200808270,2008,80827,WAS,LAN,WAS11,4,5,9
WAS200808280,2008,80828,WAS,LAN,WAS11,2,11,13
WAS200808290,2008,80829,WAS,ATL,WAS11,3,7,10
WAS200808300,2008,80830,WAS,ATL,WAS11,8,9,17
WAS200808310,2008,80831,WAS,ATL,WAS11,4,8,12
WAS200809010,2008,80901,WAS,PHI,WAS11,4,7,11
WAS200809020,2008,80902,WAS,PHI,WAS11,4,0,4
WAS200809030,2008,80903,WAS,PHI,WAS11,7,9,16
WAS200809150,2008,80915,WAS,NYN,WAS11,2,7,9
WAS200809160,2008,80916,WAS,NYN,WAS11,0,1,1
WAS200809170,2008,80917,WAS,NYN,WAS11,9,7,16
WAS200809180,2008,80918,WAS,NYN,WAS11,7,2,9
WAS200809190,2008,80919,WAS,SDN,WAS11,11,6,17
WAS200809200,2008,80920,WAS,SDN,WAS11,6,1,7
WAS200809210,2008,80921,WAS,SDN,WAS11,6,2,8
WAS200809230,2008,80923,WAS,FLO,WAS11,4,9,13
WAS200809240,2008,80924,WAS,FLO,WAS11,9,4,13
WAS200904130,2009,90413,WAS,PHI,WAS11,9,8,17
WAS200904160,2009,90416,WAS,PHI,WAS11,2,8,10
WAS200904170,2009,90417,WAS,FLO,WAS11,3,2,5
WAS200904180,2009,90418,WAS,FLO,WAS11,9,6,15
WAS200904190,2009,90419,WAS,FLO,WAS11,7,4,11
WAS200904200,2009,90420,WAS,ATL,WAS11,2,3,5
WAS200904210,2009,90421,WAS,ATL,WAS11,3,4,7
WAS200904220,2009,90422,WAS,ATL,WAS11,1,0,1
WAS200904300,2009,90430,WAS,SLN,WAS11,9,4,13
WAS200905010,2009,90501,WAS,SLN,WAS11,6,2,8
WAS200905020,2009,90502,WAS,SLN,WAS11,1,6,7
WAS200905040,2009,90504,WAS,HOU,WAS11,4,9,13
WAS200905050,2009,90505,WAS,HOU,WAS11,10,11,21
WAS200905150,2009,90515,WAS,PHI,WAS11,10,6,16
WAS200905161,2009,90516,WAS,PHI,WAS11,8,5,13
WAS200905162,2009,90516,WAS,PHI,WAS11,7,5,12
WAS200905170,2009,90517,WAS,PHI,WAS11,8,6,14
WAS200905180,2009,90518,WAS,PIT,WAS11,12,7,19
WAS200905190,2009,90519,WAS,PIT,WAS11,8,5,13
WAS200905200,2009,90520,WAS,PIT,WAS11,2,1,3
WAS200905210,2009,90521,WAS,PIT,WAS11,4,5,9
WAS200905220,2009,90522,WAS,BAL,WAS11,4,2,6
WAS200905230,2009,90523,WAS,BAL,WAS11,2,1,3
WAS200905240,2009,90524,WAS,BAL,WAS11,5,8,13
WAS200906020,2009,90602,WAS,SFN,WAS11,6,10,16
WAS200906041,2009,90604,WAS,SFN,WAS11,5,1,6
WAS200906042,2009,90604,WAS,SFN,WAS11,4,1,5
WAS200906050,2009,90605,WAS,NYN,WAS11,3,1,4
WAS200906060,2009,90606,WAS,NYN,WAS11,1,7,8
WAS200906070,2009,90607,WAS,NYN,WAS11,7,0,7
WAS200906090,2009,90609,WAS,CIN,WAS11,3,2,5
WAS200906100,2009,90610,WAS,CIN,WAS11,4,2,6
WAS200906110,2009,90611,WAS,CIN,WAS11,2,3,5
WAS200906190,2009,90619,WAS,TOR,WAS11,1,2,3
WAS200906200,2009,90620,WAS,TOR,WAS11,3,5,8
WAS200906210,2009,90621,WAS,TOR,WAS11,9,4,13
WAS200906230,2009,90623,WAS,BOS,WAS11,11,3,14
WAS200906240,2009,90624,WAS,BOS,WAS11,6,4,10
WAS200906250,2009,90625,WAS,BOS,WAS11,3,9,12
WAS200907030,2009,90703,WAS,ATL,WAS11,9,8,17
WAS200907040,2009,90704,WAS,ATL,WAS11,3,5,8
WAS200907050,2009,90705,WAS,ATL,WAS11,3,5,8
WAS200907160,2009,90716,WAS,CHN,WAS11,6,2,8
WAS200907170,2009,90717,WAS,CHN,WAS11,3,1,4
WAS200907180,2009,90718,WAS,CHN,WAS11,6,5,11
WAS200907190,2009,90719,WAS,CHN,WAS11,11,3,14
WAS200907200,2009,90720,WAS,NYN,WAS11,6,2,8
WAS200907210,2009,90721,WAS,NYN,WAS11,0,4,4
WAS200907220,2009,90722,WAS,NYN,WAS11,1,3,4
WAS200907230,2009,90723,WAS,SLN,WAS11,4,1,5
WAS200907240,2009,90724,WAS,SDN,WAS11,6,2,8
WAS200907250,2009,90725,WAS,SDN,WAS11,1,13,14
WAS200907260,2009,90726,WAS,SDN,WAS11,2,3,5
WAS200908040,2009,90804,WAS,FLO,WAS11,4,6,10
WAS200908050,2009,90805,WAS,FLO,WAS11,4,5,9
WAS200908060,2009,90806,WAS,FLO,WAS11,8,12,20
WAS200908070,2009,90807,WAS,ARI,WAS11,6,7,13
WAS200908080,2009,90808,WAS,ARI,WAS11,2,5,7
WAS200908090,2009,90809,WAS,ARI,WAS11,2,9,11
WAS200908180,2009,90818,WAS,COL,WAS11,4,3,7
WAS200908190,2009,90819,WAS,COL,WAS11,5,4,9
WAS200908200,2009,90820,WAS,COL,WAS11,4,1,5
WAS200908210,2009,90821,WAS,MIL,WAS11,7,3,10
WAS200908220,2009,90822,WAS,MIL,WAS11,11,9,20
WAS200908230,2009,90823,WAS,MIL,WAS11,3,8,11
WAS200908240,2009,90824,WAS,MIL,WAS11,7,1,8
WAS200909040,2009,90904,WAS,FLO,WAS11,9,6,15
WAS200909050,2009,90905,WAS,FLO,WAS11,9,5,14
WAS200909060,2009,90906,WAS,FLO,WAS11,4,5,9
WAS200909080,2009,90908,WAS,PHI,WAS11,5,3,8
WAS200909090,2009,90909,WAS,PHI,WAS11,6,5,11
WAS200909100,2009,90910,WAS,PHI,WAS11,7,8,15
WAS200909220,2009,90922,WAS,LAN,WAS11,14,2,16
WAS200909230,2009,90923,WAS,LAN,WAS11,4,5,9
WAS200909240,2009,90924,WAS,LAN,WAS11,7,6,13
WAS200909250,2009,90925,WAS,ATL,WAS11,4,1,5
WAS200909260,2009,90926,WAS,ATL,WAS11,11,5,16
WAS200909270,2009,90927,WAS,ATL,WAS11,6,3,9
WAS200909280,2009,90928,WAS,NYN,WAS11,1,2,3
WAS200909290,2009,90929,WAS,NYN,WAS11,3,4,7
WAS200909300,2009,90930,WAS,NYN,WAS11,4,7,11
